CAMERA,RADIUS,NCELLS,AREA,MIN,MAX,RANGE,MEAN,STD
W01,250,3,161054.67,7824,8432,608,8078.333333,257.9616681
W02,250,4,214739.56,8101,8431,330,8204.25,135.2282792
W03,250,4,214739.56,8007,8294,287,8161.5,133.4100821
W04,250,4,214739.56,8147,8240,93,8198.75,33.89966814
W05,250,3,161054.67,7759,8205,446,8056.333333,210.2464163
W06,250,4,214739.56,7547,8140,593,7695.25,256.7765322
W07,250,3,161054.67,6973,7678,705,7403,307.9772719
W08,250,4,214739.56,7513,8348,835,8113.25,348.8591227
W09,250,3,161054.67,7368,7623,255,7519.333333,109.4237431
W10,250,4,214739.56,7500,7719,219,7572.75,88.29319056
W11,250,4,214739.56,7214,7477,263,7408.75,112.457492
W12,250,4,214739.56,6627,7167,540,6764.75,232.2825596
W13,250,4,214739.56,6596,7245,649,6849.25,240.2637873
W14,250,3,161054.67,6794,7284,490,7066,203.6533002
W15,250,3,161054.67,6607,7356,749,7072.666667,331.8476893
W16,250,3,161054.67,7637,7909,272,7808.333333,121.7684506
W17,250,3,161054.67,7704,7766,62,7745.333333,29.22708029
W18,250,4,214739.56,7837,8096,259,7928.25,106.0786854
W19,250,4,214739.56,6958,7034,76,6996,38
W20,250,4,214739.56,6646,7199,553,6965.25,200.1454159
W21,250,4,214739.56,7700,8203,503,7956.5,246.601399
W22,250,4,214739.56,6965,7762,797,7287.25,300.3584317
W23,250,3,161054.67,5038,5443,405,5266.666667,169.4310742
W24,250,3,161054.67,7578,7691,113,7639.666667,46.70712532
W25,250,4,214739.56,7691,7836,145,7763.5,72.5
W26,250,4,214739.56,3997,5195,1198,4895.5,518.7492169
W27,250,4,214739.56,6478,6569,91,6503.5,38.08214805
W28,250,3,161054.67,7216,8484,1268,7638.666667,597.7409324
W29,250,3,161054.67,7480,7546,66,7522.666667,30.21405118
W30,250,4,214739.56,5905,7140,1235,6450.75,555.1028621
W31,250,4,214739.56,7180,7878,698,7592.5,274.6729874
W32,250,4,214739.56,6641,7036,395,6838.5,197.5
W33,250,3,161054.67,6677,7383,706,6928.333333,322.0945341
W34,250,4,214739.56,8236,8361,125,8329.75,54.12658774
W35,250,4,214739.56,6876,7510,634,7078,251.9355076
W36,250,3,161054.67,7454,7887,433,7618.333333,191.5486593
W37,250,4,214739.56,7313,8100,787,7755.75,285.1397684
W38,250,4,214739.56,7720,8328,608,8007,228.7553278
W39,250,4,214739.56,5709,7534,1825,6165.25,790.248181
W40,250,4,214739.56,7933,8152,219,8097.25,94.82978171
W41,250,4,214739.56,7303,8316,1013,7777,364.9047821
W42,250,4,214739.56,7591,7851,260,7739.5,109.8760665
W43,250,4,214739.56,7698,8039,341,7845,145.1981405
W44,250,3,161054.67,6724,7174,450,6999,196.8501969
W45,250,4,214739.56,6607,7634,1027,7376.75,444.4161198
W46,250,3,161054.67,5062,7627,2565,6374.666667,1048.025551
W47,250,3,161054.67,7738,7885,147,7787,69.29646456
W48,250,3,161054.67,7492,8086,594,7832,250.0079999
W49,250,4,214739.56,6162,7063,901,6831.5,386.5970124
W50,250,4,214739.56,8394,8565,171,8472,72.46723398
W51,250,3,161054.67,7160,7686,526,7373.333333,225.9341104
W52,250,4,214739.56,5138,7099,1961,6296,740.2529973
W53,250,4,214739.56,7572,7831,259,7702.75,104.7792322
W54,250,4,214739.56,6973,7249,276,7105.25,120.4374838
W55,250,4,214739.56,7639,7782,143,7695.25,58.93375518
W56,250,3,161054.67,7378,7421,43,7406.666667,20.27039439
W57,250,3,161054.67,8359,8408,49,8377.666667,21.63844316
W58,250,4,214739.56,5076,7587,2511,6682.75,954.7338307
W59,250,4,214739.56,6281,7454,1173,6586.5,501.1409482
W60,250,4,214739.56,6467,7080,613,6773.5,306.5
W61,250,3,161054.67,4163,5694,1531,4914,625.3644271
W62,250,4,214739.56,6897,7898,1001,7576.75,409.2220516
W63,250,3,161054.67,7802,7885,83,7829.666667,39.12657523
W64,250,3,161054.67,5613,6805,1192,6010.333333,561.9141888
W65,250,4,214739.56,6950,7293,343,7046.25,142.7189108
W66,250,3,161054.67,6074,6322,248,6220.333333,106.0576363
WB-E1,250,4,214739.56,1531,4730,3199,2936.25,1149.500408
WB-E10,250,3,161054.67,1914,2940,1026,2256.333333,483.4255085
WB-E2,250,4,214739.56,7186,7207,21,7196.5,10.5
WB-E3,250,4,214739.56,7571,7641,70,7595.75,28.43743132
WB-E4,250,3,161054.67,7896,8272,376,8021.333333,177.2480998
WB-E5,250,4,214739.56,5273,8547,3274,7027.25,1337.663331
WB-E6,250,4,214739.56,7666,7950,284,7836.5,104.375524
WB-E7,250,4,214739.56,7593,7593,0,7593,0
WB-E8,250,4,214739.56,7815,8010,195,7960,83.74067112
WB-E9,250,4,214739.56,8079,8403,324,8201,124.2738911
WB-H1,250,4,214739.56,5885,6524,639,6129.5,266.1977648
WB-H10,250,3,161054.67,5458,6523,1065,6168,502.0458146
WB-H2,250,4,214739.56,7116,7753,637,7397.75,228.1922161
WB-H3,250,3,161054.67,6229,7350,1121,6976.333333,528.4444678
WB-H4,250,4,214739.56,7307,7682,375,7464,139.1743511
WB-H5,250,4,214739.56,4502,6362,1860,4967,805.4036255
WB-H6,250,4,214739.56,6237,9091,2854,8056.25,1156.060417
WB-H7,250,4,214739.56,6043,7796,1753,7318.25,736.971972
WB-H8,250,3,161054.67,4674,6455,1781,5515,730.4523713
WB-H9,250,4,214739.56,3107,5534,2427,4390.75,860.9449387
WB-S1,250,4,214739.56,4372,8991,4619,6850.75,1745.469188
WB-S10,250,3,161054.67,7085,7562,477,7386,213.8550911
WB-S11,250,3,161054.67,6923,7385,462,7185.333333,193.7461111
WB-S12,250,4,214739.56,6058,7316,1258,6500.5,484.0296995
WB-S13,250,4,214739.56,5529,6103,574,5881.75,215.0550802
WB-S14,250,4,214739.56,6620,7613,993,7189,436.220701
WB-S15,250,4,214739.56,5890,7613,1723,7106,705.9444029
WB-S16,250,4,214739.56,5515,5871,356,5693,178
WB-S17,250,4,214739.56,6516,7796,1280,7383.25,506.7224956
WB-S18,250,4,214739.56,6287,8250,1963,7248.75,962.1554903
WB-S19,250,4,214739.56,7399,8358,959,7892.75,422.9511644
WB-S2,250,4,214739.56,4583,6755,2172,5554.5,984.9024063
WB-S20,250,4,214739.56,7841,7883,42,7862,21
WB-S21,250,4,214739.56,7736,8228,492,7952.5,220.4829925
WB-S22,250,4,214739.56,7526,7600,74,7556.75,30.22726418
WB-S23,250,4,214739.56,7822,8148,326,7982,154.2919311
WB-S24,250,4,214739.56,4070,5801,1731,5368.25,749.544987
WB-S25,250,4,214739.56,7649,7649,0,7649,0
WB-S26,250,4,214739.56,8195,8597,402,8375.25,180.033851
WB-S27,250,4,214739.56,7895,8086,191,7990.5,95.5
WB-S28,250,3,161054.67,8012,8035,23,8027.333333,10.84230398
WB-S29,250,3,161054.67,6577,6747,170,6680.333333,74.0870359
WB-S3,250,3,161054.67,6759,6889,130,6819,53.54126135
WB-S4,250,4,214739.56,1643,2953,1310,2552.75,538.5120124
WB-S5,250,4,214739.56,4717,6150,1433,5738.5,594.8161481
WB-S6,250,4,214739.56,4955,6864,1909,6278.25,782.5085862
WB-S7,250,3,161054.67,7084,7183,99,7117,46.66904756
WB-S8,250,4,214739.56,7763,7909,146,7820.5,53.89573267
WB-S9,250,4,214739.56,3086,4867,1781,3903.75,651.6791292
WB-W1,250,4,214739.56,7472,7621,149,7543.25,69.066544
WB-W10,250,3,161054.67,6480,7312,832,6909,340.1597664
WB-W2,250,4,214739.56,8264,8567,303,8415.5,151.5
WB-W3,250,3,161054.67,8073,8268,195,8143.666667,88.19045048
WB-W4,250,4,214739.56,4548,5043,495,4845.75,209.6608869
WB-W5,250,4,214739.56,7633,7859,226,7754.75,94.58428781
WB-W6,250,4,214739.56,8177,8443,266,8334,105.0951949
WB-W7,250,3,161054.67,7292,8276,984,7687.333333,424.3405341
WB-W8,250,3,161054.67,5082,5191,109,5146.666667,46.76418383
WB-W9,250,4,214739.56,6461,7080,619,6703.75,260.45861
W01,500,15,805273.35,7816,8432,616,8099.066667,222.9345096
W02,500,14,751588.46,7849,8431,582,8150.428571,197.6239988
W03,500,14,751588.46,5552,8456,2904,7853.714286,695.2390574
W04,500,15,805273.35,7661,8240,579,8015.466667,202.8174439
W05,500,14,751588.46,7759,8252,493,7976.142857,179.089705
W06,500,16,858958.24,7547,8268,721,7835,227.0641429
W07,500,16,858958.24,6973,8197,1224,7496.25,324.809271
W08,500,16,858958.24,6140,8615,2475,7833.4375,735.8188439
W09,500,15,805273.35,7065,8085,1020,7666.666667,281.9344289
W10,500,14,751588.46,7321,7937,616,7645.642857,185.4922436
W11,500,15,805273.35,6676,7621,945,7289.266667,332.0412558
W12,500,16,858958.24,6346,7167,821,6786.4375,237.2783094
W13,500,14,751588.46,6051,7245,1194,6701.428571,258.4176338
W14,500,16,858958.24,5701,8040,2339,7278.625,557.7572136
W15,500,15,805273.35,6080,7963,1883,7124.066667,459.9448469
W16,500,15,805273.35,7627,7923,296,7805.466667,96.46544574
W17,500,14,751588.46,7404,7961,557,7677.142857,160.3762795
W18,500,14,751588.46,7771,8098,327,7915.5,119.2373084
W19,500,14,751588.46,6620,7711,1091,7124.642857,319.8668489
W20,500,14,751588.46,6560,7635,1075,7168.071429,388.4247425
W21,500,16,858958.24,6643,8484,1841,7845.5625,528.6303019
W22,500,15,805273.35,-312,8261,8573,6107.266667,2853.530175
W23,500,16,858958.24,5008,6154,1146,5482.4375,362.7747181
W24,500,15,805273.35,7558,7788,230,7665.333333,85.32656223
W25,500,14,751588.46,7671,7923,252,7798.5,69.75339213
W26,500,14,751588.46,1757,8152,6395,5118,1999.60814
W27,500,15,805273.35,6478,7327,849,6789.6,279.4238835
W28,500,16,858958.24,6084,8627,2543,7583.25,594.4253002
W29,500,15,805273.35,7319,7885,566,7660.666667,160.8380828
W30,500,16,858958.24,5070,7140,2070,6525,608.2304251
W31,500,15,805273.35,7105,7878,773,7596.8,240.3681066
W32,500,15,805273.35,6211,8354,2143,7176.066667,727.8132056
W33,500,15,805273.35,6244,8309,2065,7175.2,520.1009133
W34,500,15,805273.35,8008,8496,488,8227.466667,150.0043851
W35,500,15,805273.35,4365,7683,3318,7019.533333,754.6604417
W36,500,15,805273.35,7454,7925,471,7622.333333,152.0665059
W37,500,14,751588.46,6423,8196,1773,7681.357143,442.7441388
W38,500,15,805273.35,3459,8328,4869,7038.2,1770.18094
W39,500,14,751588.46,3703,7633,3930,6102.428571,1083.221301
W40,500,14,751588.46,6157,8152,1995,7672.928571,624.3202548
W41,500,14,751588.46,7303,8316,1013,7770.642857,355.5775196
W42,500,14,751588.46,6895,7858,963,7621.428571,230.0809529
W43,500,14,751588.46,7613,8039,426,7859,157.1918755
W44,500,15,805273.35,6020,7246,1226,6691.733333,329.9930235
W45,500,16,858958.24,5853,7810,1957,7392.625,494.2290556
W46,500,14,751588.46,2517,7781,5264,6670.214286,1475.524419
W47,500,15,805273.35,3939,7885,3946,7336.733333,922.545281
W48,500,16,858958.24,7205,8086,881,7655.9375,304.2249309
W49,500,14,751588.46,6162,7216,1054,6933.928571,267.8524285
W50,500,15,805273.35,8200,8625,425,8434.8,101.1429352
W51,500,15,805273.35,6399,7686,1287,7132.266667,345.1010416
W52,500,14,751588.46,2877,7099,4222,5566.642857,1291.734637
W53,500,14,751588.46,7572,7924,352,7798.785714,103.9650893
W54,500,15,805273.35,6973,7382,409,7182.6,135.0667983
W55,500,15,805273.35,7639,7914,275,7770.533333,85.64957028
W56,500,15,805273.35,5960,9559,3599,7819.6,1285.236258
W57,500,14,751588.46,4800,8660,3860,7486.928571,1296.912348
W58,500,15,805273.35,4670,8025,3355,6596.866667,1126.309127
W59,500,14,751588.46,3736,7705,3969,5971.071429,1454.929623
W60,500,14,751588.46,6467,7556,1089,7031.214286,398.9755056
W61,500,14,751588.46,4163,7155,2992,5123.214286,1012.191553
W62,500,14,751588.46,6156,7898,1742,7132.785714,607.3938683
W63,500,15,805273.35,6215,7885,1670,7453.866667,448.1258553
W64,500,15,805273.35,4901,7153,2252,5975.6,809.0966815
W65,500,14,751588.46,6950,7441,491,7163.571429,179.4084384
W66,500,14,751588.46,5648,7110,1462,6113.357143,391.9417973
WB-E1,500,15,805273.35,1130,4730,3600,2908.866667,1247.821882
WB-E10,500,15,805273.35,1692,4723,3031,2808,1008.382996
WB-E2,500,16,858958.24,6816,7423,607,7202.375,161.5908703
WB-E3,500,14,751588.46,7276,8084,808,7637.214286,210.3168285
WB-E4,500,16,858958.24,7745,8319,574,8009.1875,202.2777233
WB-E5,500,14,751588.46,1414,8944,7530,5911.785714,2390.337937
WB-E6,500,16,858958.24,7463,8000,537,7729.6875,194.1020089
WB-E7,500,14,751588.46,3779,7593,3814,7200.571429,956.0455544
WB-E8,500,14,751588.46,7328,8010,682,7856.642857,211.8057085
WB-E9,500,16,858958.24,7350,8403,1053,8048.125,245.6409664
WB-H1,500,15,805273.35,4815,7153,2338,6228.6,687.7439252
WB-H10,500,15,805273.35,5458,7901,2443,6717.133333,658.4022951
WB-H2,500,15,805273.35,4012,8555,4543,7281.666667,1174.478702
WB-H3,500,16,858958.24,3283,7925,4642,6473,1155.941013
WB-H4,500,14,751588.46,6567,7682,1115,7429.428571,279.0255273
WB-H5,500,14,751588.46,1716,7250,5534,4767.785714,1996.923068
WB-H6,500,16,858958.24,1841,9091,7250,6883.4375,2072.88989
WB-H7,500,14,751588.46,4165,7838,3673,7001.142857,1126.666249
WB-H8,500,15,805273.35,3929,7645,3716,5584.333333,1234.800803
WB-H9,500,14,751588.46,1100,5534,4434,3826.214286,1361.088282
WB-S1,500,16,858958.24,3320,8991,5671,6555.6875,1818.107798
WB-S10,500,14,751588.46,3807,7835,4028,6677.357143,1373.559485
WB-S11,500,15,805273.35,6170,7385,1215,6884.8,367.2004357
WB-S12,500,14,751588.46,4501,7609,3108,6543.928571,777.1105331
WB-S13,500,14,751588.46,5529,6103,574,5789.357143,184.7873709
WB-S14,500,15,805273.35,6620,8179,1559,7540.533333,553.1011802
WB-S15,500,15,805273.35,3617,7776,4159,6554.933333,1210.081896
WB-S16,500,15,805273.35,2822,7146,4324,5290.133333,1088.311406
WB-S17,500,14,751588.46,3093,7844,4751,6940.785714,1285.838702
WB-S18,500,14,751588.46,5248,8250,3002,6933.5,1088.228951
WB-S19,500,14,751588.46,5510,8358,2848,7489.714286,907.295544
WB-S2,500,14,751588.46,2526,7750,5224,5414.642857,1556.85487
WB-S20,500,14,751588.46,7502,8076,574,7822.357143,147.4563408
WB-S21,500,15,805273.35,6652,8367,1715,7829.2,514.14579
WB-S22,500,14,751588.46,7284,7725,441,7551.214286,110.4576057
WB-S23,500,14,751588.46,3740,8148,4408,7481.642857,1305.998611
WB-S24,500,14,751588.46,1057,5801,4744,3102.785714,1872.158578
WB-S25,500,14,751588.46,7646,7737,91,7694,35.35129822
WB-S26,500,14,751588.46,3198,8609,5411,6845.642857,2078.769128
WB-S27,500,14,751588.46,7682,8086,404,7836.214286,135.4327343
WB-S28,500,15,805273.35,7845,8371,526,8042.6,129.3500676
WB-S29,500,14,751588.46,6577,7522,945,6899.642857,283.9604115
WB-S3,500,15,805273.35,5897,7245,1348,6679.2,407.6583864
WB-S4,500,14,751588.46,1643,4849,3206,2824.785714,1015.061587
WB-S5,500,14,751588.46,4282,6410,2128,5466.571429,794.6630656
WB-S6,500,14,751588.46,3054,6864,3810,5419.214286,1163.799945
WB-S7,500,15,805273.35,6761,7347,586,7085.866667,152.711871
WB-S8,500,14,751588.46,7708,7909,201,7801,61.29553701
WB-S9,500,14,751588.46,410,4867,4457,3298.571429,1425.757729
WB-W1,500,15,805273.35,6676,7621,945,7445.866667,241.4099878
WB-W10,500,16,858958.24,2202,7312,5110,5572.75,1857.649876
WB-W2,500,15,805273.35,8135,8629,494,8381.466667,155.887937
WB-W3,500,15,805273.35,7265,8268,1003,7984.333333,260.8564526
WB-W4,500,14,751588.46,4548,6066,1518,5088.142857,498.2649693
WB-W5,500,16,858958.24,7633,8018,385,7781.9375,118.6583693
WB-W6,500,14,751588.46,7763,8443,680,8167.571429,272.8562453
WB-W7,500,15,805273.35,7292,9225,1933,7848.133333,642.4012107
WB-W8,500,15,805273.35,3647,6983,3336,5227.2,844.3220713
WB-W9,500,14,751588.46,6461,7803,1342,7030.142857,433.6118833
W01,750,34,1825286.26,7673,8432,759,8014.323529,234.7495186
W02,750,32,1717916.48,7793,8431,638,8123.03125,198.4320546
W03,750,33,1771601.37,5552,8456,2904,7643.090909,714.3012845
W04,750,32,1717916.48,7615,8240,625,7967.96875,189.2220066
W05,750,32,1717916.48,7759,8266,507,7988.5625,162.3724379
W06,750,32,1717916.48,7245,8339,1094,7889.71875,270.655366
W07,750,32,1717916.48,6564,8346,1782,7478.0625,413.8457546
W08,750,32,1717916.48,5455,8617,3162,7487.4375,952.1491787
W09,750,34,1825286.26,7065,8213,1148,7691.852941,295.1906794
W10,750,32,1717916.48,7310,7949,639,7692.34375,194.6762712
W11,750,34,1825286.26,6299,7721,1422,7238.264706,436.9612521
W12,750,32,1717916.48,6163,7201,1038,6783.34375,303.9697363
W13,750,32,1717916.48,5673,7245,1572,6664.34375,299.1062321
W14,750,33,1771601.37,5497,8040,2543,7445.363636,583.6467808
W15,750,34,1825286.26,6080,8095,2015,7275.441176,455.5128455
W16,750,33,1771601.37,7493,8302,809,7819.575758,147.812541
W17,750,33,1771601.37,7404,7992,588,7699.909091,138.0808642
W18,750,33,1771601.37,7761,8098,337,7903.212121,110.5467836
W19,750,32,1717916.48,6620,7738,1118,7231.21875,350.9315046
W20,750,32,1717916.48,6543,7636,1093,7184.1875,388.3222275
W21,750,32,1717916.48,6643,8484,1841,7842.65625,571.1921529
W22,750,32,1717916.48,-312,8261,8573,6121.65625,2719.077964
W23,750,32,1717916.48,4703,6428,1725,5548.125,418.1959581
W24,750,34,1825286.26,6888,7886,998,7599.411765,192.4223476
W25,750,32,1717916.48,7555,7968,413,7787.09375,104.997726
W26,750,33,1771601.37,738,8152,7414,5198.030303,2407.602372
W27,750,34,1825286.26,6020,7529,1509,6932.794118,386.9603855
W28,750,33,1771601.37,6084,8627,2543,7633.181818,635.9591398
W29,750,33,1771601.37,7195,8281,1086,7693.818182,223.3918224
W30,750,32,1717916.48,5070,7244,2174,6472.09375,611.6438588
W31,750,32,1717916.48,7105,7878,773,7595.28125,221.5516636
W32,750,35,1878971.15,6092,8670,2578,7479.714286,834.1135781
W33,750,33,1771601.37,6244,8511,2267,7513.545455,660.585236
W34,750,35,1878971.15,7893,8811,918,8267.885714,254.0649828
W35,750,34,1825286.26,4365,7729,3364,6892.294118,992.4920367
W36,750,34,1825286.26,6622,7925,1303,7580.852941,263.1474796
W37,750,32,1717916.48,4054,9107,5053,7611.3125,916.3831226
W38,750,34,1825286.26,3459,8328,4869,6937.205882,1597.807869
W39,750,32,1717916.48,3187,8087,4900,5880.71875,1451.862839
W40,750,32,1717916.48,6157,8152,1995,7555.4375,609.9170506
W41,750,34,1825286.26,7270,8316,1046,7738.382353,340.0853712
W42,750,33,1771601.37,6478,8124,1646,7567.181818,405.0099478
W43,750,32,1717916.48,7053,8240,1187,7784.03125,266.3223475
W44,750,33,1771601.37,6020,7632,1612,6846.060606,375.9738014
W45,750,32,1717916.48,2629,7965,5336,6827.09375,1469.966801
W46,750,33,1771601.37,2472,7796,5324,6560.272727,1511.410104
W47,750,33,1771601.37,2495,7885,5390,6930.848485,1380.994506
W48,750,32,1717916.48,7205,8086,881,7631.5625,260.4048456
W49,750,32,1717916.48,6162,7282,1120,7013.0625,225.3574851
W50,750,34,1825286.26,7189,8733,1544,8253.470588,450.7456068
W51,750,33,1771601.37,6399,7831,1432,7111.545455,403.046361
W52,750,33,1771601.37,1935,7099,5164,4756.151515,1665.372961
W53,750,34,1825286.26,4867,8153,3286,7658.764706,618.0542551
W54,750,35,1878971.15,5695,7759,2064,7204.457143,378.0078112
W55,750,32,1717916.48,7395,7926,531,7722.4375,168.8756824
W56,750,34,1825286.26,5960,9859,3899,8061.058824,1265.219347
W57,750,32,1717916.48,4800,8660,3860,7323.75,1273.02094
W58,750,32,1717916.48,4670,8025,3355,6930.53125,1020.461966
W59,750,32,1717916.48,3316,7918,4602,5857.03125,1596.652582
W60,750,33,1771601.37,6467,7556,1089,7105,359.3189686
W61,750,32,1717916.48,4163,7936,3773,5897.15625,1348.946768
W62,750,33,1771601.37,3930,7898,3968,6855.242424,972.4920201
W63,750,34,1825286.26,6215,7885,1670,7316.294118,465.6989389
W64,750,35,1878971.15,4779,7153,2374,6226.028571,804.9957049
W65,750,32,1717916.48,6890,8000,1110,7248.375,231.7055985
W66,750,32,1717916.48,5648,7478,1830,6509.3125,523.3547099
WB-E1,750,32,1717916.48,1130,5889,4759,2791.96875,1399.864536
WB-E10,750,33,1771601.37,1685,5247,3562,2886.636364,1121.934039
WB-E2,750,32,1717916.48,5731,7423,1692,7097.8125,370.2494461
WB-E3,750,32,1717916.48,7052,8131,1079,7666.78125,294.2449802
WB-E4,750,32,1717916.48,7745,8341,596,8006.875,206.5120684
WB-E5,750,32,1717916.48,1026,9051,8025,5682.1875,2663.377619
WB-E6,750,32,1717916.48,7426,8000,574,7698.15625,194.7176015
WB-E7,750,33,1771601.37,3462,7754,4292,6938.424242,1256.349137
WB-E8,750,32,1717916.48,5580,8183,2603,7646.4375,606.4942259
WB-E9,750,32,1717916.48,7066,8446,1380,7957.09375,324.511398
WB-H1,750,35,1878971.15,4815,8131,3316,6663.314286,833.8084662
WB-H10,750,33,1771601.37,3569,7901,4332,6545.121212,1129.199227
WB-H2,750,32,1717916.48,4012,8555,4543,6887.8125,1408.940747
WB-H3,750,34,1825286.26,1891,8282,6391,5697.911765,1740.743272
WB-H4,750,33,1771601.37,4833,7785,2952,7156.121212,683.2944597
WB-H5,750,34,1825286.26,1034,7250,6216,4481.029412,2100.997879
WB-H6,750,33,1771601.37,688,9091,8403,6085.757576,2396.294438
WB-H7,750,33,1771601.37,2392,7859,5467,6263.636364,1831.376396
WB-H8,750,34,1825286.26,2699,7911,5212,5713.647059,1491.330572
WB-H9,750,33,1771601.37,636,5951,5315,3262.272727,1614.664695
WB-S1,750,34,1825286.26,2442,8991,6549,5936,2093.851531
WB-S10,750,33,1771601.37,795,7835,7040,5813.454545,2195.592942
WB-S11,750,33,1771601.37,3690,7555,3865,6582.939394,797.0732805
WB-S12,750,32,1717916.48,2368,8000,5632,6296.90625,1459.627893
WB-S13,750,32,1717916.48,2761,6162,3401,5240.03125,963.1525543
WB-S14,750,32,1717916.48,6554,8179,1625,7590.09375,469.8275854
WB-S15,750,34,1825286.26,2472,7776,5304,6547.647059,1443.08609
WB-S16,750,32,1717916.48,2033,7146,5113,4879,1553.109603
WB-S17,750,32,1717916.48,3093,7847,4754,6789.8125,1367.607638
WB-S18,750,34,1825286.26,3971,8915,4944,6961.382353,1430.479496
WB-S19,750,32,1717916.48,5510,8363,2853,7535.75,833.5167215
WB-S2,750,32,1717916.48,1356,8127,6771,5226.25,2026.814696
WB-S20,750,34,1825286.26,7502,8076,574,7803.117647,150.8927872
WB-S21,750,34,1825286.26,6088,8399,2311,7787.705882,535.5633938
WB-S22,750,33,1771601.37,7284,7725,441,7570.69697,103.9689595
WB-S23,750,32,1717916.48,3735,8148,4413,7278,1502.26038
WB-S24,750,32,1717916.48,901,5801,4900,2471.0625,1557.779588
WB-S25,750,33,1771601.37,7544,7737,193,7686.575758,49.61550973
WB-S26,750,32,1717916.48,3198,8669,5471,7013.8125,1805.080598
WB-S27,750,32,1717916.48,7630,8111,481,7814.4375,138.5780325
WB-S28,750,34,1825286.26,7699,8444,745,8062.852941,188.8342149
WB-S29,750,33,1771601.37,6315,7901,1586,6958.636364,454.2540884
WB-S3,750,34,1825286.26,4560,7528,2968,6781.764706,684.0933484
WB-S4,750,34,1825286.26,1000,5856,4856,2778.323529,1288.238645
WB-S5,750,32,1717916.48,2895,7364,4469,5208.5625,1214.219166
WB-S6,750,32,1717916.48,1824,7642,5818,4509.5,1719.223371
WB-S7,750,33,1771601.37,6761,7757,996,7148.787879,198.0483194
WB-S8,750,32,1717916.48,7262,7909,647,7698.0625,165.2637924
WB-S9,750,32,1717916.48,216,5343,5127,2837.75,1793.39202
WB-W1,750,34,1825286.26,6636,7806,1170,7443.970588,313.4527345
WB-W10,750,33,1771601.37,2202,7312,5110,5325.030303,1886.62388
WB-W2,750,31,1664231.59,8017,8629,612,8356.903226,154.1210992
WB-W3,750,33,1771601.37,6439,8268,1829,7763.69697,534.7534966
WB-W4,750,32,1717916.48,4548,6252,1704,5366.28125,561.8605384
WB-W5,750,32,1717916.48,7633,8044,411,7828.375,127.0437302
WB-W6,750,32,1717916.48,7680,8443,763,8051.25,273.5746013
WB-W7,750,34,1825286.26,7095,9787,2692,7915.470588,778.9680291
WB-W8,750,33,1771601.37,3647,8034,4387,5902.515152,1123.917826
WB-W9,750,33,1771601.37,6461,8089,1628,7245.575758,430.1981242
W01,1000,61,3274778.29,7568,8432,864,7983.04918,232.7400172
W02,1000,59,3167408.51,7793,8431,638,8098.20339,180.1774812
W03,1000,58,3113723.62,4708,8456,3748,7314.275862,944.0644118
W04,1000,57,3060038.73,7513,8347,834,7945.403509,193.004305
W05,1000,59,3167408.51,7579,8299,720,8002.474576,177.6543355
W06,1000,59,3167408.51,7245,8339,1094,7901.864407,301.7323687
W07,1000,59,3167408.51,6538,8346,1808,7404.694915,461.7995843
W08,1000,59,3167408.51,3233,8617,5384,7080.745763,1431.458396
W09,1000,61,3274778.29,3572,8222,4650,7509.737705,876.449112
W10,1000,58,3113723.62,5588,8053,2465,7633.741379,439.2815671
W11,1000,59,3167408.51,4064,7806,3742,7119.118644,717.9656071
W12,1000,58,3113723.62,6156,7725,1569,6841.706897,425.9549923
W13,1000,56,3006353.84,4893,7245,2352,6441.303571,489.4095904
W14,1000,59,3167408.51,5497,8049,2552,7522.101695,544.0726115
W15,1000,61,3274778.29,6080,8095,2015,7413.459016,432.8654648
W16,1000,61,3274778.29,7193,8302,1109,7800.983607,208.2794853
W17,1000,59,3167408.51,7404,7999,595,7743.525424,139.2048066
W18,1000,58,3113723.62,7622,8098,476,7880.931034,112.4493544
W19,1000,56,3006353.84,6620,7886,1266,7321.892857,342.2756658
W20,1000,56,3006353.84,6355,8042,1687,7219.410714,420.105462
W21,1000,59,3167408.51,3228,8484,5256,7708.067797,914.5147248
W22,1000,56,3006353.84,-919,8367,9286,6068.232143,2953.150624
W23,1000,59,3167408.51,4703,6942,2239,5680.644068,554.6046618
W24,1000,60,3221093.4,5405,7911,2506,7465.133333,502.92042
W25,1000,56,3006353.84,7252,8060,808,7736.25,147.4122318
W26,1000,58,3113723.62,738,8264,7526,4939.603448,2673.539104
W27,1000,59,3167408.51,6020,7742,1722,7090.338983,442.6415932
W28,1000,59,3167408.51,5858,8627,2769,7599.237288,631.3020266
W29,1000,58,3113723.62,6738,8281,1543,7654,309.9765286
W30,1000,59,3167408.51,3445,7636,4191,6449.610169,808.7722861
W31,1000,56,3006353.84,6986,8237,1251,7632.125,266.9512437
W32,1000,61,3274778.29,5745,8670,2925,7664.098361,862.8877499
W33,1000,60,3221093.4,6244,8579,2335,7689.033333,692.7711735
W34,1000,60,3221093.4,6458,8949,2491,8276.466667,372.3255057
W35,1000,59,3167408.51,4365,8036,3671,7062.932203,962.1194095
W36,1000,62,3328463.18,5221,8144,2923,7452.903226,656.7313908
W37,1000,58,3113723.62,2127,9107,6980,6866.810345,1721.899267
W38,1000,60,3221093.4,3459,8328,4869,7265.083333,1280.013025
W39,1000,56,3006353.84,1895,8087,6192,5933.678571,1581.091893
W40,1000,59,3167408.51,5111,8329,3218,7568.186441,655.0282301
W41,1000,58,3113723.62,6983,8316,1333,7699.87931,318.9577357
W42,1000,58,3113723.62,5789,8149,2360,7464.051724,578.7191691
W43,1000,58,3113723.62,6276,8240,1964,7633.465517,439.4790103
W44,1000,58,3113723.62,5171,7778,2607,6814.103448,529.9627082
W45,1000,58,3113723.62,2180,8010,5830,6418.37931,1811.407348
W46,1000,60,3221093.4,2472,7796,5324,6474.683333,1513.40591
W47,1000,58,3113723.62,2495,7885,5390,6876.551724,1317.007386
W48,1000,59,3167408.51,7154,8086,932,7619.033898,232.4307053
W49,1000,56,3006353.84,5984,7546,1562,6988.625,280.5351749
W50,1000,58,3113723.62,5362,8985,3623,8094.844828,637.1088199
W51,1000,60,3221093.4,6399,7861,1462,7187.5,392.4472151
W52,1000,58,3113723.62,1899,7748,5849,4552.948276,1774.096384
W53,1000,58,3113723.62,4109,8193,4084,7503.275862,964.4918225
W54,1000,61,3274778.29,4558,8003,3445,7146.803279,622.4289497
W55,1000,56,3006353.84,7253,8017,764,7689.714286,209.5063683
W56,1000,61,3274778.29,5960,9877,3917,8103.540984,1147.432723
W57,1000,59,3167408.51,4800,8660,3860,7106.711864,1232.971278
W58,1000,56,3006353.84,4670,8043,3373,7105.839286,953.2531476
W59,1000,58,3113723.62,1605,8597,6992,5757.155172,1824.805562
W60,1000,58,3113723.62,6467,7828,1361,7189.275862,360.722732
W61,1000,59,3167408.51,4163,7936,3773,6457.915254,1293.578053
W62,1000,58,3113723.62,2000,7898,5898,6426.327586,1507.599432
W63,1000,59,3167408.51,1760,7909,6149,6639.389831,1530.157475
W64,1000,60,3221093.4,4529,7266,2737,6443.8,776.6420196
W65,1000,57,3060038.73,4582,8000,3418,7231.315789,474.7736361
W66,1000,59,3167408.51,3408,7567,4159,6630.932203,672.4287339
WB-E1,1000,56,3006353.84,1130,8029,6899,2964.892857,1705.008983
WB-E10,1000,59,3167408.51,1464,5247,3783,2787.762712,986.5215614
WB-E2,1000,59,3167408.51,5731,7423,1692,6944.423729,434.9367849
WB-E3,1000,58,3113723.62,7052,8131,1079,7742.793103,273.1315054
WB-E4,1000,59,3167408.51,7612,8559,947,8015.966102,256.5346619
WB-E5,1000,56,3006353.84,273,9051,8778,5280.089286,2786.773315
WB-E6,1000,58,3113723.62,7145,8039,894,7648.12069,216.2240279
WB-E7,1000,58,3113723.62,2413,7758,5345,6699.275862,1431.858399
WB-E8,1000,58,3113723.62,5580,8183,2603,7558.603448,681.4541232
WB-E9,1000,57,3060038.73,6931,8446,1515,7894.368421,378.233504
WB-H1,1000,60,3221093.4,4815,8131,3316,6869.2,783.4949649
WB-H10,1000,60,3221093.4,2779,7901,5122,6220.733333,1465.50544
WB-H2,1000,57,3060038.73,1980,8555,6575,6545.22807,1849.990308
WB-H3,1000,61,3274778.29,1891,8447,6556,5230.213115,2022.04503
WB-H4,1000,58,3113723.62,2200,7931,5731,6786.810345,1407.761055
WB-H5,1000,58,3113723.62,1034,8220,7186,4553.155172,2331.871661
WB-H6,1000,58,3113723.62,688,9091,8403,5578.862069,2519.236696
WB-H7,1000,59,3167408.51,2022,8589,6567,6036.644068,2140.526981
WB-H8,1000,62,3328463.18,2383,8254,5871,5593.548387,1760.028965
WB-H9,1000,58,3113723.62,636,5951,5315,2858.034483,1606.515162
WB-S1,1000,61,3274778.29,1980,9336,7356,5434.704918,2220.752858
WB-S10,1000,61,3274778.29,795,7876,7081,5584.704918,2219.507591
WB-S11,1000,60,3221093.4,1921,7563,5642,6261.05,1200.521767
WB-S12,1000,56,3006353.84,1581,8137,6556,5841.767857,1716.383261
WB-S13,1000,57,3060038.73,2395,6771,4376,4967.122807,1108.813101
WB-S14,1000,58,3113723.62,5364,8179,2815,7564.793103,499.6437613
WB-S15,1000,60,3221093.4,2472,7796,5324,6450.566667,1598.02248
WB-S16,1000,56,3006353.84,1753,7780,6027,4675.017857,1837.321745
WB-S17,1000,59,3167408.51,3093,7906,4813,6645.491525,1493.253772
WB-S18,1000,58,3113723.62,2252,8915,6663,6797.586207,1681.352565
WB-S19,1000,58,3113723.62,2824,8363,5539,7140.465517,1242.050602
WB-S2,1000,56,3006353.84,971,8653,7682,5235.089286,2267.934887
WB-S20,1000,58,3113723.62,7502,8324,822,7832.051724,163.9969956
WB-S21,1000,59,3167408.51,4927,8399,3472,7746.728814,600.103009
WB-S22,1000,58,3113723.62,7284,7725,441,7556.793103,97.67217488
WB-S23,1000,59,3167408.51,3504,8296,4792,7288.881356,1412.622637
WB-S24,1000,58,3113723.62,726,5801,5075,2241.758621,1426.987197
WB-S25,1000,58,3113723.62,7355,7859,504,7677.603448,82.24855929
WB-S26,1000,58,3113723.62,3198,8674,5476,7267.758621,1567.588377
WB-S27,1000,58,3113723.62,7554,8111,557,7822.241379,132.017542
WB-S28,1000,61,3274778.29,7699,8509,810,8070.540984,180.7043209
WB-S29,1000,60,3221093.4,6226,7961,1735,7010.433333,528.475145
WB-S3,1000,62,3328463.18,3377,7528,4151,6530.193548,1093.579338
WB-S4,1000,58,3113723.62,818,7040,6222,2816.482759,1641.877124
WB-S5,1000,56,3006353.84,2895,7881,4986,5301.107143,1548.471616
WB-S6,1000,58,3113723.62,1798,7736,5938,4113.586207,1932.299586
WB-S7,1000,60,3221093.4,6181,8113,1932,7180.683333,314.6165651
WB-S8,1000,58,3113723.62,7262,8227,965,7673.810345,171.573595
WB-S9,1000,57,3060038.73,143,6574,6431,3140.122807,1966.90266
WB-W1,1000,60,3221093.4,6299,7841,1542,7406.65,391.3934434
WB-W10,1000,59,3167408.51,2202,7312,5110,5414.644068,1674.873947
WB-W2,1000,58,3113723.62,6517,8629,2112,8244.655172,337.1976066
WB-W3,1000,58,3113723.62,6439,8290,1851,7660.137931,614.5146514
WB-W4,1000,58,3113723.62,4548,7623,3075,5635.896552,659.1164067
WB-W5,1000,58,3113723.62,7633,8091,458,7863.931034,129.8708725
WB-W6,1000,58,3113723.62,7680,8471,791,8045.551724,265.3701496
WB-W7,1000,60,3221093.4,7095,9787,2692,7821.25,712.0623012
WB-W8,1000,60,3221093.4,3647,8049,4402,6309.016667,1107.508548
WB-W9,1000,58,3113723.62,6461,8089,1628,7328.448276,433.1049555
W01,1250,93,4992694.77,6241,8432,2191,7936.903226,343.1025448
W02,1250,93,4992694.77,7653,8434,781,8081.172043,192.9194842
W03,1250,91,4885324.99,2838,8531,5693,6984.098901,1291.853188
W04,1250,88,4724270.32,7471,8444,973,7941.011364,216.1439175
W05,1250,94,5046379.66,7579,8514,935,8000.287234,215.8805138
W06,1250,93,4992694.77,7245,8339,1094,7893.344086,294.0104414
W07,1250,92,4939009.88,6290,8346,2056,7342.98913,483.9976755
W08,1250,93,4992694.77,2348,8617,6269,6617.924731,1787.312822
W09,1250,93,4992694.77,3572,8222,4650,7458.505376,967.5322742
W10,1250,90,4831640.1,3980,8235,4255,7474.388889,933.8101127
W11,1250,93,4992694.77,4064,7841,3777,7036.591398,914.9370533
W12,1250,91,4885324.99,5745,8047,2302,6866.769231,557.9499776
W13,1250,88,4724270.32,1576,7245,5669,6130.045455,988.9148312
W14,1250,91,4885324.99,5497,8064,2567,7518.164835,569.1051249
W15,1250,93,4992694.77,5947,8095,2148,7448.010753,410.2525709
W16,1250,93,4992694.77,6361,9776,3415,7825.913978,369.7613777
W17,1250,93,4992694.77,7089,8124,1035,7772.688172,164.0941887
W18,1250,91,4885324.99,7325,8150,825,7864.846154,149.8972485
W19,1250,91,4885324.99,4533,8234,3701,7315.21978,527.8377165
W20,1250,90,4831640.1,5250,8042,2792,7148.744444,563.0670882
W21,1250,91,4885324.99,2070,8484,6414,7347.274725,1401.222763
W22,1250,88,4724270.32,-919,9979,10898,6380.068182,2561.784524
W23,1250,91,4885324.99,4288,6942,2654,5693.373626,577.2859319
W24,1250,93,4992694.77,3158,7922,4764,7170.946237,1018.874377
W25,1250,91,4885324.99,4910,8078,3168,7620.362637,424.5723256
W26,1250,91,4885324.99,650,8511,7861,4782.879121,2742.407372
W27,1250,93,4992694.77,6020,7833,1813,7158.032258,465.9925342
W28,1250,91,4885324.99,5858,8627,2769,7579.769231,594.0253459
W29,1250,92,4939009.88,6199,8281,2082,7565.826087,391.666662
W30,1250,93,4992694.77,3445,7831,4386,6580.096774,859.7054642
W31,1250,91,4885324.99,6986,8237,1251,7694.505495,264.3646488
W32,1250,93,4992694.77,5745,8670,2925,7782.709677,820.8217176
W33,1250,94,5046379.66,4852,8586,3734,7772.489362,810.4522213
W34,1250,93,4992694.77,5862,9134,3272,8108.086022,611.094781
W35,1250,93,4992694.77,4228,8036,3808,7065.903226,1034.407639
W36,1250,93,4992694.77,3151,8235,5084,7306.021505,938.7328565
W37,1250,89,4777955.21,2127,9107,6980,6659.775281,1838.392836
W38,1250,93,4992694.77,3459,8444,4985,7408.204301,1123.428935
W39,1250,90,4831640.1,1893,8087,6194,6057.622222,1514.51265
W40,1250,93,4992694.77,2768,8329,5561,7461.11828,968.1152163
W41,1250,91,4885324.99,6100,8316,2216,7690.879121,340.6734067
W42,1250,91,4885324.99,5369,8149,2780,7493.098901,608.0114056
W43,1250,90,4831640.1,4647,8390,3743,7448.011111,645.1525142
W44,1250,92,4939009.88,2514,7927,5413,6780.032609,738.6734357
W45,1250,91,4885324.99,1767,8126,6359,6215.175824,1935.974557
W46,1250,94,5046379.66,2472,7796,5324,6429.819149,1506.781041
W47,1250,93,4992694.77,2495,8069,5574,6769.258065,1357.355366
W48,1250,92,4939009.88,7154,8086,932,7611.195652,235.0747448
W49,1250,90,4831640.1,4024,7546,3522,6877.9,490.1383263
W50,1250,90,4831640.1,4455,8985,4530,7911.422222,784.0779578
W51,1250,93,4992694.77,6399,7996,1597,7262.537634,384.6115918
W52,1250,91,4885324.99,1690,7748,6058,4262.153846,1861.351234
W53,1250,92,4939009.88,4109,8360,4251,7475.847826,993.0146014
W54,1250,93,4992694.77,3343,8059,4716,6852.688172,1127.40797
W55,1250,88,4724270.32,7226,8080,854,7663.795455,227.8648004
W56,1250,93,4992694.77,5960,9919,3959,8040.677419,1083.327661
W57,1250,93,4992694.77,2999,8660,5661,6683.182796,1402.710701
W58,1250,88,4724270.32,4670,8156,3486,7185.704545,909.5958163
W59,1250,90,4831640.1,1382,8597,7215,5772.211111,1921.128317
W60,1250,91,4885324.99,6467,7897,1430,7238.417582,342.5069524
W61,1250,93,4992694.77,3709,8039,4330,6747.602151,1285.565924
W62,1250,91,4885324.99,1407,7898,6491,6011.648352,1896.254239
W63,1250,93,4992694.77,869,8139,7270,6110.451613,2056.445365
W64,1250,93,4992694.77,4529,7266,2737,6499.870968,748.435461
W65,1250,91,4885324.99,2938,8000,5062,6859.186813,1023.344247
W66,1250,94,5046379.66,2273,7567,5294,6392.489362,1183.802292
WB-E1,1250,91,4885324.99,1130,8272,7142,3441,2035.300577
WB-E10,1250,94,5046379.66,765,8301,7536,2988.446809,1368.536014
WB-E2,1250,91,4885324.99,5312,7423,2111,6902.56044,465.1392373
WB-E3,1250,90,4831640.1,6065,8131,2066,7678.344444,334.4848165
WB-E4,1250,92,4939009.88,7612,8559,947,8024.195652,267.0631435
WB-E5,1250,90,4831640.1,273,9051,8778,5174.622222,2845.671382
WB-E6,1250,92,4939009.88,7145,8039,894,7632.380435,214.0201048
WB-E7,1250,91,4885324.99,1600,7758,6158,6476.582418,1766.533298
WB-E8,1250,90,4831640.1,3786,8395,4609,7516.422222,810.3186887
WB-E9,1250,88,4724270.32,5258,8446,3188,7759.761364,601.8323346
WB-H1,1250,93,4992694.77,4815,8131,3316,7006.139785,785.8026318
WB-H10,1250,93,4992694.77,2078,7980,5902,5956.344086,1686.473852
WB-H2,1250,88,4724270.32,1980,8555,6575,6362.159091,2020.002812
WB-H3,1250,93,4992694.77,1654,8580,6926,5098.44086,2109.896647
WB-H4,1250,91,4885324.99,1818,7995,6177,6545.593407,1784.553646
WB-H5,1250,89,4777955.21,1034,8220,7186,4539.235955,2374.478062
WB-H6,1250,90,4831640.1,688,9091,8403,5428.644444,2487.570655
WB-H7,1250,91,4885324.99,1344,9522,8178,5929.791209,2351.527708
WB-H8,1250,93,4992694.77,2368,8317,5949,5519.182796,1799.535507
WB-H9,1250,90,4831640.1,636,6498,5862,2684.477778,1611.968667
WB-S1,1250,94,5046379.66,1521,9453,7932,5159.457447,2204.961864
WB-S10,1250,93,4992694.77,795,7876,7081,5367.397849,2114.209973
WB-S11,1250,93,4992694.77,1329,7755,6426,5959.741935,1553.759318
WB-S12,1250,90,4831640.1,1581,8283,6702,5407.566667,1951.3998
WB-S13,1250,90,4831640.1,2395,6807,4412,4652.588889,1140.243267
WB-S14,1250,88,4724270.32,5013,8197,3184,7470.761364,656.6085556
WB-S15,1250,93,4992694.77,1953,7796,5843,6475.967742,1578.087072
WB-S16,1250,91,4885324.99,1508,8087,6579,4492.593407,1979.667293
WB-S17,1250,92,4939009.88,3093,7926,4833,6692.532609,1452.865201
WB-S18,1250,89,4777955.21,1814,8915,7101,6533.11236,2024.3217
WB-S19,1250,89,4777955.21,2567,8363,5796,7015.157303,1404.314243
WB-S2,1250,89,4777955.21,399,9908,9509,4927.483146,2604.804028
WB-S20,1250,90,4831640.1,7502,8339,837,7852.488889,186.0786718
WB-S21,1250,93,4992694.77,4593,8399,3806,7762.741935,635.0935907
WB-S22,1250,90,4831640.1,7215,7725,510,7549.688889,100.2524197
WB-S23,1250,93,4992694.77,3467,8296,4829,7276.16129,1346.162713
WB-S24,1250,91,4885324.99,587,5801,5214,2331.703297,1525.846603
WB-S25,1250,91,4885324.99,7355,7868,513,7671.725275,100.5377919
WB-S26,1250,90,4831640.1,3198,8674,5476,7508.622222,1414.825349
WB-S27,1250,90,4831640.1,7554,8192,638,7831.055556,128.2776815
WB-S28,1250,93,4992694.77,7699,8523,824,8066.376344,189.6650082
WB-S29,1250,93,4992694.77,6226,8996,2770,7110.666667,651.8910512
WB-S3,1250,93,4992694.77,3021,7528,4507,6367.860215,1263.392758
WB-S4,1250,89,4777955.21,818,7585,6767,2923.561798,1923.473409
WB-S5,1250,90,4831640.1,2368,7935,5567,5393.911111,1774.685885
WB-S6,1250,89,4777955.21,1468,7736,6268,4156.47191,1983.67391
WB-S7,1250,93,4992694.77,5393,8113,2720,7183.849462,399.3068442
WB-S8,1250,91,4885324.99,7262,8227,965,7695.56044,210.3662536
WB-S9,1250,91,4885324.99,137,7481,7344,3167.725275,2135.152459
WB-W1,1250,94,5046379.66,4064,8364,4300,7305.531915,656.6605506
WB-W10,1250,92,4939009.88,2202,8291,6089,5647.163043,1585.539692
WB-W2,1250,92,4939009.88,4549,8629,4080,8078.663043,677.1085308
WB-W3,1250,92,4939009.88,6439,8305,1866,7599.836957,631.9923685
WB-W4,1250,90,4831640.1,4548,7623,3075,5837.322222,749.6944093
WB-W5,1250,88,4724270.32,7376,8379,1003,7883.681818,165.2451035
WB-W6,1250,89,4777955.21,7561,8563,1002,8029.775281,277.7074992
WB-W7,1250,94,5046379.66,6098,9787,3689,7797.43617,744.7209896
WB-W8,1250,93,4992694.77,3647,8063,4416,6560.774194,1084.609896
WB-W9,1250,91,4885324.99,6355,8089,1734,7362.791209,441.3265845
W01,1500,132,7086405.48,5188,8432,3244,7814.234848,562.8118511
W02,1500,133,7140090.37,7635,8463,828,8068.097744,207.2114486
W03,1500,131,7032720.59,2838,8531,5693,6873.458015,1388.323209
W04,1500,128,6871665.92,7468,8509,1041,7973.757813,242.6726752
W05,1500,133,7140090.37,7520,8514,994,8008.150376,224.0983101
W06,1500,133,7140090.37,6696,8411,1715,7875.300752,317.273535
W07,1500,132,7086405.48,6290,8501,2211,7301.727273,487.1079634
W08,1500,132,7086405.48,1582,8617,7035,6436.098485,1908.694929
W09,1500,132,7086405.48,3572,8349,4777,7435.590909,1053.43475
W10,1500,133,7140090.37,3049,8306,5257,7403.902256,1173.128071
W11,1500,131,7032720.59,4064,8364,4300,7011.10687,952.0933565
W12,1500,133,7140090.37,5745,8266,2521,6869.533835,604.8295547
W13,1500,129,6925350.81,1576,7245,5669,6011.581395,1092.233589
W14,1500,131,7032720.59,5497,8191,2694,7514.847328,587.9282616
W15,1500,131,7032720.59,5597,8095,2498,7428.519084,455.983667
W16,1500,132,7086405.48,6361,9776,3415,7908.128788,533.9673041
W17,1500,133,7140090.37,7089,8349,1260,7771.894737,225.3591374
W18,1500,131,7032720.59,7262,8177,915,7845.007634,174.3797075
W19,1500,131,7032720.59,3201,8403,5202,7274.587786,752.6334009
W20,1500,130,6979035.7,5250,8146,2896,7115.246154,617.3583931
W21,1500,133,7140090.37,1793,8484,6691,6978.37594,1706.892554
W22,1500,129,6925350.81,-919,9979,10898,6412.170543,2490.751202
W23,1500,133,7140090.37,4201,6942,2741,5717.067669,606.9895293
W24,1500,132,7086405.48,1894,8089,6195,6845.909091,1407.463646
W25,1500,131,7032720.59,3880,8332,4452,7443.229008,745.7414934
W26,1500,131,7032720.59,120,8511,8391,4596.450382,2770.331579
W27,1500,131,7032720.59,6020,7844,1824,7243.030534,466.6829504
W28,1500,130,6979035.7,5404,8627,3223,7542.030769,642.1032021
W29,1500,133,7140090.37,6095,8281,2186,7512.804511,450.1463164
W30,1500,133,7140090.37,3445,8044,4599,6608.56391,940.4735598
W31,1500,130,6979035.7,6986,8354,1368,7736.730769,262.465933
W32,1500,131,7032720.59,5745,8670,2925,7892.374046,752.2014037
W33,1500,132,7086405.48,4852,8586,3734,7813.325758,857.3692982
W34,1500,134,7193775.26,4165,9134,4969,7798.492537,1062.895101
W35,1500,131,7032720.59,4228,8080,3852,7192.954198,955.3174275
W36,1500,133,7140090.37,1922,8235,6313,7093.609023,1348.870036
W37,1500,131,7032720.59,2127,9107,6980,6297.496183,2013.131207
W38,1500,135,7247460.15,3459,8444,4985,7546.274074,964.5398629
W39,1500,130,6979035.7,1893,8186,6293,6157.138462,1519.215312
W40,1500,133,7140090.37,2768,8329,5561,7383.669173,1057.665515
W41,1500,132,7086405.48,5756,8316,2560,7644.515152,405.6459399
W42,1500,132,7086405.48,5223,8149,2926,7503.575758,603.5273853
W43,1500,131,7032720.59,3167,8390,5223,7300.618321,872.9861314
W44,1500,133,7140090.37,2307,7927,5620,6691.180451,960.2730645
W45,1500,133,7140090.37,1400,8126,6726,6036.503759,2046.470432
W46,1500,135,7247460.15,1925,7818,5893,6419.911111,1574.480352
W47,1500,132,7086405.48,2495,8069,5574,6732.674242,1397.227029
W48,1500,132,7086405.48,7154,8086,932,7636.159091,230.658078
W49,1500,130,6979035.7,4024,7546,3522,6807.115385,554.6443994
W50,1500,132,7086405.48,4455,8985,4530,7720.878788,875.4870768
W51,1500,131,7032720.59,6399,8039,1640,7320.061069,380.8648606
W52,1500,131,7032720.59,1552,7919,6367,4363.572519,1978.902152
W53,1500,133,7140090.37,4109,8360,4251,7469.849624,910.4385417
W54,1500,136,7301145.04,3343,8072,4729,6709.294118,1267.084565
W55,1500,129,6925350.81,6560,8080,1520,7636.48062,273.012312
W56,1500,132,7086405.48,4045,9919,5874,7962.916667,1052.39203
W57,1500,133,7140090.37,2199,8660,6461,6214.195489,1604.436071
W58,1500,129,6925350.81,4670,8380,3710,7262.697674,877.1548581
W59,1500,132,7086405.48,1194,8597,7403,5817.030303,2009.589981
W60,1500,132,7086405.48,6467,7897,1430,7276.530303,327.0725626
W61,1500,133,7140090.37,3709,8069,4360,6924.706767,1265.675366
W62,1500,131,7032720.59,1238,8132,6894,5729.358779,2093.152457
W63,1500,131,7032720.59,279,8139,7860,5574.366412,2275.44159
W64,1500,135,7247460.15,4471,7266,2795,6580.311111,719.3668458
W65,1500,130,6979035.7,1409,8000,6591,6328.884615,1657.867224
W66,1500,134,7193775.26,1180,7709,6529,6176.029851,1446.41949
WB-E1,1500,130,6979035.7,715,8396,7681,3818.815385,2158.403847
WB-E10,1500,132,7086405.48,765,8322,7557,3249.55303,1754.674758
WB-E2,1500,133,7140090.37,5312,7465,2153,6856.571429,516.6519063
WB-E3,1500,132,7086405.48,6065,8131,2066,7605.643939,361.6838175
WB-E4,1500,132,7086405.48,7612,8586,974,8053.030303,265.0364452
WB-E5,1500,131,7032720.59,273,9051,8778,5052.465649,2864.408774
WB-E6,1500,130,6979035.7,7145,8039,894,7620.230769,197.505386
WB-E7,1500,131,7032720.59,1600,7758,6158,6322.503817,1865.771884
WB-E8,1500,131,7032720.59,2280,8395,6115,7364.015267,1147.880835
WB-E9,1500,124,6656926.36,3856,8446,4590,7575.814516,848.1392571
WB-H1,1500,135,7247460.15,3309,8131,4822,7011.985185,803.4519966
WB-H10,1500,131,7032720.59,2078,8208,6130,5790.854962,1870.198586
WB-H2,1500,130,6979035.7,1980,8555,6575,6154.984615,2052.372754
WB-H3,1500,134,7193775.26,1109,9158,8049,5183.61194,2348.837165
WB-H4,1500,132,7086405.48,1662,8034,6372,6349.939394,1954.896679
WB-H5,1500,131,7032720.59,882,8220,7338,4471.236641,2440.294807
WB-H6,1500,131,7032720.59,688,9091,8403,5198.541985,2479.451689
WB-H7,1500,133,7140090.37,598,9834,9236,5832.12782,2519.875416
WB-H8,1500,133,7140090.37,2358,8385,6027,5365.593985,1842.491204
WB-H9,1500,130,6979035.7,636,7200,6564,2601.315385,1627.688418
WB-S1,1500,133,7140090.37,892,9453,8561,5028.233083,2248.592642
WB-S10,1500,134,7193775.26,-1058,7876,8934,5200.432836,2108.661192
WB-S11,1500,132,7086405.48,1058,7755,6697,5478.416667,1978.080088
WB-S12,1500,129,6925350.81,1231,8286,7055,5075.108527,2018.39099
WB-S13,1500,130,6979035.7,1328,6981,5653,4392.330769,1332.408781
WB-S14,1500,124,6656926.36,5013,8197,3184,7403.274194,705.1954698
WB-S15,1500,135,7247460.15,1680,7796,6116,6325.777778,1664.874137
WB-S16,1500,130,6979035.7,729,8389,7660,4508.769231,2111.677567
WB-S17,1500,133,7140090.37,3093,8044,4951,6807.383459,1404.463597
WB-S18,1500,132,7086405.48,1814,9087,7273,6237.742424,2316.182611
WB-S19,1500,131,7032720.59,1940,8363,6423,6781.648855,1622.30427
WB-S2,1500,130,6979035.7,-119,9908,10027,4931.523077,2930.897209
WB-S20,1500,130,6979035.7,7502,8512,1010,7883.1,211.3640989
WB-S21,1500,131,7032720.59,4593,8399,3806,7690.732824,711.4864219
WB-S22,1500,132,7086405.48,7215,7725,510,7541.083333,99.05722571
WB-S23,1500,133,7140090.37,2856,8296,5440,7340.962406,1241.144841
WB-S24,1500,130,6979035.7,587,6616,6029,2461.1,1599.628913
WB-S25,1500,131,7032720.59,4544,7975,3431,7655.969466,299.2346711
WB-S26,1500,131,7032720.59,3198,8674,5476,7713.549618,1274.29942
WB-S27,1500,130,6979035.7,7503,8192,689,7829.823077,141.7791058
WB-S28,1500,133,7140090.37,6173,8523,2350,8015.646617,292.3972526
WB-S29,1500,132,7086405.48,6226,9491,3265,7241.075758,819.6532491
WB-S3,1500,133,7140090.37,2509,7771,5262,6216.037594,1397.324917
WB-S4,1500,131,7032720.59,639,8172,7533,3278.916031,2176.452861
WB-S5,1500,132,7086405.48,2357,8051,5694,5523.484848,1931.915479
WB-S6,1500,131,7032720.59,1468,7736,6268,4076.122137,2035.455543
WB-S7,1500,131,7032720.59,5393,8113,2720,7239.045802,397.3961214
WB-S8,1500,130,6979035.7,7262,8227,965,7711.553846,223.9901118
WB-S9,1500,130,6979035.7,51,7762,7711,3350.138462,2253.98299
WB-W1,1500,135,7247460.15,4064,8364,4300,7220.562963,834.4194398
WB-W10,1500,130,6979035.7,2202,8291,6089,5610.9,1608.714794
WB-W2,1500,133,7140090.37,4549,8629,4080,8040.654135,603.4069942
WB-W3,1500,133,7140090.37,6439,8730,2291,7532.864662,652.868532
WB-W4,1500,131,7032720.59,4356,7623,3267,5902.824427,762.2340656
WB-W5,1500,124,6656926.36,6952,8379,1427,7869,197.268525
WB-W6,1500,131,7032720.59,7426,8581,1155,8018.526718,304.8381708
WB-W7,1500,133,7140090.37,6069,9913,3844,7794.819549,784.2902623
WB-W8,1500,131,7032720.59,3647,8067,4420,6576.519084,1066.945904
WB-W9,1500,132,7086405.48,5205,8237,3032,7388.871212,501.2936508
W01,1750,180,9663280.2,2285,8437,6152,7603.266667,1118.128062
W02,1750,180,9663280.2,6778,8597,1819,8059.011111,248.3669102
W03,1750,179,9609595.31,2444,8531,6087,6849.893855,1475.992224
W04,1750,177,9502225.53,7387,8523,1136,7984.841808,248.8023922
W05,1750,182,9770649.98,6776,8567,1791,7991.708791,268.291886
W06,1750,181,9716965.09,6506,8411,1905,7843.359116,361.9012385
W07,1750,180,9663280.2,6290,8501,2211,7277.194444,514.8834075
W08,1750,181,9716965.09,1582,8617,7035,6210.966851,2014.052853
W09,1750,180,9663280.2,3572,8349,4777,7491.655556,1008.530825
W10,1750,179,9609595.31,3049,8688,5639,7471.167598,1064.71078
W11,1750,181,9716965.09,3932,8364,4432,6976.18232,1000.069
W12,1750,181,9716965.09,5491,8266,2775,6857.828729,651.9344597
W13,1750,178,9555910.42,1394,7268,5874,5836.792135,1287.254092
W14,1750,181,9716965.09,5497,8359,2862,7516.220994,611.9136867
W15,1750,180,9663280.2,2555,8095,5540,7264.338889,914.5284952
W16,1750,180,9663280.2,6361,9776,3415,7999.427778,653.222661
W17,1750,181,9716965.09,7089,8421,1332,7809.220994,246.9605641
W18,1750,178,9555910.42,4890,8210,3320,7795.617978,343.4753481
W19,1750,179,9609595.31,1381,8403,7022,7180.865922,1109.997465
W20,1750,179,9609595.31,5250,8151,2901,7095.927374,619.0108981
W21,1750,181,9716965.09,477,8484,8007,6604.430939,2047.483922
W22,1750,178,9555910.42,-919,9979,10898,6278.792135,2407.666915
W23,1750,180,9663280.2,4201,6942,2741,5744.166667,590.8413352
W24,1750,181,9716965.09,1444,8176,6732,6497.773481,1695.038068
W25,1750,178,9555910.42,1627,8332,6705,7194.505618,1137.938296
W26,1750,177,9502225.53,120,8511,8391,4419.175141,2708.243354
W27,1750,180,9663280.2,6020,7844,1824,7309.805556,432.7460905
W28,1750,182,9770649.98,3679,8627,4948,7428.423077,792.3209904
W29,1750,179,9609595.31,5274,8415,3141,7476.826816,500.1827355
W30,1750,180,9663280.2,3445,8044,4599,6606.927778,987.5835719
W31,1750,178,9555910.42,6909,8354,1445,7747.073034,261.1657751
W32,1750,181,9716965.09,5522,8670,3148,7943.447514,718.1510974
W33,1750,182,9770649.98,4852,8702,3850,7847.197802,828.8677133
W34,1750,179,9609595.31,1961,9134,7173,7355.832402,1637.851118
W35,1750,181,9716965.09,3413,8336,4923,7205.127072,985.9161151
W36,1750,180,9663280.2,1922,8235,6313,6963.211111,1455.511353
W37,1750,177,9502225.53,1249,9107,7858,6146.446328,2149.833116
W38,1750,180,9663280.2,3459,8555,5096,7619.772222,854.6689407
W39,1750,179,9609595.31,1893,8215,6322,6353.396648,1491.711995
W40,1750,180,9663280.2,2089,8408,6319,7299.861111,1208.452319
W41,1750,179,9609595.31,5071,8353,3282,7593.581006,481.2544454
W42,1750,177,9502225.53,4393,8149,3756,7514.039548,627.2670915
W43,1750,178,9555910.42,2688,8390,5702,7199.938202,980.7330333
W44,1750,179,9609595.31,2307,7927,5620,6756.502793,965.8058804
W45,1750,180,9663280.2,1400,8134,6734,6111.838889,2040.113636
W46,1750,183,9824334.87,1666,7970,6304,6445.300546,1632.906485
W47,1750,181,9716965.09,2495,8069,5574,6735.773481,1394.210313
W48,1750,182,9770649.98,7038,8156,1118,7627.384615,231.2607476
W49,1750,178,9555910.42,4024,7592,3568,6734.910112,656.3674488
W50,1750,179,9609595.31,4173,8985,4812,7562.223464,953.3582251
W51,1750,181,9716965.09,6399,8055,1656,7353.563536,376.3222033
W52,1750,180,9663280.2,1552,7919,6367,4516.038889,2115.539199
W53,1750,179,9609595.31,4109,8360,4251,7460.675978,847.4653936
W54,1750,179,9609595.31,3195,8072,4877,6580.787709,1366.047436
W55,1750,178,9555910.42,3537,8153,4616,7517.044944,547.9154247
W56,1750,181,9716965.09,2818,9919,7101,7791.961326,1245.193079
W57,1750,181,9716965.09,2003,8660,6657,5816.78453,1747.463988
W58,1750,178,9555910.42,4469,8990,4521,7294.589888,941.672714
W59,1750,178,9555910.42,1194,8597,7403,5809.876404,2010.170728
W60,1750,177,9502225.53,5942,7897,1955,7257.621469,367.2468315
W61,1750,181,9716965.09,3709,8090,4381,7036.464088,1221.593364
W62,1750,179,9609595.31,1238,8132,6894,5535.687151,2185.328108
W63,1750,180,9663280.2,279,8139,7860,5114.072222,2385.188017
W64,1750,179,9609595.31,4466,7611,3145,6624.039106,691.8485348
W65,1750,177,9502225.53,1006,8000,6994,5751.305085,2088.309661
W66,1750,182,9770649.98,1180,7709,6529,5780.049451,1828.876396
WB-E1,1750,178,9555910.42,715,8396,7681,4359.539326,2297.839582
WB-E10,1750,181,9716965.09,377,8597,8220,3443.790055,1989.552839
WB-E2,1750,180,9663280.2,5312,7741,2429,6885.688889,526.2925917
WB-E3,1750,179,9609595.31,5874,8131,2257,7599.145251,359.7637355
WB-E4,1750,181,9716965.09,7612,8586,974,8073.933702,259.5503677
WB-E5,1750,177,9502225.53,273,9051,8778,4977.146893,2855.152124
WB-E6,1750,180,9663280.2,6276,8240,1964,7584.877778,249.0788509
WB-E7,1750,178,9555910.42,1600,7962,6362,6279.38764,1882.500104
WB-E8,1750,177,9502225.53,2280,8395,6115,7308.824859,1216.76542
WB-E9,1750,180,9663280.2,2810,8486,5676,7223.766667,1300.165199
WB-H1,1750,179,9609595.31,2057,8221,6164,6952.206704,1036.731147
WB-H10,1750,180,9663280.2,2078,8208,6130,5795.022222,1910.334441
WB-H2,1750,179,9609595.31,1978,8555,6577,5993.631285,2088.055289
WB-H3,1750,180,9663280.2,1109,9158,8049,5452.288889,2487.260261
WB-H4,1750,177,9502225.53,1491,8203,6712,6143.480226,2091.783615
WB-H5,1750,177,9502225.53,882,8424,7542,4421.903955,2521.461955
WB-H6,1750,181,9716965.09,688,9276,8588,5010.983425,2543.606696
WB-H7,1750,179,9609595.31,172,9834,9662,5494.078212,2692.674641
WB-H8,1750,180,9663280.2,2357,8874,6517,5342.4,1922.67829
WB-H9,1750,179,9609595.31,636,8245,7609,2851.659218,1830.202288
WB-S1,1750,180,9663280.2,4,9453,9449,4988.738889,2432.974296
WB-S10,1750,181,9716965.09,-1058,7898,8956,4897.729282,2248.850139
WB-S11,1750,180,9663280.2,1023,7820,6797,5135.027778,2202.906087
WB-S12,1750,180,9663280.2,1194,8286,7092,5051.577778,2031.657334
WB-S13,1750,178,9555910.42,882,7456,6574,4195.47191,1470.586416
WB-S14,1750,180,9663280.2,4472,8197,3725,7411.644444,712.6456625
WB-S15,1750,180,9663280.2,1666,7796,6130,6298.805556,1691.523321
WB-S16,1750,178,9555910.42,262,8408,8146,4521.123596,2255.512622
WB-S17,1750,179,9609595.31,3093,8154,5061,6842.765363,1385.614077
WB-S18,1750,178,9555910.42,1764,9087,7323,6026.123596,2434.87904
WB-S19,1750,177,9502225.53,1940,8398,6458,6675.559322,1734.02181
WB-S2,1750,180,9663280.2,-230,9908,10138,4809.677778,3238.536221
WB-S20,1750,179,9609595.31,7502,8750,1248,7909.284916,223.706967
WB-S21,1750,181,9716965.09,3855,8399,4544,7472.187845,952.8896663
WB-S22,1750,177,9502225.53,7215,7752,537,7538.79661,100.1842562
WB-S23,1750,179,9609595.31,2856,8296,5440,7363.162011,1224.092062
WB-S24,1750,180,9663280.2,587,7196,6609,2644.555556,1759.438475
WB-S25,1750,178,9555910.42,4544,8040,3496,7596.230337,553.7861488
WB-S26,1750,179,9609595.31,3198,8750,5552,7830.072626,1167.438781
WB-S27,1750,178,9555910.42,7184,8192,1008,7830.05618,163.8238201
WB-S28,1750,180,9663280.2,4708,8523,3815,7954.9,492.5914929
WB-S29,1750,181,9716965.09,6226,9491,3265,7311.441989,873.1193163
WB-S3,1750,180,9663280.2,2509,7891,5382,6221.316667,1370.33503
WB-S4,1750,178,9555910.42,639,8662,8023,3704.58427,2401.176253
WB-S5,1750,178,9555910.42,2251,8250,5999,5596.567416,1991.388119
WB-S6,1750,177,9502225.53,1468,7854,6386,4007.915254,1952.382988
WB-S7,1750,180,9663280.2,5393,8113,2720,7294.477778,398.2341642
WB-S8,1750,179,9609595.31,5870,8311,2441,7715.212291,286.6125987
WB-S9,1750,177,9502225.53,51,7855,7804,3563.412429,2358.456386
WB-W1,1750,180,9663280.2,4064,8539,4475,7105.488889,958.5833789
WB-W10,1750,181,9716965.09,381,8532,8151,5639.287293,1678.122045
WB-W2,1750,179,9609595.31,4549,8629,4080,8006.715084,559.5055702
WB-W3,1750,179,9609595.31,6405,8898,2493,7471.893855,701.6675787
WB-W4,1750,177,9502225.53,4356,7720,3364,5982.666667,809.5343201
WB-W5,1750,180,9663280.2,5462,8379,2917,7754.716667,486.0204074
WB-W6,1750,177,9502225.53,7426,8581,1155,8025.361582,304.0878261
WB-W7,1750,180,9663280.2,5843,9913,4070,7778.755556,826.2531198
WB-W8,1750,180,9663280.2,3647,8067,4420,6578.761111,1071.226236
WB-W9,1750,177,9502225.53,5180,8237,3057,7383.988701,578.3944853
W01,2000,234,12562264.26,2285,8437,6152,7419.799145,1358.596022
W02,2000,235,12615949.15,6696,8601,1905,8052.370213,300.9120518
W03,2000,236,12669634.04,1912,8531,6619,6936.601695,1507.812256
W04,2000,236,12669634.04,7387,8523,1136,7991.711864,244.1361666
W05,2000,233,12508579.37,6776,8875,2099,7982.527897,293.3752235
W06,2000,232,12454894.48,6506,8411,1905,7809.961207,401.0295514
W07,2000,232,12454894.48,5970,8501,2531,7237.293103,549.4049919
W08,2000,232,12454894.48,1582,8617,7035,6190.24569,2064.80059
W09,2000,234,12562264.26,3572,8349,4777,7613.311966,917.8899768
W10,2000,234,12562264.26,3049,8688,5639,7507.290598,1063.200631
W11,2000,233,12508579.37,3932,8539,4607,6948.012876,1045.373964
W12,2000,233,12508579.37,3289,8266,4977,6803.381974,734.2562352
W13,2000,236,12669634.04,1394,7626,6232,5723.288136,1387.726898
W14,2000,234,12562264.26,5497,8359,2862,7519.602564,595.3046338
W15,2000,234,12562264.26,2555,8213,5658,7160.576923,1155.132562
W16,2000,234,12562264.26,4056,9776,5720,8003.679487,798.5557716
W17,2000,234,12562264.26,4744,8521,3777,7806.816239,374.5082879
W18,2000,234,12562264.26,4890,8362,3472,7761.264957,455.7323944
W19,2000,232,12454894.48,1381,8403,7022,7102.50431,1284.920489
W20,2000,233,12508579.37,5250,8151,2901,7102.914163,625.8605347
W21,2000,233,12508579.37,477,8484,8007,6336.695279,2252.498888
W22,2000,236,12669634.04,-919,9979,10898,6036.148305,2449.107653
W23,2000,232,12454894.48,4201,7095,2894,5787.301724,595.6273311
W24,2000,234,12562264.26,1444,8176,6732,6316.547009,1828.099349
W25,2000,233,12508579.37,580,8332,7752,6930.699571,1605.152416
W26,2000,235,12615949.15,120,8511,8391,4283.178723,2645.869729
W27,2000,233,12508579.37,6020,8038,2018,7330.364807,435.4357001
W28,2000,234,12562264.26,3476,8627,5151,7371.081197,900.9372837
W29,2000,234,12562264.26,4195,8415,4220,7436.15812,628.1977993
W30,2000,232,12454894.48,3445,8154,4709,6581.396552,1030.027807
W31,2000,232,12454894.48,6562,8373,1811,7753.474138,274.8927365
W32,2000,235,12615949.15,5522,8670,3148,8019.285106,675.1144644
W33,2000,233,12508579.37,4596,8702,4106,7867.081545,841.5292014
W34,2000,235,12615949.15,1961,9134,7173,7010.442553,1921.437888
W35,2000,233,12508579.37,3261,8344,5083,7200.193133,1062.362394
W36,2000,234,12562264.26,1922,8235,6313,6918.051282,1537.504718
W37,2000,235,12615949.15,1249,9107,7858,6019.770213,2275.421612
W38,2000,236,12669634.04,3459,8555,5096,7678.427966,761.2877131
W39,2000,234,12562264.26,1893,8215,6322,6565.940171,1433.622543
W40,2000,235,12615949.15,2089,8408,6319,7168.87234,1352.818546
W41,2000,233,12508579.37,4040,8353,4313,7580.197425,537.320282
W42,2000,234,12562264.26,4309,8246,3937,7454.645299,708.5701793
W43,2000,235,12615949.15,2688,8390,5702,7211.174468,1009.504057
W44,2000,233,12508579.37,2307,8094,5787,6787.759657,1025.808168
W45,2000,231,12401209.59,1400,8736,7336,6175.865801,2034.214165
W46,2000,234,12562264.26,1666,7970,6304,6391.717949,1686.540143
W47,2000,234,12562264.26,2495,8465,5970,6779.115385,1350.368294
W48,2000,234,12562264.26,6788,8156,1368,7605.696581,245.0668447
W49,2000,234,12562264.26,2729,7684,4955,6477.128205,1026.142553
W50,2000,235,12615949.15,3807,8985,5178,7448.838298,976.9877019
W51,2000,234,12562264.26,6399,8055,1656,7366.57265,355.4037987
W52,2000,236,12669634.04,1552,8026,6474,4671.084746,2203.889136
W53,2000,234,12562264.26,4109,8360,4251,7438.551282,784.8285563
W54,2000,237,12723318.93,3175,8124,4949,6395.78481,1502.239392
W55,2000,236,12669634.04,3537,8168,4631,7423.415254,741.3896174
W56,2000,234,12562264.26,1340,9919,8579,7537.837607,1501.943743
W57,2000,235,12615949.15,2003,8660,6657,5476.774468,1848.182087
W58,2000,236,12669634.04,3773,8990,5217,7305.639831,1045.740737
W59,2000,235,12615949.15,1194,8597,7403,5760.774468,1971.226471
W60,2000,235,12615949.15,5942,7897,1955,7261.73617,380.2855122
W61,2000,235,12615949.15,2645,8090,5445,7112.26383,1172.153533
W62,2000,236,12669634.04,860,8132,7272,5416.720339,2211.261891
W63,2000,233,12508579.37,279,8139,7860,4602.39485,2494.847917
W64,2000,236,12669634.04,3810,7611,3801,6628.080508,720.9589702
W65,2000,233,12508579.37,890,8000,7110,5235.879828,2336.698835
W66,2000,234,12562264.26,1180,7905,6725,5534.034188,1976.244768
WB-E1,2000,232,12454894.48,715,8396,7681,4640.060345,2357.899527
WB-E10,2000,233,12508579.37,377,8597,8220,3497.695279,2090.202329
WB-E2,2000,232,12454894.48,5180,7741,2561,6938.715517,529.9469037
WB-E3,2000,234,12562264.26,5874,8138,2264,7589.747863,358.4176056
WB-E4,2000,234,12562264.26,6621,8586,1965,8082.205128,285.7355342
WB-E5,2000,233,12508579.37,273,9051,8778,4841.244635,2731.210398
WB-E6,2000,234,12562264.26,5764,8240,2476,7559.260684,300.2189023
WB-E7,2000,235,12615949.15,1600,8076,6476,6202.404255,1903.180264
WB-E8,2000,235,12615949.15,2280,8395,6115,7128.519149,1385.233307
WB-E9,2000,237,12723318.93,2234,8511,6277,6917.350211,1589.897587
WB-H1,2000,235,12615949.15,1446,8221,6775,6783.195745,1374.011956
WB-H10,2000,233,12508579.37,2078,8208,6130,5746.609442,1924.48361
WB-H2,2000,235,12615949.15,1782,8556,6774,5943.229787,2146.775712
WB-H3,2000,234,12562264.26,1109,9158,8049,5648.653846,2538.85138
WB-H4,2000,235,12615949.15,1491,8203,6712,5966.319149,2202.24473
WB-H5,2000,235,12615949.15,882,8424,7542,4456.523404,2519.52566
WB-H6,2000,234,12562264.26,688,9276,8588,5024.401709,2554.338359
WB-H7,2000,235,12615949.15,172,9834,9662,5281.953191,2756.636025
WB-H8,2000,234,12562264.26,1942,8874,6932,5343.311966,1995.857923
WB-H9,2000,236,12669634.04,636,8333,7697,3078.423729,2038.080939
WB-S1,2000,234,12562264.26,-151,9453,9604,4990.82906,2690.097672
WB-S10,2000,234,12562264.26,-1058,7975,9033,4642.893162,2328.46358
WB-S11,2000,232,12454894.48,938,7820,6882,4897,2289.454194
WB-S12,2000,233,12508579.37,1194,8286,7092,5111.266094,1995.158978
WB-S13,2000,234,12562264.26,882,8427,7545,4185.935897,1671.657977
WB-S14,2000,236,12669634.04,2761,8628,5867,7404.775424,755.305907
WB-S15,2000,236,12669634.04,1666,7818,6152,6369.665254,1678.022094
WB-S16,2000,232,12454894.48,262,8408,8146,4603.534483,2310.356986
WB-S17,2000,235,12615949.15,3093,8154,5061,6922.229787,1313.534416
WB-S18,2000,234,12562264.26,1462,9203,7741,5940.713675,2507.572368
WB-S19,2000,235,12615949.15,1432,8398,6966,6525.791489,1882.091185
WB-S2,2000,235,12615949.15,-325,9908,10233,4693.47234,3385.40135
WB-S20,2000,236,12669634.04,5580,8750,3170,7895.830508,303.803371
WB-S21,2000,233,12508579.37,3019,8399,5380,7313.579399,1107.114462
WB-S22,2000,235,12615949.15,7215,7752,537,7540.629787,101.9054796
WB-S23,2000,235,12615949.15,2493,8296,5803,7338.514894,1285.02871
WB-S24,2000,235,12615949.15,587,7842,7255,2876.119149,1977.53492
WB-S25,2000,235,12615949.15,4544,8180,3636,7581.297872,599.6436784
WB-S26,2000,233,12508579.37,3198,8855,5657,7929.703863,1071.435743
WB-S27,2000,236,12669634.04,7184,8392,1208,7849.733051,177.3227234
WB-S28,2000,234,12562264.26,4708,8523,3815,7877.91453,635.9314734
WB-S29,2000,234,12562264.26,6226,9569,3343,7424.410256,955.1940703
WB-S3,2000,234,12562264.26,2509,8168,5659,6172.102564,1378.352993
WB-S4,2000,236,12669634.04,639,8830,8191,4094.639831,2524.243666
WB-S5,2000,235,12615949.15,2251,8463,6212,5699.195745,2020.986091
WB-S6,2000,235,12615949.15,1468,7854,6386,3942.259574,1897.508213
WB-S7,2000,232,12454894.48,5393,8113,2720,7317.366379,392.7714955
WB-S8,2000,235,12615949.15,5096,8367,3271,7701.723404,401.4968219
WB-S9,2000,233,12508579.37,51,9979,9928,3888.077253,2511.463403
WB-W1,2000,237,12723318.93,1672,8539,6867,7007.320675,1110.212573
WB-W10,2000,234,12562264.26,381,8532,8151,5664.594017,1655.724068
WB-W2,2000,234,12562264.26,4549,8629,4080,7952.602564,586.6707533
WB-W3,2000,233,12508579.37,6274,8998,2724,7437.2103,734.2472151
WB-W4,2000,235,12615949.15,4356,7720,3364,6056.259574,822.1495675
WB-W5,2000,236,12669634.04,5462,8379,2917,7720.402542,475.3147519
WB-W6,2000,235,12615949.15,7426,8586,1160,8025.782979,295.138885
WB-W7,2000,233,12508579.37,3311,9913,6602,7689.218884,968.2975677
WB-W8,2000,233,12508579.37,3647,8067,4420,6592.48927,1028.226917
WB-W9,2000,234,12562264.26,2387,8566,6179,7320.92735,831.1817397
W01,2250,296,15890727.44,2285,8437,6152,7354.783784,1397.671053
W02,2250,295,15837042.55,3182,8639,5457,8019.742373,453.2403576
W03,2250,297,15944412.33,1912,8531,6619,6960.323232,1604.882102
W04,2250,300,16105467,7387,8523,1136,7989.886667,235.767245
W05,2250,295,15837042.55,5094,8875,3781,7962.752542,461.6906402
W06,2250,294,15783357.66,4618,8411,3793,7807.877551,459.3003759
W07,2250,298,15998097.22,5952,8523,2571,7208.822148,565.6992097
W08,2250,294,15783357.66,1550,8617,7067,6061.629252,2193.298327
W09,2250,296,15890727.44,3572,8481,4909,7680.057432,874.1066598
W10,2250,296,15890727.44,2772,8688,5916,7460.050676,1193.713848
W11,2250,294,15783357.66,1672,8539,6867,6863.561224,1235.392976
W12,2250,299,16051782.11,1315,8266,6951,6596.792642,1045.681828
W13,2250,300,16105467,1394,8023,6629,5617.203333,1474.077787
W14,2250,298,15998097.22,5497,8359,2862,7482.751678,610.2472753
W15,2250,297,15944412.33,1883,8213,6330,7077.020202,1362.536032
W16,2250,295,15837042.55,3726,9776,6050,7975.186441,961.8376387
W17,2250,295,15837042.55,3436,8521,5085,7760.138983,614.6074875
W18,2250,297,15944412.33,2568,8449,5881,7690.397306,723.0257343
W19,2250,298,15998097.22,726,8415,7689,6999.104027,1480.424492
W20,2250,297,15944412.33,5250,8151,2901,7109.558923,631.9406783
W21,2250,298,15998097.22,477,8484,8007,6137.439597,2324.486946
W22,2250,297,15944412.33,-919,9979,10898,5779.053872,2565.776506
W23,2250,296,15890727.44,4201,7511,3310,5850.685811,638.0568362
W24,2250,296,15890727.44,1081,8196,7115,6070.976351,1987.675866
W25,2250,298,15998097.22,368,8332,7964,6699.802013,1887.238284
W26,2250,296,15890727.44,120,8511,8391,4236.043919,2562.324059
W27,2250,296,15890727.44,5922,8038,2116,7336.75,454.124847
W28,2250,300,16105467,1795,8627,6832,7232.06,1146.050835
W29,2250,297,15944412.33,3182,8626,5444,7375.488215,817.8998486
W30,2250,296,15890727.44,3093,8154,5061,6662.118243,1045.467241
W31,2250,298,15998097.22,6562,8412,1850,7780.402685,295.3456721
W32,2250,295,15837042.55,5522,8836,3314,8048.911864,679.1734301
W33,2250,296,15890727.44,4381,8702,4321,7841.199324,918.0333365
W34,2250,293,15729672.77,1465,9134,7669,6677.286689,2146.129452
W35,2250,295,15837042.55,2582,8470,5888,7081.728814,1246.879253
W36,2250,296,15890727.44,1922,8235,6313,6918.540541,1526.537731
W37,2250,297,15944412.33,1249,9107,7858,6027.882155,2292.771134
W38,2250,293,15729672.77,3459,8555,5096,7719.139932,695.9870131
W39,2250,298,15998097.22,1893,8215,6322,6754.781879,1360.347896
W40,2250,296,15890727.44,2089,8419,6330,7083.543919,1421.859645
W41,2250,297,15944412.33,3889,8368,4479,7570.138047,597.0469285
W42,2250,297,15944412.33,4309,8327,4018,7430.276094,726.3768196
W43,2250,297,15944412.33,2688,8390,5702,7168.686869,1108.969367
W44,2250,298,15998097.22,2307,8162,5855,6879.59396,1021.49652
W45,2250,297,15944412.33,1400,8736,7336,6326.289562,1966.515864
W46,2250,295,15837042.55,1659,7970,6311,6375.454237,1635.036575
W47,2250,298,15998097.22,2074,8465,6391,6713.681208,1460.10646
W48,2250,298,15998097.22,6788,8156,1368,7596.456376,248.6383315
W49,2250,297,15944412.33,2199,7841,5642,6198.919192,1329.956894
W50,2250,297,15944412.33,3807,8985,5178,7385.801347,962.4529046
W51,2250,296,15890727.44,6163,8071,1908,7373.824324,352.355006
W52,2250,299,16051782.11,1439,8130,6691,4743.247492,2241.207028
W53,2250,297,15944412.33,4109,8360,4251,7431.838384,728.6663438
W54,2250,293,15729672.77,2704,8124,5420,6214.771331,1609.22848
W55,2250,300,16105467,2033,8268,6235,7316.293333,973.9126042
W56,2250,296,15890727.44,1177,9919,8742,7331.506757,1650.104409
W57,2250,295,15837042.55,1759,8660,6901,5242.155932,1899.020639
W58,2250,298,15998097.22,2979,8990,6011,7320.734899,1094.68923
W59,2250,296,15890727.44,1194,8597,7403,5629.942568,1969.789658
W60,2250,297,15944412.33,5942,7897,1955,7268.198653,381.3870101
W61,2250,295,15837042.55,2645,8090,5445,7196.311864,1097.773873
W62,2250,299,16051782.11,860,8132,7272,5345.839465,2254.199573
W63,2250,297,15944412.33,279,8139,7860,4165.06734,2585.174708
W64,2250,293,15729672.77,2595,7940,5345,6606.832765,820.1753721
W65,2250,298,15998097.22,807,8000,7193,4774.211409,2488.142183
W66,2250,295,15837042.55,920,7905,6985,5179.708475,2118.719494
WB-E1,2250,296,15890727.44,715,8396,7681,4854.89527,2447.941257
WB-E10,2250,296,15890727.44,377,8597,8220,3473.375,2178.544724
WB-E2,2250,296,15890727.44,5180,7799,2619,6988.591216,532.0939244
WB-E3,2250,297,15944412.33,4294,8201,3907,7544.37037,456.5176977
WB-E4,2250,299,16051782.11,5706,8586,2880,8049.16388,372.5133607
WB-E5,2250,297,15944412.33,273,9051,8778,4603.892256,2683.923503
WB-E6,2250,298,15998097.22,5764,8340,2576,7529.724832,373.0523536
WB-E7,2250,296,15890727.44,1600,8217,6617,6205.081081,1866.960688
WB-E8,2250,296,15890727.44,2280,8395,6115,6978.702703,1513.889645
WB-E9,2250,300,16105467,2168,8511,6343,6552.23,1865.413846
WB-H1,2250,293,15729672.77,1375,8441,7066,6648.730375,1606.466266
WB-H10,2250,296,15890727.44,2078,8208,6130,5844.597973,1879.521857
WB-H2,2250,297,15944412.33,1782,8556,6774,5967.983165,2166.522521
WB-H3,2250,295,15837042.55,1109,9158,8049,5874.508475,2519.623649
WB-H4,2250,297,15944412.33,1491,8455,6964,5850.976431,2285.851631
WB-H5,2250,297,15944412.33,882,8460,7578,4516.387205,2498.998412
WB-H6,2250,298,15998097.22,688,9891,9203,5158.439597,2556.886013
WB-H7,2250,296,15890727.44,172,9834,9662,5011.439189,2779.407558
WB-H8,2250,296,15890727.44,1938,8956,7018,5454.692568,2078.192348
WB-H9,2250,298,15998097.22,636,8396,7760,3398.842282,2249.867262
WB-S1,2250,294,15783357.66,-158,9819,9977,4942.44898,2869.931573
WB-S10,2250,296,15890727.44,-1058,7975,9033,4417.554054,2373.569023
WB-S11,2250,295,15837042.55,742,7820,7078,4712.464407,2388.604633
WB-S12,2250,298,15998097.22,1194,8597,7403,5136.124161,2000.805112
WB-S13,2250,298,15998097.22,882,8639,7757,4237.899329,1740.82254
WB-S14,2250,300,16105467,2761,8628,5867,7359.54,815.9520013
WB-S15,2250,293,15729672.77,1659,8222,6563,6436.515358,1655.597651
WB-S16,2250,296,15890727.44,262,8408,8146,4657.094595,2314.710568
WB-S17,2250,296,15890727.44,2645,8182,5537,6951.72973,1289.73909
WB-S18,2250,297,15944412.33,1364,9203,7839,5910.171717,2480.882223
WB-S19,2250,297,15944412.33,1432,8398,6966,6379.164983,1991.073942
WB-S2,2250,298,15998097.22,-670,9908,10578,4648.255034,3506.660821
WB-S20,2250,298,15998097.22,5580,8750,3170,7887.436242,348.6649191
WB-S21,2250,295,15837042.55,3018,8399,5381,7151.311864,1212.548166
WB-S22,2250,297,15944412.33,6671,7823,1152,7537.346801,117.3834443
WB-S23,2250,295,15837042.55,1031,8296,7265,7232.711864,1414.568857
WB-S24,2250,299,16051782.11,587,8412,7825,3144.461538,2220.886462
WB-S25,2250,297,15944412.33,4544,8305,3761,7586.548822,578.8786663
WB-S26,2250,296,15890727.44,3198,8855,5657,7985.766892,1012.460735
WB-S27,2250,294,15783357.66,7184,8460,1276,7872.663265,187.1146804
WB-S28,2250,296,15890727.44,4708,8523,3815,7849.077703,667.4997956
WB-S29,2250,295,15837042.55,6226,9569,3343,7509.549153,980.4885414
WB-S3,2250,296,15890727.44,2041,8168,6127,6100.429054,1455.649022
WB-S4,2250,298,15998097.22,639,8830,8191,4316.946309,2602.100745
WB-S5,2250,298,15998097.22,1954,8614,6660,5751.637584,2067.246982
WB-S6,2250,297,15944412.33,1468,8100,6632,3972.804714,1869.886304
WB-S7,2250,296,15890727.44,5393,8113,2720,7303.780405,397.842869
WB-S8,2250,298,15998097.22,3308,8381,5073,7664.942953,533.0778619
WB-S9,2250,298,15998097.22,-919,9979,10898,4209.684564,2660.62654
WB-W1,2250,293,15729672.77,1276,8539,7263,6878.590444,1313.571624
WB-W10,2250,301,16159151.89,381,8532,8151,5707.475083,1654.615244
WB-W2,2250,294,15783357.66,3250,8819,5569,7925.278912,664.4307346
WB-W3,2250,299,16051782.11,6052,9074,3022,7419.150502,762.0207299
WB-W4,2250,295,15837042.55,4356,7766,3410,6156.888136,840.8534311
WB-W5,2250,300,16105467,5462,8379,2917,7695.876667,469.2623873
WB-W6,2250,297,15944412.33,7426,8586,1160,8010.225589,301.4040985
WB-W7,2250,295,15837042.55,3189,9919,6730,7554.325424,1159.632743
WB-W8,2250,295,15837042.55,3647,8067,4420,6660.955932,974.6242812
WB-W9,2250,297,15944412.33,1432,8566,7134,7238.670034,1055.932491
W01,2500,362,19433930.18,1195,8437,7242,7291.629834,1435.965448
W02,2500,365,19594984.85,3182,8861,5679,7950.345205,672.1881229
W03,2500,365,19594984.85,1912,8531,6619,7042.605479,1597.776471
W04,2500,372,19970779.08,6173,8523,2350,7974.63172,258.5413308
W05,2500,364,19541299.96,5094,8875,3781,7933.664835,538.3579764
W06,2500,364,19541299.96,4618,8576,3958,7781.06044,562.3413297
W07,2500,364,19541299.96,5952,8523,2571,7189.67033,556.9211883
W08,2500,364,19541299.96,1374,8617,7243,6083.43956,2210.81343
W09,2500,362,19433930.18,2195,8481,6286,7707.527624,866.6765731
W10,2500,367,19702354.63,2772,8688,5916,7415.787466,1264.361977
W11,2500,364,19541299.96,1276,8539,7263,6743.631868,1436.620246
W12,2500,364,19541299.96,1020,8266,7246,6393.901099,1287.206835
W13,2500,372,19970779.08,1394,8023,6629,5571.260753,1532.267872
W14,2500,365,19594984.85,5003,8359,3356,7453.583562,638.0791223
W15,2500,362,19433930.18,1789,8213,6424,7001.494475,1504.141093
W16,2500,362,19433930.18,2088,9776,7688,7900.941989,1122.835974
W17,2500,366,19648669.74,935,8521,7586,7590.70765,1004.99833
W18,2500,365,19594984.85,2247,8449,6202,7669.194521,783.3169221
W19,2500,370,19863409.3,726,8513,7787,6906.113514,1599.006279
W20,2500,368,19756039.52,5250,8151,2901,7097.168478,621.2209655
W21,2500,364,19541299.96,477,8484,8007,6100.936813,2286.680771
W22,2500,370,19863409.3,-919,9979,10898,5595.335135,2621.107131
W23,2500,364,19541299.96,4201,7705,3504,5935.961538,710.3572802
W24,2500,363,19487615.07,1081,8196,7115,5934.76584,2101.830821
W25,2500,370,19863409.3,262,8341,8079,6470.572973,2052.286668
W26,2500,365,19594984.85,120,8511,8391,4188.824658,2487.546661
W27,2500,364,19541299.96,5527,8038,2511,7329.519231,470.1976755
W28,2500,366,19648669.74,1315,8627,7312,7148.068306,1331.164521
W29,2500,364,19541299.96,2505,8626,6121,7334.714286,955.4669854
W30,2500,364,19541299.96,3093,8154,5061,6720.848901,1068.805581
W31,2500,371,19917094.19,6562,8651,2089,7811.043127,317.1715348
W32,2500,365,19594984.85,5288,8869,3581,8080.969863,672.4872717
W33,2500,365,19594984.85,4381,8750,4369,7858.780822,896.084601
W34,2500,365,19594984.85,1465,9134,7669,6366.520548,2302.657984
W35,2500,365,19594984.85,1548,8470,6922,7027.586301,1407.120299
W36,2500,362,19433930.18,1922,8235,6313,6919.350829,1504.805559
W37,2500,369,19809724.41,1249,9107,7858,6107.03523,2261.189464
W38,2500,364,19541299.96,3459,8555,5096,7751.755495,632.3446064
W39,2500,370,19863409.3,1893,8215,6322,6907.645946,1281.963617
W40,2500,366,19648669.74,2089,8460,6371,6998.098361,1487.497141
W41,2500,367,19702354.63,3889,8368,4479,7544.46594,667.5603134
W42,2500,367,19702354.63,4309,8440,4131,7406.702997,743.4378693
W43,2500,367,19702354.63,2474,8390,5916,7119.220708,1210.256713
W44,2500,364,19541299.96,1748,8192,6444,6929.302198,1070.305791
W45,2500,364,19541299.96,1400,8736,7336,6407.296703,1897.046303
W46,2500,364,19541299.96,1622,8222,6600,6323.467033,1675.581309
W47,2500,367,19702354.63,1500,8465,6965,6573.046322,1638.700038
W48,2500,363,19487615.07,6788,8156,1368,7600.008264,241.7127645
W49,2500,370,19863409.3,1936,7841,5905,5936.764865,1565.595735
W50,2500,365,19594984.85,3807,8985,5178,7350.857534,930.0818679
W51,2500,365,19594984.85,6163,8181,2018,7377.276712,345.2325365
W52,2500,365,19594984.85,1406,8195,6789,4799.90411,2231.51299
W53,2500,365,19594984.85,4109,8360,4251,7426.624658,710.7711875
W54,2500,365,19594984.85,2704,8124,5420,6054.309589,1673.740241
W55,2500,372,19970779.08,1550,8268,6718,7159.916667,1311.096345
W56,2500,363,19487615.07,1177,9919,8742,7194.782369,1716.839532
W57,2500,365,19594984.85,1759,8660,6901,5103.8,1921.640853
W58,2500,370,19863409.3,2391,8990,6599,7238.516216,1208.316721
W59,2500,367,19702354.63,1194,8597,7403,5415.776567,2009.893935
W60,2500,366,19648669.74,3714,7905,4191,7276.653005,446.5847906
W61,2500,365,19594984.85,2645,8090,5445,7215.191781,1095.62827
W62,2500,365,19594984.85,762,8173,7411,5272.643836,2304.570798
W63,2500,365,19594984.85,160,8139,7979,3811.715068,2586.013492
W64,2500,364,19541299.96,2595,8113,5518,6588.071429,885.9248259
W65,2500,370,19863409.3,742,8000,7258,4433.335135,2547.176476
W66,2500,366,19648669.74,824,7905,7081,4880.68306,2218.775751
WB-E1,2500,371,19917094.19,613,8396,7783,4983.797844,2493.332393
WB-E10,2500,367,19702354.63,377,8597,8220,3394.645777,2162.961528
WB-E2,2500,364,19541299.96,5180,7807,2627,7020.266484,547.465537
WB-E3,2500,369,19809724.41,4294,8201,3907,7504.319783,527.6711638
WB-E4,2500,363,19487615.07,4807,8586,3779,7992.834711,474.8107353
WB-E5,2500,369,19809724.41,273,9051,8778,4347.775068,2630.305143
WB-E6,2500,366,19648669.74,4647,8390,3743,7525.325137,430.7525893
WB-E7,2500,364,19541299.96,1178,8511,7333,6141.467033,1877.11293
WB-E8,2500,367,19702354.63,2280,8583,6303,6750.716621,1670.532589
WB-E9,2500,373,20024463.97,1938,8511,6573,6191.168901,2085.269842
WB-H1,2500,365,19594984.85,1276,8465,7189,6539.671233,1786.916717
WB-H10,2500,366,19648669.74,2078,8208,6130,5865.032787,1844.499185
WB-H2,2500,370,19863409.3,1782,8556,6774,5994.632432,2119.43007
WB-H3,2500,362,19433930.18,1109,9158,8049,5970.345304,2490.729635
WB-H4,2500,367,19702354.63,1468,8513,7045,5800.39782,2335.864469
WB-H5,2500,367,19702354.63,882,8639,7757,4615.80654,2483.013364
WB-H6,2500,365,19594984.85,688,9958,9270,5303.558904,2583.650867
WB-H7,2500,367,19702354.63,172,9834,9662,4853.923706,2713.202596
WB-H8,2500,362,19433930.18,1938,8956,7018,5517.071823,2067.482411
WB-H9,2500,365,19594984.85,636,8396,7760,3640.408219,2356.060433
WB-S1,2500,366,19648669.74,-214,9819,10033,4840.519126,3025.340747
WB-S10,2500,362,19433930.18,-1058,7975,9033,4195.466851,2433.472672
WB-S11,2500,365,19594984.85,552,7820,7268,4638.958904,2427.294507
WB-S12,2500,369,19809724.41,1194,8597,7403,5073.655827,2060.544377
WB-S13,2500,370,19863409.3,882,8639,7757,4340.045946,1839.839547
WB-S14,2500,372,19970779.08,2675,8628,5953,7268.983871,935.5836657
WB-S15,2500,365,19594984.85,1659,8298,6639,6472.512329,1642.452045
WB-S16,2500,370,19863409.3,262,8408,8146,4645.056757,2400.964404
WB-S17,2500,366,19648669.74,2645,8182,5537,6984.002732,1237.160552
WB-S18,2500,367,19702354.63,1364,9203,7839,5971.147139,2416.656439
WB-S19,2500,368,19756039.52,1383,8398,7015,6175.070652,2108.224754
WB-S2,2500,370,19863409.3,-796,9908,10704,4499.335135,3568.293512
WB-S20,2500,365,19594984.85,5568,8750,3182,7857.29863,420.9255375
WB-S21,2500,365,19594984.85,2761,8399,5638,7073.260274,1270.39515
WB-S22,2500,366,19648669.74,6671,7823,1152,7528.420765,131.5359371
WB-S23,2500,365,19594984.85,680,8296,7616,7143.024658,1535.862718
WB-S24,2500,365,19594984.85,587,8412,7825,3363.558904,2351.123041
WB-S25,2500,365,19594984.85,4544,8430,3886,7602.232877,556.1086698
WB-S26,2500,369,19809724.41,3198,8855,5657,8035.162602,939.5516896
WB-S27,2500,366,19648669.74,7184,8539,1355,7881.997268,194.6504994
WB-S28,2500,362,19433930.18,4708,8523,3815,7826.781768,652.3077515
WB-S29,2500,363,19487615.07,6226,9569,3343,7588.272727,996.4537036
WB-S3,2500,362,19433930.18,1968,8168,6200,6061.323204,1499.995357
WB-S4,2500,366,19648669.74,639,8830,8191,4464.355191,2654.525376
WB-S5,2500,369,19809724.41,1938,8719,6781,5828.265583,2079.653436
WB-S6,2500,369,19809724.41,1468,8100,6632,4098.604336,1919.81437
WB-S7,2500,365,19594984.85,5393,8181,2788,7275.542466,428.3369068
WB-S8,2500,365,19594984.85,3032,8415,5383,7594.578082,699.3994195
WB-S9,2500,370,19863409.3,-919,9979,10898,4473.164865,2735.679755
WB-W1,2500,365,19594984.85,879,8539,7660,6764.449315,1448.308654
WB-W10,2500,366,19648669.74,381,8532,8151,5718.806011,1685.681466
WB-W2,2500,367,19702354.63,3250,8828,5578,7884.411444,758.6548954
WB-W3,2500,364,19541299.96,6052,9419,3367,7431.277473,786.7728196
WB-W4,2500,366,19648669.74,4356,7931,3575,6238.918033,862.5215219
WB-W5,2500,372,19970779.08,5462,8379,2917,7661.817204,495.9015564
WB-W6,2500,366,19648669.74,6044,8586,2542,7967.437158,354.8887075
WB-W7,2500,364,19541299.96,1509,9919,8410,7388.25,1440.347419
WB-W8,2500,366,19648669.74,3647,8067,4420,6732.456284,918.5503499
WB-W9,2500,366,19648669.74,1432,8566,7134,7182.693989,1159.621183
W01,2750,440,23621351.6,1195,8520,7325,7257.877273,1441.810686
W02,2750,445,23889776.05,3182,8861,5679,7876.134831,819.8596426
W03,2750,444,23836091.16,1912,8531,6619,7065.322072,1619.758915
W04,2750,445,23889776.05,5084,8523,3439,7946.01573,339.5674012
W05,2750,441,23675036.49,3250,8875,5625,7848.600907,728.6798142
W06,2750,441,23675036.49,4618,8605,3987,7780.879819,620.1160535
W07,2750,443,23782406.27,3784,8523,4739,7188.891648,606.7922222
W08,2750,441,23675036.49,1374,8617,7243,6042.632653,2239.828484
W09,2750,440,23621351.6,2195,8481,6286,7717.893182,835.0472605
W10,2750,446,23943460.94,2772,8688,5916,7386.975336,1265.760114
W11,2750,440,23621351.6,879,8539,7660,6635.975,1565.001992
W12,2750,444,23836091.16,1020,8266,7246,6182.581081,1462.40611
W13,2750,444,23836091.16,1319,8229,6910,5562.445946,1562.83743
W14,2750,444,23836091.16,4819,8359,3540,7430.664414,678.7798124
W15,2750,440,23621351.6,1720,8257,6537,6995.963636,1547.660802
W16,2750,440,23621351.6,1343,9776,8433,7773.472727,1359.334902
W17,2750,442,23728721.38,426,8521,8095,7360.947964,1410.026751
W18,2750,446,23943460.94,1197,8449,7252,7591.358744,983.0182274
W19,2750,443,23782406.27,36,8513,8477,6850.24605,1646.537832
W20,2750,443,23782406.27,5250,8151,2901,7074.453725,632.9224377
W21,2750,444,23836091.16,477,8953,8476,6174.423423,2233.321871
W22,2750,442,23728721.38,-919,9979,10898,5493.21267,2623.779338
W23,2750,444,23836091.16,3624,7855,4231,6032.367117,802.9955364
W24,2750,441,23675036.49,988,8196,7208,5844.156463,2161.760532
W25,2750,445,23889776.05,262,8341,8079,6335.148315,2113.891226
W26,2750,446,23943460.94,120,8511,8391,4167.513453,2474.617258
W27,2750,440,23621351.6,5527,8038,2511,7320.665909,484.3162985
W28,2750,443,23782406.27,1261,8843,7582,7035.137698,1538.87628
W29,2750,443,23782406.27,2505,8626,6121,7237.252822,1108.139551
W30,2750,442,23728721.38,3093,8182,5089,6802.298643,1076.047843
W31,2750,444,23836091.16,6562,8651,2089,7833.77027,318.2838716
W32,2750,438,23513981.82,5288,8869,3581,8095.070776,665.6128443
W33,2750,440,23621351.6,4381,8750,4369,7859.825,897.3169065
W34,2750,437,23460296.93,1364,9134,7770,6150.311213,2361.562049
W35,2750,440,23621351.6,1427,8470,7043,6936.902273,1558.009844
W36,2750,439,23567666.71,1922,8398,6476,6925.699317,1496.711069
W37,2750,445,23889776.05,1249,9107,7858,6228.467416,2178.373474
W38,2750,437,23460296.93,3459,8555,5096,7770.654462,584.1606406
W39,2750,444,23836091.16,1893,8277,6384,7006.538288,1215.955236
W40,2750,445,23889776.05,2089,8460,6371,6965.242697,1479.422809
W41,2750,446,23943460.94,3889,8433,4544,7527.85426,700.9463359
W42,2750,447,23997145.83,4309,8476,4167,7395.738255,732.1372965
W43,2750,445,23889776.05,2474,8390,5916,7092.703371,1240.342039
W44,2750,443,23782406.27,1748,8265,6517,7006.257336,1051.14508
W45,2750,444,23836091.16,1400,8736,7336,6512.936937,1805.364738
W46,2750,442,23728721.38,1616,8298,6682,6348.162896,1687.775184
W47,2750,444,23836091.16,1500,8465,6965,6453.668919,1768.340483
W48,2750,443,23782406.27,6788,8161,1373,7608.024831,240.7191479
W49,2750,445,23889776.05,1835,7849,6014,5772.757303,1665.12115
W50,2750,445,23889776.05,3807,8985,5178,7340.217978,893.0437108
W51,2750,442,23728721.38,5954,8484,2530,7386.122172,356.1780829
W52,2750,444,23836091.16,1406,8298,6892,4885.29955,2221.048361
W53,2750,444,23836091.16,4109,8362,4253,7407.040541,712.1023266
W54,2750,437,23460296.93,2704,8124,5420,6001.169336,1671.28236
W55,2750,445,23889776.05,1550,8268,6718,6972.289888,1568.63568
W56,2750,441,23675036.49,1177,9919,8742,7049.802721,1806.465571
W57,2750,442,23728721.38,1759,8731,6972,5089.760181,1912.504953
W58,2750,444,23836091.16,2391,8990,6599,7156.484234,1325.737049
W59,2750,444,23836091.16,1194,8597,7403,5155.731982,2042.373888
W60,2750,445,23889776.05,2970,7905,4935,7239.462921,592.1963284
W61,2750,442,23728721.38,2645,8521,5876,7259.402715,1072.32201
W62,2750,444,23836091.16,750,8472,7722,5144.367117,2406.658969
W63,2750,440,23621351.6,143,8139,7996,3583.645455,2507.692068
W64,2750,437,23460296.93,2595,8113,5518,6596.542334,893.4377701
W65,2750,444,23836091.16,552,8000,7448,4199.833333,2572.372464
W66,2750,443,23782406.27,427,7905,7478,4546.422122,2294.476916
WB-E1,2750,443,23782406.27,567,9051,8484,5054.137698,2524.920233
WB-E10,2750,441,23675036.49,377,8597,8220,3374.442177,2171.308936
WB-E2,2750,444,23836091.16,5180,8143,2963,7049.743243,562.5243993
WB-E3,2750,446,23943460.94,4294,8234,3940,7486.356502,510.9875129
WB-E4,2750,443,23782406.27,2756,8586,5830,7861.577878,756.5403763
WB-E5,2750,444,23836091.16,273,9051,8778,4131.585586,2608.358346
WB-E6,2750,446,23943460.94,2688,8390,5702,7462.015695,633.0969805
WB-E7,2750,446,23943460.94,928,8511,7583,6147.482063,1867.993686
WB-E8,2750,446,23943460.94,2219,8583,6364,6536.520179,1791.298408
WB-E9,2750,447,23997145.83,1938,8511,6573,5869.293065,2216.186759
WB-H1,2750,437,23460296.93,1276,8465,7189,6528.93135,1797.843605
WB-H10,2750,440,23621351.6,2078,8208,6130,5888.231818,1808.427424
WB-H2,2750,444,23836091.16,1542,8556,7014,6108.578829,2096.803539
WB-H3,2750,439,23567666.71,1109,9158,8049,6013.492027,2451.343725
WB-H4,2750,446,23943460.94,1468,8513,7045,5818.352018,2295.481612
WB-H5,2750,446,23943460.94,882,8639,7757,4709.849776,2465.268684
WB-H6,2750,444,23836091.16,688,9958,9270,5440.918919,2628.7899
WB-H7,2750,445,23889776.05,172,9834,9662,4804.150562,2622.546277
WB-H8,2750,440,23621351.6,1938,8956,7018,5655.595455,2055.604373
WB-H9,2750,445,23889776.05,636,8396,7760,3903.289888,2377.270248
WB-S1,2750,438,23513981.82,-214,9819,10033,4734.913242,3030.529087
WB-S10,2750,441,23675036.49,-1058,7975,9033,4056.011338,2459.78064
WB-S11,2750,441,23675036.49,552,7820,7268,4565.170068,2482.443333
WB-S12,2750,444,23836091.16,1194,8597,7403,4981.085586,2094.2947
WB-S13,2750,445,23889776.05,882,8639,7757,4494.588764,1932.621616
WB-S14,2750,446,23943460.94,2675,8736,6061,7188.183857,1041.191654
WB-S15,2750,437,23460296.93,1622,8298,6676,6453.130435,1662.498783
WB-S16,2750,444,23836091.16,222,8408,8186,4671.788288,2442.966603
WB-S17,2750,445,23889776.05,2645,8182,5537,7015.485393,1192.735927
WB-S18,2750,446,23943460.94,1364,9203,7839,6061.672646,2378.560035
WB-S19,2750,445,23889776.05,1383,8398,7015,6097.137079,2123.481105
WB-S2,2750,442,23728721.38,-796,9908,10704,4447.251131,3602.556463
WB-S20,2750,446,23943460.94,4414,8750,4336,7812.098655,489.5369865
WB-S21,2750,441,23675036.49,2761,8399,5638,7006.235828,1304.574896
WB-S22,2750,446,23943460.94,6463,7975,1512,7518.076233,166.4651043
WB-S23,2750,443,23782406.27,680,8296,7616,6979.297968,1702.458571
WB-S24,2750,444,23836091.16,587,8412,7825,3634.84009,2463.924211
WB-S25,2750,447,23997145.83,4544,8526,3982,7624.268456,572.3862367
WB-S26,2750,447,23997145.83,3198,8855,5657,8053.425056,887.3386033
WB-S27,2750,446,23943460.94,7184,8816,1632,7893.154709,214.6824661
WB-S28,2750,439,23567666.71,4708,8523,3815,7834.166287,608.9696756
WB-S29,2750,441,23675036.49,4137,9569,5432,7606.619048,994.1613998
WB-S3,2750,440,23621351.6,590,8320,7730,5993.386364,1644.408138
WB-S4,2750,444,23836091.16,639,8830,8191,4552.961712,2698.458575
WB-S5,2750,445,23889776.05,1938,8880,6942,5919.080899,2082.020616
WB-S6,2750,446,23943460.94,1468,8120,6652,4296.934978,2004.698292
WB-S7,2750,443,23782406.27,5393,8181,2788,7256.451467,453.8821749
WB-S8,2750,445,23889776.05,3032,8415,5383,7535.28764,764.7318355
WB-S9,2750,444,23836091.16,-919,9979,10898,4570.531532,2714.884326
WB-W1,2750,437,23460296.93,879,8539,7660,6601.329519,1617.217337
WB-W10,2750,443,23782406.27,381,8532,8151,5726.58465,1722.311844
WB-W2,2750,447,23997145.83,3250,8828,5578,7851.879195,827.1661894
WB-W3,2750,444,23836091.16,5991,9491,3500,7429.358108,800.9432166
WB-W4,2750,445,23889776.05,4356,8060,3704,6323.52809,867.799209
WB-W5,2750,446,23943460.94,4544,8502,3958,7633.020179,553.4713583
WB-W6,2750,444,23836091.16,3714,8668,4954,7888.621622,571.2887092
WB-W7,2750,441,23675036.49,1204,9919,8715,7185.820862,1704.801543
WB-W8,2750,441,23675036.49,3647,8067,4420,6816.834467,882.998305
WB-W9,2750,446,23943460.94,1432,8566,7134,7130.542601,1227.017039
W01,3000,525,28184567.25,809,8603,7794,7164.51619,1589.925448
W02,3000,529,28399306.81,3182,8861,5679,7771.36673,939.2932677
W03,3000,526,28238252.14,1912,8531,6619,7120.653992,1563.8466
W04,3000,533,28614046.37,4708,8523,3815,7896.058161,476.4998345
W05,3000,530,28452991.7,3236,8875,5639,7788.362264,835.5152183
W06,3000,526,28238252.14,4618,8713,4095,7778.910646,648.0187571
W07,3000,523,28077197.47,2229,8523,6294,7184.091778,717.0766065
W08,3000,526,28238252.14,1374,8617,7243,6112.657795,2211.741488
W09,3000,527,28291937.03,2195,8492,6297,7715.184061,802.5269521
W10,3000,528,28345621.92,2772,8688,5916,7346.583333,1295.726532
W11,3000,527,28291937.03,879,8539,7660,6516,1651.427137
W12,3000,522,28023512.58,1020,8266,7246,6021.881226,1571.631214
W13,3000,531,28506676.59,587,8351,7764,5554.299435,1613.578255
W14,3000,525,28184567.25,4819,8504,3685,7416.16,681.0731316
W15,3000,528,28345621.92,1611,8490,6879,7001.143939,1574.462508
W16,3000,527,28291937.03,1343,9776,8433,7595.411765,1574.079677
W17,3000,527,28291937.03,369,8521,8152,7130.309298,1721.047463
W18,3000,525,28184567.25,1197,8451,7254,7540.693333,1065.847611
W19,3000,528,28345621.92,36,8513,8477,6767.886364,1728.783417
W20,3000,531,28506676.59,5250,8151,2901,7047.154426,636.1788253
W21,3000,522,28023512.58,477,8953,8476,6226.856322,2220.991431
W22,3000,534,28667731.26,-919,9979,10898,5460.117978,2579.739205
W23,3000,524,28130882.36,2473,7855,5382,6104.69084,869.5494731
W24,3000,527,28291937.03,946,8196,7250,5823.314991,2195.457256
W25,3000,529,28399306.81,262,8718,8456,6221.606805,2133.355495
W26,3000,525,28184567.25,37,8511,8474,4144.742857,2475.275945
W27,3000,527,28291937.03,2413,8038,5625,7258.753321,638.4646639
W28,3000,523,28077197.47,1084,8843,7759,6977.214149,1633.616506
W29,3000,525,28184567.25,1807,8665,6858,7174.965714,1204.049133
W30,3000,526,28238252.14,3093,8182,5089,6880.653992,1067.798513
W31,3000,532,28560361.48,6562,8651,2089,7849.552632,314.8206361
W32,3000,526,28238252.14,4720,8931,4211,8103.519011,683.8942524
W33,3000,528,28345621.92,4381,8750,4369,7875.160985,860.1154293
W34,3000,525,28184567.25,1364,9134,7770,5957.75619,2386.688532
W35,3000,527,28291937.03,1427,8470,7043,6918.671727,1574.259691
W36,3000,527,28291937.03,1922,8398,6476,6949.629981,1505.464128
W37,3000,526,28238252.14,1249,9107,7858,6308.828897,2145.868607
W38,3000,526,28238252.14,3459,8555,5096,7785.895437,540.3907142
W39,3000,533,28614046.37,1893,8277,6384,7084.816135,1166.994933
W40,3000,529,28399306.81,2089,8600,6511,6952.529301,1464.937851
W41,3000,527,28291937.03,3343,8433,5090,7493.703985,773.5420857
W42,3000,528,28345621.92,4309,8476,4167,7389.986742,724.5107321
W43,3000,527,28291937.03,2474,8390,5916,7076.053131,1228.013362
W44,3000,527,28291937.03,1748,8265,6517,7056.104364,1050.958328
W45,3000,524,28130882.36,1400,8736,7336,6575.166031,1728.783506
W46,3000,529,28399306.81,1616,8298,6682,6353.803403,1722.569633
W47,3000,526,28238252.14,1500,8465,6965,6390.102662,1803.620105
W48,3000,522,28023512.58,6788,8161,1373,7605.603448,239.8602679
W49,3000,532,28560361.48,1564,8080,6516,5662.704887,1762.397645
W50,3000,526,28238252.14,3139,8985,5846,7305.268061,911.7118871
W51,3000,526,28238252.14,5680,8484,2804,7401.011407,395.9328109
W52,3000,527,28291937.03,1406,8298,6892,4987.296015,2236.279073
W53,3000,526,28238252.14,3780,8362,4582,7370.237643,745.1086675
W54,3000,523,28077197.47,2704,8124,5420,5974.070746,1650.281734
W55,3000,533,28614046.37,1550,8268,6718,6839.727955,1705.160829
W56,3000,527,28291937.03,1177,9919,8742,6977.214421,1865.479693
W57,3000,529,28399306.81,1309,8731,7422,5112.854442,1944.302642
W58,3000,534,28667731.26,2219,8990,6771,7065.024345,1459.608738
W59,3000,527,28291937.03,1194,8597,7403,4988.113852,2035.032638
W60,3000,527,28291937.03,2970,8342,5372,7208.916509,710.9035173
W61,3000,529,28399306.81,2645,8622,5977,7300.981096,1061.246923
W62,3000,526,28238252.14,750,8518,7768,5071.110266,2487.463773
W63,3000,527,28291937.03,143,8139,7996,3447.037951,2451.390907
W64,3000,527,28291937.03,2362,8113,5751,6554.140417,963.5750613
W65,3000,533,28614046.37,552,8000,7448,4010.780488,2548.952886
W66,3000,530,28452991.7,427,8283,7856,4295.960377,2351.337699
WB-E1,3000,533,28614046.37,438,9051,8613,5086.93621,2551.311511
WB-E10,3000,528,28345621.92,377,8597,8220,3365.136364,2131.148311
WB-E2,3000,524,28130882.36,5180,8143,2963,7071.570611,572.1704365
WB-E3,3000,529,28399306.81,4294,8234,3940,7485.119093,482.2404343
WB-E4,3000,522,28023512.58,1782,8586,6804,7731.057471,977.1302441
WB-E5,3000,531,28506676.59,273,9051,8778,3990.623352,2578.503809
WB-E6,3000,526,28238252.14,2688,8390,5702,7436.589354,680.1133926
WB-E7,3000,526,28238252.14,204,8511,8307,6133.695817,1915.835271
WB-E8,3000,527,28291937.03,1472,8583,7111,6351.489564,1920.009664
WB-E9,3000,534,28667731.26,224,8511,8287,5574.973783,2304.483514
WB-H1,3000,525,28184567.25,1276,8465,7189,6486.75619,1831.869698
WB-H10,3000,526,28238252.14,2078,8208,6130,5879.627376,1772.681819
WB-H2,3000,533,28614046.37,1542,8568,7026,6220.390244,2085.611599
WB-H3,3000,526,28238252.14,1109,9158,8049,6008.988593,2432.813499
WB-H4,3000,526,28238252.14,1468,8513,7045,5872.346008,2257.989243
WB-H5,3000,527,28291937.03,882,8639,7757,4789.144213,2443.075139
WB-H6,3000,525,28184567.25,657,9958,9301,5449.558095,2625.81149
WB-H7,3000,528,28345621.92,131,9834,9703,4870.439394,2593.429012
WB-H8,3000,526,28238252.14,1938,8956,7018,5758.028517,2042.973146
WB-H9,3000,526,28238252.14,636,8710,8074,4068.043726,2374.594817
WB-S1,3000,526,28238252.14,-214,9819,10033,4556.205323,3022.887768
WB-S10,3000,527,28291937.03,-1058,7975,9033,3946.322581,2493.903459
WB-S11,3000,528,28345621.92,552,7820,7268,4558.340909,2519.958194
WB-S12,3000,532,28560361.48,1194,8597,7403,4865.272556,2142.228278
WB-S13,3000,533,28614046.37,882,8639,7757,4633.902439,2024.868463
WB-S14,3000,534,28667731.26,1991,8736,6745,7081.09176,1187.580507
WB-S15,3000,526,28238252.14,1616,8298,6682,6460.576046,1653.063964
WB-S16,3000,534,28667731.26,222,8408,8186,4755.855805,2479.318276
WB-S17,3000,528,28345621.92,2645,8182,5537,7048.67803,1131.987871
WB-S18,3000,526,28238252.14,1364,9203,7839,6180.520913,2334.153959
WB-S19,3000,526,28238252.14,1383,8398,7015,6060.819392,2106.758972
WB-S2,3000,531,28506676.59,-796,9908,10704,4412.47646,3669.151789
WB-S20,3000,528,28345621.92,1855,8750,6895,7745.267045,754.4872448
WB-S21,3000,527,28291937.03,2761,8399,5638,6985.781784,1289.33351
WB-S22,3000,526,28238252.14,2997,8018,5021,7483.638783,397.3217499
WB-S23,3000,529,28399306.81,680,8296,7616,6871.827977,1787.498469
WB-S24,3000,526,28238252.14,587,8973,8386,3853.279468,2487.899578
WB-S25,3000,526,28238252.14,4544,8570,4026,7640.579848,586.1519907
WB-S26,3000,529,28399306.81,3198,8855,5657,8059.132325,854.133066
WB-S27,3000,528,28345621.92,7184,8860,1676,7903.916667,235.5862302
WB-S28,3000,526,28238252.14,4708,8523,3815,7836.969582,571.9433244
WB-S29,3000,528,28345621.92,4137,9712,5575,7627.625,993.9575357
WB-S3,3000,526,28238252.14,590,8320,7730,5910.992395,1756.389203
WB-S4,3000,526,28238252.14,637,8830,8193,4597.444867,2723.336082
WB-S5,3000,531,28506676.59,1938,8880,6942,6003.619586,2060.806869
WB-S6,3000,526,28238252.14,1468,8241,6773,4458.007605,2073.122877
WB-S7,3000,528,28345621.92,5151,8181,3030,7248.342803,471.489799
WB-S8,3000,526,28238252.14,2568,8513,5945,7490.157795,842.3564403
WB-S9,3000,533,28614046.37,-919,9979,10898,4726.594747,2688.969663
WB-W1,3000,525,28184567.25,879,8539,7660,6475.262857,1734.108256
WB-W10,3000,523,28077197.47,381,8692,8311,5723.520076,1759.635856
WB-W2,3000,528,28345621.92,3236,8828,5592,7835.024621,854.9868893
WB-W3,3000,525,28184567.25,5970,9491,3521,7440.255238,807.5761852
WB-W4,3000,528,28345621.92,4356,8060,3704,6394.128788,866.1064513
WB-W5,3000,532,28560361.48,4544,8627,4083,7618.37218,603.4393129
WB-W6,3000,527,28291937.03,3714,8668,4954,7831.990512,710.6450486
WB-W7,3000,525,28184567.25,377,9919,9542,6948.300952,2014.551141
WB-W8,3000,526,28238252.14,3647,8067,4420,6885.840304,851.7284535
WB-W9,3000,525,28184567.25,1432,8566,7134,7103.23619,1249.213271
W01,3250,616,33069892.24,720,9008,8288,7110.991883,1711.435811
W02,3250,618,33177262.02,1195,8861,7666,7687.512945,1048.395868
W03,3250,621,33338316.69,1912,8531,6619,7144.220612,1523.437272
W04,3250,618,33177262.02,4708,8530,3822,7871.441748,525.9547281
W05,3250,618,33177262.02,3236,8875,5639,7722.880259,906.5365018
W06,3250,615,33016207.35,4618,8713,4095,7759.573984,676.6797905
W07,3250,620,33284631.8,1236,8768,7532,7171.380645,941.0984438
W08,3250,615,33016207.35,1374,8617,7243,6193.769106,2159.280745
W09,3250,616,33069892.24,2195,9451,7256,7730.079545,796.1578752
W10,3250,621,33338316.69,2772,8688,5916,7312.436393,1307.976787
W11,3250,614,32962522.46,879,8539,7660,6419.055375,1733.055795
W12,3250,620,33284631.8,982,8266,7284,5926.493548,1594.858035
W13,3250,618,33177262.02,587,8351,7764,5562.192557,1667.623794
W14,3250,621,33338316.69,4494,8504,4010,7398.711755,699.4857018
W15,3250,616,33069892.24,1611,8490,6879,7019.694805,1576.798897
W16,3250,616,33069892.24,409,9776,9367,7411.206169,1744.251892
W17,3250,617,33123577.13,96,8521,8425,6948.262561,1962.230729
W18,3250,621,33338316.69,1197,8451,7254,7489.270531,1130.387141
W19,3250,618,33177262.02,36,8517,8481,6684.542071,1817.404218
W20,3250,618,33177262.02,5250,8151,2901,7018.006472,658.0637086
W21,3250,620,33284631.8,477,8953,8476,6287.948387,2213.949579
W22,3250,616,33069892.24,-919,9979,10898,5427.696429,2582.266814
W23,3250,619,33230946.91,1497,7962,6465,6162.295638,958.1139885
W24,3250,616,33069892.24,222,8196,7974,5783.548701,2272.739892
W25,3250,619,33230946.91,262,8718,8456,6195.61874,2114.542028
W26,3250,621,33338316.69,37,8511,8474,4107.481481,2461.599251
W27,3250,615,33016207.35,2385,8190,5805,7201.673171,785.6821771
W28,3250,618,33177262.02,1084,8843,7759,6947.804207,1637.555374
W29,3250,620,33284631.8,1595,8665,7070,7110.06129,1306.387102
W30,3250,617,33123577.13,3093,8182,5089,6930.615883,1057.646628
W31,3250,617,33123577.13,6562,8667,2105,7857.901135,318.4608318
W32,3250,616,33069892.24,4689,8931,4242,8102.256494,704.1796732
W33,3250,615,33016207.35,4381,8750,4369,7876.19187,828.5870365
W34,3250,617,33123577.13,1364,9134,7770,5866.429498,2403.504872
W35,3250,617,33123577.13,1427,8470,7043,6884.544571,1604.26833
W36,3250,617,33123577.13,1249,8398,7149,6959.162075,1538.834101
W37,3250,623,33445686.47,1249,9107,7858,6383.197432,2102.438013
W38,3250,616,33069892.24,3459,8555,5096,7791.422078,505.5326917
W39,3250,618,33177262.02,1893,8322,6429,7141.144013,1131.516574
W40,3250,619,33230946.91,2089,8600,6511,6916.392569,1477.399499
W41,3250,623,33445686.47,3343,9046,5703,7445.102729,842.7833801
W42,3250,622,33392001.58,4088,8476,4388,7388.381029,729.6955193
W43,3250,623,33445686.47,2474,8390,5916,7070.786517,1214.061054
W44,3250,620,33284631.8,1748,8265,6517,7083.066129,1051.641514
W45,3250,621,33338316.69,1400,8736,7336,6578.924316,1683.253064
W46,3250,617,33123577.13,1616,8298,6682,6384.987034,1715.186969
W47,3250,619,33230946.91,1500,8465,6965,6348.722132,1840.146954
W48,3250,621,33338316.69,6788,8201,1413,7601.690821,238.5039275
W49,3250,619,33230946.91,1564,8256,6692,5647.699515,1815.138877
W50,3250,622,33392001.58,2324,8985,6661,7222.707395,1037.66829
W51,3250,620,33284631.8,4762,8484,3722,7397.362903,439.9047319
W52,3250,622,33392001.58,1406,8298,6892,5122.18328,2258.159073
W53,3250,620,33284631.8,3780,8362,4582,7334.751613,747.8721813
W54,3250,616,33069892.24,1737,8313,6576,5974.055195,1688.089959
W55,3250,617,33123577.13,1383,8416,7033,6708.226904,1850.454639
W56,3250,616,33069892.24,1177,9919,8742,6906.491883,1893.483152
W57,3250,618,33177262.02,1309,8731,7422,5143.508091,1971.779342
W58,3250,618,33177262.02,2219,8990,6771,6976.553398,1574.346645
W59,3250,621,33338316.69,1194,8597,7403,4849.495974,2037.71727
W60,3250,622,33392001.58,1671,8342,6671,7157.361736,879.9118613
W61,3250,618,33177262.02,2462,8640,6178,7317.275081,1073.701884
W62,3250,621,33338316.69,-1058,8536,9594,4944.378422,2582.042733
W63,3250,614,32962522.46,143,8300,8157,3376.770358,2419.667617
W64,3250,614,32962522.46,2205,8113,5908,6507.19544,1051.961557
W65,3250,618,33177262.02,552,8000,7448,3859.877023,2521.373156
W66,3250,619,33230946.91,213,8283,8070,4113.399031,2346.856303
WB-E1,3250,617,33123577.13,345,9051,8706,5103.009724,2587.774033
WB-E10,3250,617,33123577.13,377,8597,8220,3397.661264,2125.996188
WB-E2,3250,619,33230946.91,2228,8403,6175,7067.927302,684.3463961
WB-E3,3250,621,33338316.69,4294,8234,3940,7485.006441,454.6014198
WB-E4,3250,618,33177262.02,1782,8586,6804,7605.540453,1163.205391
WB-E5,3250,619,33230946.91,273,9051,8778,3900.678514,2534.629785
WB-E6,3250,618,33177262.02,2688,8390,5702,7396.571197,794.5113939
WB-E7,3250,621,33338316.69,204,8511,8307,6125.677939,1948.235152
WB-E8,3250,623,33445686.47,1328,8583,7255,6153.319422,2067.774876
WB-E9,3250,616,33069892.24,224,8511,8287,5357.131494,2323.871375
WB-H1,3250,619,33230946.91,1276,8465,7189,6484.038772,1837.88624
WB-H10,3250,618,33177262.02,1994,8208,6214,5815.317152,1768.803656
WB-H2,3250,618,33177262.02,1542,8606,7064,6316.627832,2080.692001
WB-H3,3250,615,33016207.35,1109,9158,8049,6008.705691,2420.333261
WB-H4,3250,623,33445686.47,1468,8513,7045,5957.075441,2206.642427
WB-H5,3250,621,33338316.69,882,8639,7757,4851.553945,2423.42166
WB-H6,3250,620,33284631.8,319,9958,9639,5458.61129,2637.485844
WB-H7,3250,620,33284631.8,131,9834,9703,5017.246774,2571.458697
WB-H8,3250,616,33069892.24,1938,8956,7018,5905.238636,2047.05542
WB-H9,3250,620,33284631.8,636,8710,8074,4220.109677,2375.546999
WB-S1,3250,614,32962522.46,-214,9819,10033,4421.905537,2979.859422
WB-S10,3250,617,33123577.13,-1058,8300,9358,3907.209076,2530.502137
WB-S11,3250,615,33016207.35,552,8000,7448,4559.128455,2527.12567
WB-S12,3250,620,33284631.8,1194,8597,7403,4784.912903,2137.109899
WB-S13,3250,618,33177262.02,882,8639,7757,4749.579288,2085.246962
WB-S14,3250,616,33069892.24,1991,8736,6745,6991.728896,1255.211544
WB-S15,3250,616,33069892.24,1616,8298,6682,6440.352273,1673.40022
WB-S16,3250,617,33123577.13,222,8408,8186,4838.729335,2486.790157
WB-S17,3250,619,33230946.91,2645,8182,5537,7086.638126,1074.732924
WB-S18,3250,623,33445686.47,1033,9203,8170,6288.606742,2299.115898
WB-S19,3250,623,33445686.47,1383,8398,7015,6061.741573,2094.976454
WB-S2,3250,617,33123577.13,-796,9932,10728,4387.256078,3718.588619
WB-S20,3250,623,33445686.47,1525,8750,7225,7682.670947,918.804733
WB-S21,3250,617,33123577.13,2761,8399,5638,6985.698541,1255.551239
WB-S22,3250,624,33499371.36,2869,8018,5149,7423.309295,551.784624
WB-S23,3250,619,33230946.91,680,8296,7616,6748.50727,1892.644826
WB-S24,3250,621,33338316.69,587,9051,8464,4033.745572,2471.07717
WB-S25,3250,621,33338316.69,4544,8570,4026,7642.391304,579.8941098
WB-S26,3250,619,33230946.91,3198,8855,5657,8049.720517,848.9108375
WB-S27,3250,624,33499371.36,7105,8958,1853,7902.290064,253.4512941
WB-S28,3250,616,33069892.24,4708,8523,3815,7841.032468,546.9931701
WB-S29,3250,617,33123577.13,2195,9712,7517,7621.200972,989.5193675
WB-S3,3250,616,33069892.24,590,8320,7730,5836.081169,1844.705477
WB-S4,3250,623,33445686.47,637,8830,8193,4629.552167,2730.382514
WB-S5,3250,619,33230946.91,1938,8880,6942,6091.392569,2046.28422
WB-S6,3250,623,33445686.47,1468,8513,7045,4658.626003,2157.924748
WB-S7,3250,619,33230946.91,2460,8181,5721,7241.644588,534.7846694
WB-S8,3250,620,33284631.8,1197,8513,7316,7397.529032,994.7515596
WB-S9,3250,618,33177262.02,-919,9979,10898,4813.210356,2669.175659
WB-W1,3250,614,32962522.46,879,8539,7660,6326.840391,1844.509414
WB-W10,3250,619,33230946.91,381,8692,8311,5708.258481,1794.037337
WB-W2,3250,620,33284631.8,3236,8828,5592,7805.864516,888.9625565
WB-W3,3250,621,33338316.69,5970,9491,3521,7439.959742,813.1572907
WB-W4,3250,622,33392001.58,4356,8060,3704,6465.210611,865.292705
WB-W5,3250,616,33069892.24,4544,8627,4083,7615.962662,611.7320048
WB-W6,3250,623,33445686.47,2756,8668,5912,7785.282504,830.978518
WB-W7,3250,614,32962522.46,377,9919,9542,6696.485342,2259.060075
WB-W8,3250,615,33016207.35,3647,8088,4441,6950.985366,830.2053335
WB-W9,3250,622,33392001.58,1432,8566,7134,7042.069132,1292.345178
W01,3500,718,38545751.02,720,9008,8288,7092.947075,1777.594342
W02,3500,716,38438381.24,1195,8861,7666,7661.863128,1095.020982
W03,3500,713,38277326.57,1749,8531,6782,7112.929874,1584.44378
W04,3500,720,38653120.8,4708,8530,3822,7851.165278,558.3070981
W05,3500,717,38492066.13,3236,8875,5639,7669.288703,965.829818
W06,3500,717,38492066.13,4549,8713,4164,7725.242678,720.6316768
W07,3500,717,38492066.13,1236,8846,7610,7160.018131,1062.589867
W08,3500,718,38545751.02,1374,8617,7243,6308.884401,2089.377716
W09,3500,719,38599435.91,2195,9712,7517,7732.410292,838.0167643
W10,3500,715,38384696.35,2007,8688,6681,7248.966434,1369.852179
W11,3500,719,38599435.91,879,8539,7660,6262.884562,1871.529173
W12,3500,718,38545751.02,934,8266,7332,5856.153203,1638.534523
W13,3500,722,38760490.58,587,8351,7764,5600.365651,1704.5074
W14,3500,714,38331011.46,1922,8504,6582,7334.162465,818.1227445
W15,3500,719,38599435.91,1611,8490,6879,7051.755216,1546.205577
W16,3500,716,38438381.24,131,9860,9729,7212.931564,1945.793312
W17,3500,717,38492066.13,-8,8521,8529,6801.153417,2110.944522
W18,3500,715,38384696.35,301,8451,8150,7433.132867,1223.406815
W19,3500,719,38599435.91,36,8517,8481,6606.59388,1932.79909
W20,3500,722,38760490.58,1028,8151,7123,6954.552632,788.6673659
W21,3500,719,38599435.91,477,8953,8476,6317.344924,2196.286116
W22,3500,722,38760490.58,-919,9979,10898,5369.537396,2611.065993
W23,3500,718,38545751.02,-9,8085,8094,6180.611421,1102.987774
W24,3500,717,38492066.13,222,8408,8186,5742.152022,2341.906728
W25,3500,718,38545751.02,262,8843,8581,6185.987465,2055.029016
W26,3500,715,38384696.35,37,8511,8474,4070.427972,2446.035907
W27,3500,722,38760490.58,1600,8718,7118,7154.747922,925.6160651
W28,3500,716,38438381.24,1084,9012,7928,6927.427374,1655.39358
W29,3500,714,38331011.46,1515,9012,7497,7047.838936,1396.723836
W30,3500,719,38599435.91,3093,8182,5089,6985.204451,1036.050751
W31,3500,720,38653120.8,6562,8667,2105,7870.444444,321.2909805
W32,3500,720,38653120.8,3198,8931,5733,8105.272222,711.5245395
W33,3500,716,38438381.24,3166,8750,5584,7832.75838,889.7852883
W34,3500,718,38545751.02,1364,9134,7770,5827.977716,2391.404496
W35,3500,719,38599435.91,1427,8470,7043,6863.489569,1592.091747
W36,3500,717,38492066.13,1249,8597,7348,6979.988842,1553.355606
W37,3500,716,38438381.24,1249,9107,7858,6412.77095,2078.897886
W38,3500,718,38545751.02,3459,8555,5096,7792.002786,478.1719164
W39,3500,721,38706805.69,1893,8322,6429,7195.595007,1094.250269
W40,3500,717,38492066.13,1335,8600,7265,6898.200837,1513.824593
W41,3500,715,38384696.35,3343,9046,5703,7397.786014,902.419294
W42,3500,715,38384696.35,2490,8476,5986,7347.896503,845.9773297
W43,3500,717,38492066.13,2474,8390,5916,7078.064156,1193.802696
W44,3500,715,38384696.35,1522,8265,6743,7073.868531,1097.815127
W45,3500,721,38706805.69,1400,8736,7336,6576.120666,1666.831381
W46,3500,717,38492066.13,1616,8298,6682,6412.949791,1683.824659
W47,3500,717,38492066.13,1362,8465,7103,6302.439331,1882.429397
W48,3500,720,38653120.8,6755,8201,1446,7596.351389,242.9375894
W49,3500,722,38760490.58,1398,8536,7138,5669.691136,1831.563735
W50,3500,717,38492066.13,2035,8985,6950,7127.175732,1168.975003
W51,3500,718,38545751.02,4762,8484,3722,7404.711699,454.6571228
W52,3500,714,38331011.46,1406,8356,6950,5247.998599,2263.710027
W53,3500,715,38384696.35,3780,8362,4582,7312.425175,758.1164631
W54,3500,718,38545751.02,1663,8351,6688,5998.520891,1706.343275
W55,3500,721,38706805.69,1383,8416,7033,6608.981969,1941.490443
W56,3500,717,38492066.13,1177,9919,8742,6805.683403,1941.571341
W57,3500,717,38492066.13,1280,8731,7451,5175.642957,2005.852314
W58,3500,722,38760490.58,2034,8990,6956,6844.369806,1710.830164
W59,3500,716,38438381.24,1194,8597,7403,4761.208101,2061.157809
W60,3500,716,38438381.24,1105,8342,7237,7096.73743,1038.102023
W61,3500,717,38492066.13,1678,8640,6962,7277.145049,1149.439097
W62,3500,714,38331011.46,-1058,8536,9594,4880.036415,2624.839802
W63,3500,721,38706805.69,143,8300,8157,3316.680999,2375.981989
W64,3500,717,38492066.13,1500,8113,6613,6463.492329,1160.013793
W65,3500,719,38599435.91,552,8000,7448,3740.250348,2481.232667
W66,3500,717,38492066.13,18,8283,8265,3983.680614,2351.620763
WB-E1,3500,720,38653120.8,279,9051,8772,5042.540278,2602.897935
WB-E10,3500,717,38492066.13,377,8597,8220,3429.645746,2107.068972
WB-E2,3500,718,38545751.02,1813,8403,6590,7050.706128,791.5288589
WB-E3,3500,717,38492066.13,4294,8234,3940,7484.246862,428.0908728
WB-E4,3500,716,38438381.24,1782,8586,6804,7492.628492,1316.11358
WB-E5,3500,717,38492066.13,273,9051,8778,3904.164575,2492.006006
WB-E6,3500,716,38438381.24,2508,8390,5882,7364.550279,868.0631021
WB-E7,3500,715,38384696.35,204,8511,8307,6096.134266,1983.607332
WB-E8,3500,717,38492066.13,1328,8660,7332,6056.1841,2130.835167
WB-E9,3500,720,38653120.8,224,8511,8287,5215.055556,2303.398974
WB-H1,3500,718,38545751.02,1276,8465,7189,6483.150418,1828.219235
WB-H10,3500,720,38653120.8,1351,8208,6857,5731.468056,1790.832639
WB-H2,3500,721,38706805.69,1542,8606,7064,6392.320388,2054.20212
WB-H3,3500,718,38545751.02,1109,9158,8049,5974.091922,2414.569508
WB-H4,3500,716,38438381.24,1468,8513,7045,6029.324022,2174.911063
WB-H5,3500,714,38331011.46,882,8639,7757,4896.829132,2406.924013
WB-H6,3500,714,38331011.46,168,9958,9790,5460.253501,2646.483417
WB-H7,3500,714,38331011.46,131,9834,9703,5181.460784,2565.676541
WB-H8,3500,719,38599435.91,1938,8956,7018,6060.788595,2042.904432
WB-H9,3500,713,38277326.57,587,8962,8375,4344.093969,2394.292276
WB-S1,3500,718,38545751.02,-214,9819,10033,4300.023677,2959.522028
WB-S10,3500,718,38545751.02,-1058,8300,9358,3859.232591,2560.348133
WB-S11,3500,720,38653120.8,552,8000,7448,4622.418056,2520.651742
WB-S12,3500,720,38653120.8,1194,8597,7403,4716.270833,2121.156258
WB-S13,3500,720,38653120.8,882,8639,7757,4820.284722,2158.796391
WB-S14,3500,720,38653120.8,1400,8736,7336,6894.783333,1332.746944
WB-S15,3500,719,38599435.91,1616,8298,6682,6446.838665,1671.228806
WB-S16,3500,722,38760490.58,222,8408,8186,4942.786704,2466.123197
WB-S17,3500,715,38384696.35,2645,8182,5537,7115.73007,1028.091904
WB-S18,3500,715,38384696.35,1033,9203,8170,6361.039161,2292.142451
WB-S19,3500,716,38438381.24,1383,8398,7015,6083.030726,2087.741889
WB-S2,3500,721,38706805.69,-796,9932,10728,4388.270458,3767.651885
WB-S20,3500,714,38331011.46,1525,8750,7225,7626.655462,1033.83532
WB-S21,3500,719,38599435.91,2761,8399,5638,6986.510431,1229.819929
WB-S22,3500,716,38438381.24,2869,8039,5170,7388.002793,573.4455184
WB-S23,3500,715,38384696.35,680,8527,7847,6688.208392,1938.212065
WB-S24,3500,714,38331011.46,587,9051,8464,4182.340336,2446.967623
WB-S25,3500,715,38384696.35,4544,8570,4026,7637.303497,570.4472459
WB-S26,3500,716,38438381.24,3198,8855,5657,8039.972067,853.3577955
WB-S27,3500,718,38545751.02,7094,8958,1864,7905.097493,267.4048321
WB-S28,3500,718,38545751.02,4708,8523,3815,7836.772981,542.6915692
WB-S29,3500,717,38492066.13,2195,9712,7517,7596.641562,976.18938
WB-S3,3500,719,38599435.91,590,8320,7730,5766.634214,1941.065627
WB-S4,3500,715,38384696.35,209,8830,8621,4588.030769,2745.530485
WB-S5,3500,719,38599435.91,1938,8908,6970,6164.38943,2039.203056
WB-S6,3500,716,38438381.24,1468,8513,7045,4811.755587,2215.753058
WB-S7,3500,720,38653120.8,1733,8181,6448,7221.220833,681.9070643
WB-S8,3500,714,38331011.46,1104,8513,7409,7310.05042,1147.048862
WB-S9,3500,718,38545751.02,-919,9979,10898,4852.728412,2653.648574
WB-W1,3500,718,38545751.02,879,8539,7660,6206.841226,1929.829414
WB-W10,3500,716,38438381.24,381,8692,8311,5670.175978,1875.955533
WB-W2,3500,717,38492066.13,2873,8875,6002,7778.535565,918.0243631
WB-W3,3500,715,38384696.35,5952,9491,3539,7443.858741,818.2848383
WB-W4,3500,717,38492066.13,4356,8060,3704,6524.53417,855.0793453
WB-W5,3500,719,38599435.91,4544,8627,4083,7602.038943,630.496977
WB-W6,3500,715,38384696.35,1782,8668,6886,7726.795804,953.6285112
WB-W7,3500,721,38706805.69,202,9919,9717,6496.327323,2377.828197
WB-W8,3500,720,38653120.8,3647,8088,4441,6993.9,824.5364765
WB-W9,3500,715,38384696.35,1432,9401,7969,6987.083916,1347.93723
W01,3750,821,44075294.69,313,9080,8767,7107.580999,1812.458321
W02,3750,821,44075294.69,1195,8861,7666,7643.566382,1121.172077
W03,3750,823,44182664.47,1004,8573,7569,7027.461725,1721.067689
W04,3750,818,43914240.02,4708,8539,3831,7841.522005,576.6912728
W05,3750,820,44021609.8,2208,8875,6667,7580.559756,1061.779543
W06,3750,823,44182664.47,1544,8764,7220,7695.443499,833.1909012
W07,3750,827,44397404.03,1101,8998,7897,7110.494559,1238.537966
W08,3750,822,44128979.58,1374,8617,7243,6433.233577,2030.534497
W09,3750,822,44128979.58,2195,9712,7517,7721.740876,850.9311915
W10,3750,821,44075294.69,1959,8688,6729,7166.677223,1462.374993
W11,3750,822,44128979.58,775,8539,7764,6134.975669,1973.655155
W12,3750,828,44451088.92,912,8266,7354,5836.694444,1636.217099
W13,3750,818,43914240.02,587,8351,7764,5654.99022,1715.054974
W14,3750,826,44343719.14,1769,8504,6735,7225.837772,1056.529743
W15,3750,823,44182664.47,1611,8504,6893,7043.63548,1536.753192
W16,3750,822,44128979.58,131,9860,9729,7071.571776,2052.247335
W17,3750,824,44236349.36,-11,8521,8532,6689.192961,2201.465959
W18,3750,824,44236349.36,301,8484,8183,7359.65534,1357.640882
W19,3750,821,44075294.69,-16,8517,8533,6532.828258,2028.540317
W20,3750,821,44075294.69,-840,8151,8991,6889.330085,972.6018958
W21,3750,827,44397404.03,477,8953,8476,6348.599758,2174.653757
W22,3750,817,43860555.13,-919,9979,10898,5320.749082,2631.34184
W23,3750,825,44290034.25,-867,8278,9145,6175.682424,1208.994322
W24,3750,822,44128979.58,222,8408,8186,5742.49635,2365.413632
W25,3750,821,44075294.69,262,8843,8581,6215.507917,2005.199222
W26,3750,825,44290034.25,37,8511,8474,4028.786667,2447.340494
W27,3750,822,44128979.58,1600,8843,7243,7104.663017,1043.068334
W28,3750,827,44397404.03,1084,9012,7928,6903.91052,1668.609926
W29,3750,826,44343719.14,1399,9012,7613,6959.176755,1502.606418
W30,3750,824,44236349.36,3093,8182,5089,7029.26699,1024.401634
W31,3750,821,44075294.69,6440,8667,2227,7875.609013,326.2493862
W32,3750,822,44128979.58,3198,9001,5803,8089.896594,741.5328868
W33,3750,824,44236349.36,2181,8845,6664,7769.598301,997.5088108
W34,3750,825,44290034.25,1364,9134,7770,5856.675152,2366.872557
W35,3750,822,44128979.58,1427,8470,7043,6825.083942,1606.57704
W36,3750,825,44290034.25,1249,8597,7348,6973.763636,1561.322828
W37,3750,825,44290034.25,1249,9107,7858,6414.756364,2057.951117
W38,3750,826,44343719.14,3459,8656,5197,7790.145278,455.4074441
W39,3750,822,44128979.58,1893,8399,6506,7224.019465,1081.171557
W40,3750,821,44075294.69,1335,8893,7558,6893.74056,1545.555362
W41,3750,826,44343719.14,2381,9046,6665,7323.483051,980.5906817
W42,3750,823,44182664.47,2151,8476,6325,7296.589307,974.4207359
W43,3750,825,44290034.25,2474,8390,5916,7090.886061,1174.925519
W44,3750,829,44504773.81,1522,8265,6743,7068.78649,1132.035833
W45,3750,827,44397404.03,1400,8736,7336,6540.114873,1668.757825
W46,3750,822,44128979.58,1576,8298,6722,6433.920925,1676.008762
W47,3750,826,44343719.14,1362,8465,7103,6261.714286,1909.024357
W48,3750,827,44397404.03,6391,8213,1822,7591.917775,252.6302851
W49,3750,822,44128979.58,1398,8603,7205,5687.76764,1857.710748
W50,3750,826,44343719.14,1825,8985,7160,7035.98063,1296.532401
W51,3750,827,44397404.03,4762,8484,3722,7385.804111,483.8891969
W52,3750,827,44397404.03,1406,8356,6950,5353.539299,2240.620061
W53,3750,828,44451088.92,3780,8362,4582,7285.560386,788.7582043
W54,3750,825,44290034.25,1663,8495,6832,6050.541818,1704.075843
W55,3750,818,43914240.02,1383,8566,7183,6537.347188,2002.020779
W56,3750,823,44182664.47,1177,9919,8742,6706.843256,1988.710299
W57,3750,822,44128979.58,1280,8731,7451,5166.043796,2045.88246
W58,3750,817,43860555.13,1500,8990,7490,6785.80049,1782.322024
W59,3750,825,44290034.25,765,8597,7832,4706.204848,2107.039157
W60,3750,825,44290034.25,1105,8471,7366,7021.938182,1210.535591
W61,3750,822,44128979.58,1549,8640,7091,7236.027981,1211.817074
W62,3750,826,44343719.14,-1058,8536,9594,4821.993947,2656.80932
W63,3750,825,44290034.25,143,8300,8157,3268.472727,2328.576946
W64,3750,824,44236349.36,1173,8113,6940,6390.775485,1281.109362
W65,3750,821,44075294.69,552,8000,7448,3707.132765,2444.541158
W66,3750,820,44021609.8,-35,8283,8318,3872.434146,2354.313102
WB-E1,3750,821,44075294.69,273,9051,8778,4952.958587,2597.156678
WB-E10,3750,825,44290034.25,377,8597,8220,3485.82303,2114.981638
WB-E2,3750,826,44343719.14,1295,8536,7241,7044.533898,884.5200553
WB-E3,3750,820,44021609.8,4294,8694,4400,7477.835366,422.2273644
WB-E4,3750,827,44397404.03,1782,8586,6804,7414.679565,1407.67348
WB-E5,3750,821,44075294.69,273,9051,8778,3963.041413,2474.84417
WB-E6,3750,828,44451088.92,2474,8390,5916,7318.762077,957.1912111
WB-E7,3750,825,44290034.25,204,8511,8307,6045.050909,2045.775727
WB-E8,3750,826,44343719.14,1328,8660,7332,6021.800242,2128.036346
WB-E9,3750,820,44021609.8,224,8690,8466,5110.697561,2292.412634
WB-H1,3750,827,44397404.03,1276,8465,7189,6454.631197,1831.466171
WB-H10,3750,827,44397404.03,1351,8208,6857,5621.073761,1844.735042
WB-H2,3750,820,44021609.8,1542,8668,7126,6460.606098,2025.590883
WB-H3,3750,823,44182664.47,1109,9158,8049,5926.533414,2396.897321
WB-H4,3750,827,44397404.03,1468,8513,7045,6060.859734,2146.687946
WB-H5,3750,827,44397404.03,882,8639,7757,4943.382104,2369.938575
WB-H6,3750,826,44343719.14,-410,9958,10368,5479.654964,2690.983862
WB-H7,3750,820,44021609.8,131,9987,9856,5416.540244,2560.414047
WB-H8,3750,822,44128979.58,1938,8956,7018,6200.373479,2033.196873
WB-H9,3750,824,44236349.36,587,8962,8375,4463.495146,2439.943691
WB-S1,3750,824,44236349.36,-214,9849,10063,4273.724515,2921.197511
WB-S10,3750,823,44182664.47,-1058,8711,9769,3827.377886,2574.148791
WB-S11,3750,823,44182664.47,552,8000,7448,4674.155529,2512.658722
WB-S12,3750,822,44128979.58,1194,8597,7403,4641.127737,2116.843243
WB-S13,3750,821,44075294.69,882,8639,7757,4934.967113,2220.850347
WB-S14,3750,820,44021609.8,1400,8736,7336,6839.709756,1393.186721
WB-S15,3750,826,44343719.14,1616,8298,6682,6464.283293,1659.102235
WB-S16,3750,821,44075294.69,222,8408,8186,5024.014616,2463.729868
WB-S17,3750,822,44128979.58,2645,8182,5537,7134.346715,1012.132916
WB-S18,3750,826,44343719.14,1033,9203,8170,6417.066586,2313.403362
WB-S19,3750,825,44290034.25,1383,8398,7015,6131.658182,2069.336836
WB-S2,3750,818,43914240.02,-796,9932,10728,4353.717604,3781.277576
WB-S20,3750,824,44236349.36,1525,8750,7225,7576.26335,1121.455903
WB-S21,3750,822,44128979.58,2676,8399,5723,6962.956204,1246.377189
WB-S22,3750,826,44343719.14,2869,8039,5170,7365.941889,578.1101247
WB-S23,3750,821,44075294.69,680,8527,7847,6647.077954,1943.894803
WB-S24,3750,827,44397404.03,587,9051,8464,4377.348247,2439.647774
WB-S25,3750,824,44236349.36,4223,8570,4347,7601.53034,640.7589414
WB-S26,3750,820,44021609.8,3198,8855,5657,8011.923171,874.1724352
WB-S27,3750,826,44343719.14,7035,8958,1923,7901.556901,279.3963396
WB-S28,3750,822,44128979.58,4618,8605,3987,7826.682482,571.9738459
WB-S29,3750,822,44128979.58,2195,9712,7517,7570.627737,975.7891248
WB-S3,3750,822,44128979.58,590,9322,8732,5715.097324,2002.206971
WB-S4,3750,827,44397404.03,209,8830,8621,4587.20919,2759.229385
WB-S5,3750,824,44236349.36,1938,8956,7018,6220.98665,2029.226993
WB-S6,3750,825,44290034.25,1468,8513,7045,4978.562424,2262.157122
WB-S7,3750,826,44343719.14,1733,8303,6570,7199.059322,811.6425683
WB-S8,3750,827,44397404.03,301,8513,8212,7180.570738,1364.086389
WB-S9,3750,821,44075294.69,-919,9979,10898,4831.951279,2639.272527
WB-W1,3750,825,44290034.25,775,8539,7764,6080.401212,2042.999529
WB-W10,3750,827,44397404.03,381,9000,8619,5646.112455,1957.727633
WB-W2,3750,821,44075294.69,2340,8875,6535,7727.551766,969.8290575
WB-W3,3750,827,44397404.03,5952,9491,3539,7442.772672,809.4373695
WB-W4,3750,825,44290034.25,4356,8060,3704,6579.379394,849.3207198
WB-W5,3750,820,44021609.8,4367,8627,4260,7586.490244,661.0526186
WB-W6,3750,826,44343719.14,1782,8668,6886,7657.066586,1064.674091
WB-W7,3750,823,44182664.47,202,9919,9717,6290.773998,2474.475167
WB-W8,3750,825,44290034.25,3647,8088,4441,7022.795152,811.7531199
WB-W9,3750,825,44290034.25,1432,9503,8071,6920.196364,1414.516277
W01,4000,939,50410111.71,313,9109,8796,7128.802982,1852.300724
W02,4000,934,50141687.26,1195,8861,7666,7626.138116,1158.295551
W03,4000,935,50195372.15,904,8573,7669,6957.322995,1833.276927
W04,4000,935,50195372.15,3182,8539,5357,7828.709091,619.0110267
W05,4000,936,50249057.04,2208,8875,6667,7477.752137,1191.614742
W06,4000,940,50463796.6,1544,8768,7224,7663.391489,939.0580794
W07,4000,935,50195372.15,826,9074,8248,7031.851337,1403.089952
W08,4000,939,50410111.71,1374,8617,7243,6559.58147,1967.405607
W09,4000,941,50517481.49,2195,9712,7517,7707.068013,858.5583533
W10,4000,934,50141687.26,1550,8688,7138,7067.846895,1568.589223
W11,4000,941,50517481.49,775,8539,7764,6011.077577,2059.770005
W12,4000,935,50195372.15,704,8266,7562,5838.680214,1662.430764
W13,4000,935,50195372.15,587,8359,7772,5717.296257,1716.413033
W14,4000,935,50195372.15,1210,8504,7294,7127.774332,1247.093195
W15,4000,942,50571166.38,1611,8504,6893,7042.124204,1531.598793
W16,4000,939,50410111.71,131,9860,9729,7023.505857,2071.559878
W17,4000,936,50249057.04,-11,9679,9690,6601.074786,2261.393995
W18,4000,934,50141687.26,301,8484,8183,7253.767666,1535.945117
W19,4000,933,50088002.37,-93,8517,8610,6463.924973,2105.37976
W20,4000,938,50356426.82,-867,8230,9097,6793.195096,1205.623176
W21,4000,935,50195372.15,477,8953,8476,6364.073797,2159.513846
W22,4000,936,50249057.04,-919,9979,10898,5271.380342,2635.988836
W23,4000,938,50356426.82,-867,8278,9145,6177.883795,1259.760731
W24,4000,940,50463796.6,222,8408,8186,5749.520213,2366.629118
W25,4000,935,50195372.15,262,8843,8581,6263.990374,1930.076455
W26,4000,935,50195372.15,5,8511,8506,4037.453476,2468.532539
W27,4000,940,50463796.6,1600,8843,7243,7046.542553,1112.681664
W28,4000,933,50088002.37,1023,9012,7989,6855.842444,1723.111846
W29,4000,934,50141687.26,1399,9012,7613,6899.185225,1538.79394
W30,4000,940,50463796.6,2645,8182,5537,7073.610638,1006.430576
W31,4000,932,50034317.48,6440,8667,2227,7882.915236,329.7734043
W32,4000,939,50410111.71,3198,9001,5803,8070.743344,747.0362464
W33,4000,938,50356426.82,2181,8855,6674,7704.379531,1120.764897
W34,4000,943,50624851.27,1364,9134,7770,5916.942736,2339.282508
W35,4000,941,50517481.49,1427,8470,7043,6775.324123,1638.184291
W36,4000,943,50624851.27,1249,8597,7348,6974.879109,1530.534801
W37,4000,936,50249057.04,1249,9107,7858,6437.78953,2017.055163
W38,4000,943,50624851.27,3459,8750,5291,7786.834571,438.2406552
W39,4000,939,50410111.71,1893,8399,6506,7240.076677,1061.701795
W40,4000,934,50141687.26,1335,8893,7558,6900.19379,1550.942175
W41,4000,935,50195372.15,2381,9046,6665,7213.503743,1083.786554
W42,4000,935,50195372.15,2151,8476,6325,7245.950802,1072.217644
W43,4000,937,50302741.93,2474,8390,5916,7106.934899,1141.135883
W44,4000,938,50356426.82,1522,8265,6743,7039.097015,1178.230082
W45,4000,938,50356426.82,1400,8736,7336,6508.803838,1667.724959
W46,4000,941,50517481.49,1507,8298,6791,6451.867163,1670.278514
W47,4000,936,50249057.04,1276,8465,7189,6242.064103,1908.266135
W48,4000,936,50249057.04,6391,8396,2005,7586.951923,266.4187406
W49,4000,938,50356426.82,1398,8820,7422,5709.84968,1877.832459
W50,4000,935,50195372.15,1715,8985,7270,6993.342246,1373.336438
W51,4000,937,50302741.93,3807,8484,4677,7332.2508,623.43
W52,4000,936,50249057.04,1406,8356,6950,5472.733974,2202.467236
W53,4000,936,50249057.04,3264,8865,5601,7259.423077,847.2764413
W54,4000,944,50678536.16,1663,8495,6832,6104.233051,1704.894898
W55,4000,936,50249057.04,1383,8566,7183,6490.029915,2009.369351
W56,4000,940,50463796.6,1177,9919,8742,6590.287234,2034.460883
W57,4000,936,50249057.04,1280,8731,7451,5147.530983,2066.10859
W58,4000,936,50249057.04,1500,8990,7490,6706.132479,1860.791933
W59,4000,937,50302741.93,765,8597,7832,4618.646745,2147.359514
W60,4000,936,50249057.04,825,8486,7661,6950.30235,1333.294544
W61,4000,935,50195372.15,1045,8640,7595,7177.429947,1309.881452
W62,4000,936,50249057.04,-1058,8536,9594,4774.774573,2684.780413
W63,4000,941,50517481.49,143,8300,8157,3225.107333,2297.788701
W64,4000,943,50624851.27,1063,8175,7112,6259.582185,1477.353807
W65,4000,935,50195372.15,483,8000,7517,3708.985027,2414.302377
W66,4000,937,50302741.93,-35,8320,8355,3744.197439,2356.793146
WB-E1,4000,932,50034317.48,273,9051,8778,4818.5,2582.836542
WB-E10,4000,937,50302741.93,377,8791,8414,3542.966916,2121.136423
WB-E2,4000,938,50356426.82,1295,8536,7241,6999.464819,1000.152718
WB-E3,4000,936,50249057.04,2997,8694,5697,7456.626068,465.8466022
WB-E4,4000,935,50195372.15,1542,8668,7126,7384.771123,1454.244113
WB-E5,4000,936,50249057.04,273,9051,8778,4031.813034,2481.315532
WB-E6,4000,937,50302741.93,2474,8390,5916,7296.757737,967.0044549
WB-E7,4000,935,50195372.15,204,8511,8307,5979.157219,2103.182074
WB-E8,4000,935,50195372.15,1328,8660,7332,6002.775401,2111.934637
WB-E9,4000,936,50249057.04,224,8956,8732,5059.257479,2297.719325
WB-H1,4000,944,50678536.16,1276,8465,7189,6460.997881,1815.800437
WB-H10,4000,939,50410111.71,1351,8208,6857,5540.942492,1879.204121
WB-H2,4000,936,50249057.04,1542,8668,7126,6575.961538,1986.114968
WB-H3,4000,942,50571166.38,1109,9158,8049,5850.70276,2381.529644
WB-H4,4000,936,50249057.04,1468,8513,7045,6063.05235,2126.746693
WB-H5,4000,938,50356426.82,882,8926,8044,4997.103412,2353.989987
WB-H6,4000,933,50088002.37,-410,9958,10368,5531.082529,2717.02015
WB-H7,4000,933,50088002.37,131,9987,9856,5631.682744,2569.959877
WB-H8,4000,942,50571166.38,1938,8956,7018,6309.484076,2016.284196
WB-H9,4000,936,50249057.04,587,8962,8375,4588.494658,2479.441645
WB-S1,4000,941,50517481.49,-256,9849,10105,4321.328374,2897.30644
WB-S10,4000,943,50624851.27,-1058,8711,9769,3811.932131,2545.90764
WB-S11,4000,941,50517481.49,552,8000,7448,4724.16153,2496.769318
WB-S12,4000,937,50302741.93,1194,8597,7403,4588.550694,2110.40679
WB-S13,4000,936,50249057.04,882,8639,7757,5024.711538,2266.598488
WB-S14,4000,936,50249057.04,1400,8736,7336,6784.660256,1444.045213
WB-S15,4000,943,50624851.27,1512,8298,6786,6496.662778,1650.478856
WB-S16,4000,933,50088002.37,222,8408,8186,5111.378349,2471.96963
WB-S17,4000,933,50088002.37,2645,8182,5537,7150.382637,995.7665181
WB-S18,4000,935,50195372.15,651,9203,8552,6435.79893,2342.595529
WB-S19,4000,937,50302741.93,1383,8398,7015,6179.843116,2031.808028
WB-S2,4000,937,50302741.93,-997,9932,10929,4329,3772.303381
WB-S20,4000,937,50302741.93,1525,8750,7225,7497.351121,1239.228994
WB-S21,4000,941,50517481.49,2508,8399,5891,6926.767269,1280.514397
WB-S22,4000,939,50410111.71,2822,8039,5217,7348.551651,610.2436848
WB-S23,4000,934,50141687.26,680,8574,7894,6644.991435,1917.300927
WB-S24,4000,936,50249057.04,587,9051,8464,4475.569444,2438.111572
WB-S25,4000,935,50195372.15,2805,8570,5765,7531.495187,805.6610065
WB-S26,4000,934,50141687.26,3198,8855,5657,7986.255889,905.9101424
WB-S27,4000,936,50249057.04,5455,8958,3503,7893.344017,318.2622105
WB-S28,4000,940,50463796.6,2838,8605,5767,7802.409574,640.7144876
WB-S29,4000,940,50463796.6,2195,9712,7517,7544.006383,962.4713679
WB-S3,4000,941,50517481.49,572,9322,8750,5663.177471,2056.930445
WB-S4,4000,938,50356426.82,209,8830,8621,4574.352878,2757.678443
WB-S5,4000,937,50302741.93,1938,8956,7018,6232.272145,2018.238432
WB-S6,4000,936,50249057.04,1468,8513,7045,5121.606838,2286.393423
WB-S7,4000,937,50302741.93,1733,8503,6770,7164.033084,921.3718149
WB-S8,4000,935,50195372.15,301,8517,8216,7120.906952,1470.060527
WB-S9,4000,935,50195372.15,-919,9979,10898,4847.045989,2609.491153
WB-W1,4000,943,50624851.27,775,8539,7764,5977.141039,2117.143891
WB-W10,4000,934,50141687.26,381,9000,8619,5613.342612,2018.430422
WB-W2,4000,930,49926947.7,2340,8875,6535,7688.283871,990.2141525
WB-W3,4000,935,50195372.15,4896,9491,4595,7430.203209,810.4346371
WB-W4,4000,934,50141687.26,3585,8332,4747,6611.180942,852.6118371
WB-W5,4000,936,50249057.04,4367,8627,4260,7565.949786,688.6731007
WB-W6,4000,936,50249057.04,1782,8668,6886,7588.564103,1166.638475
WB-W7,4000,939,50410111.71,202,9919,9717,6126.400426,2552.968395
WB-W8,4000,937,50302741.93,3445,8228,4783,7033.359658,811.9196325
WB-W9,4000,936,50249057.04,1432,9677,8245,6877.554487,1491.213561
W01,4250,1061,56959668.29,313,9157,8844,7149.159284,1861.71203
W02,4250,1057,56744928.73,1195,8861,7666,7582.934721,1226.315942
W03,4250,1059,56852298.51,879,8573,7694,6913.996223,1882.754303
W04,4250,1050,56369134.5,3182,8605,5423,7810.792381,671.2588109
W05,4250,1061,56959668.29,2208,8875,6667,7402.539114,1260.448881
W06,4250,1061,56959668.29,1544,8828,7284,7632.974552,962.6693157
W07,4250,1061,56959668.29,775,9300,8525,6958.169651,1521.369777
W08,4250,1061,56959668.29,1374,8617,7243,6638.198869,1910.298673
W09,4250,1061,56959668.29,2195,9712,7517,7664.590952,884.8818536
W10,4250,1056,56691243.84,1550,8688,7138,6973.724432,1653.608345
W11,4250,1063,57067038.07,680,8539,7859,5932.952963,2097.129733
W12,4250,1060,56905983.4,703,8412,7709,5826.268868,1731.691413
W13,4250,1051,56422819.39,587,8402,7815,5789.498573,1715.259449
W14,4250,1060,56905983.4,1199,8504,7305,7033.750943,1399.751284
W15,4250,1059,56852298.51,1554,8504,6950,6996.253069,1553.023664
W16,4250,1060,56905983.4,131,9860,9729,6974.071698,2088.631199
W17,4250,1057,56744928.73,-11,9679,9690,6569.677389,2280.131671
W18,4250,1059,56852298.51,301,8485,8184,7173.784703,1599.836806
W19,4250,1052,56476504.28,-93,8634,8727,6393.747148,2184.568004
W20,4250,1052,56476504.28,-867,8451,9318,6704.179658,1397.22534
W21,4250,1060,56905983.4,96,8953,8857,6349.283019,2197.380909
W22,4250,1050,56369134.5,-919,9979,10898,5226.89619,2618.626113
W23,4250,1063,57067038.07,-867,9979,10846,6201.742239,1324.29543
W24,4250,1060,56905983.4,222,8953,8731,5757.464151,2381.362773
W25,4250,1053,56530189.17,262,8843,8581,6321.931624,1868.766697
W26,4250,1058,56798613.62,-159,8511,8670,4066.742911,2492.083233
W27,4250,1063,57067038.07,1409,8843,7434,6986.32079,1179.312952
W28,4250,1060,56905983.4,899,9012,8113,6780.59717,1797.462371
W29,4250,1058,56798613.62,1399,9012,7613,6822.510397,1583.541915
W30,4250,1061,56959668.29,2645,8182,5537,7102.491989,977.6858746
W31,4250,1051,56422819.39,6440,8692,2252,7888.50999,336.4142827
W32,4250,1063,57067038.07,3198,9001,5803,8042.155221,769.0158849
W33,4250,1061,56959668.29,1741,8855,7114,7634.054665,1229.663168
W34,4250,1059,56852298.51,1364,9134,7770,5973.143532,2316.806851
W35,4250,1063,57067038.07,1427,8470,7043,6758.4873,1651.120475
W36,4250,1060,56905983.4,1249,9107,7858,6950.418868,1514.603522
W37,4250,1057,56744928.73,1249,9107,7858,6471.543046,1972.407055
W38,4250,1061,56959668.29,3459,8750,5291,7785.909519,418.4781
W39,4250,1055,56637558.95,1893,8399,6506,7255.145024,1047.79317
W40,4250,1059,56852298.51,1335,8893,7558,6898.523135,1542.983643
W41,4250,1058,56798613.62,2381,9046,6665,7109.619093,1183.050651
W42,4250,1056,56691243.84,2151,8476,6325,7212.712121,1107.183635
W43,4250,1057,56744928.73,2474,8390,5916,7135.04825,1104.530474
W44,4250,1059,56852298.51,1522,8265,6743,6960.476865,1281.007202
W45,4250,1064,57120722.96,1400,8736,7336,6489.644737,1661.256353
W46,4250,1063,57067038.07,1507,8298,6791,6436.839135,1686.449749
W47,4250,1061,56959668.29,1276,8465,7189,6221.93591,1908.795862
W48,4250,1062,57013353.18,2906,8674,5768,7561.329567,381.9774432
W49,4250,1056,56691243.84,1398,8820,7422,5748.837121,1886.22802
W50,4250,1060,56905983.4,1715,8985,7270,6936.89717,1453.432364
W51,4250,1063,57067038.07,2965,8484,5519,7266.066792,782.3727258
W52,4250,1059,56852298.51,1406,8356,6950,5559.803588,2172.627922
W53,4250,1059,56852298.51,2896,8865,5969,7214.683664,922.9183846
W54,4250,1061,56959668.29,1663,8495,6832,6161.854854,1678.479679
W55,4250,1051,56422819.39,1383,8566,7183,6456.334919,2000.626128
W56,4250,1063,57067038.07,1177,9919,8742,6473.003763,2085.349232
W57,4250,1062,57013353.18,1280,8731,7451,5142.397363,2098.646311
W58,4250,1050,56369134.5,1270,8990,7720,6670.199048,1904.864932
W59,4250,1057,56744928.73,377,8597,8220,4533.848628,2194.401395
W60,4250,1057,56744928.73,793,8486,7693,6889.516556,1427.046998
W61,4250,1060,56905983.4,1045,8640,7595,7115.489623,1421.007752
W62,4250,1058,56798613.62,-1058,8536,9594,4759.670132,2705.923644
W63,4250,1063,57067038.07,-175,8300,8475,3220.995296,2286.202243
W64,4250,1061,56959668.29,1044,8238,7194,6149.581527,1624.632639
W65,4250,1052,56476504.28,377,8000,7623,3746.059886,2393.471735
W66,4250,1061,56959668.29,-35,8359,8394,3696.239397,2362.485579
WB-E1,4250,1050,56369134.5,273,9051,8778,4676.733333,2580.66777
WB-E10,4250,1061,56959668.29,377,8791,8414,3564.626767,2128.279194
WB-E2,4250,1063,57067038.07,1295,8536,7241,6917.682973,1153.463127
WB-E3,4250,1057,56744928.73,2997,8694,5697,7442.129612,482.4761907
WB-E4,4250,1061,56959668.29,1542,8668,7126,7363.890669,1497.90873
WB-E5,4250,1053,56530189.17,273,9051,8778,4113.728395,2475.153642
WB-E6,4250,1058,56798613.62,2474,8390,5916,7282.042533,968.7480652
WB-E7,4250,1058,56798613.62,204,8511,8307,5915.570888,2135.523447
WB-E8,4250,1058,56798613.62,1259,8660,7401,5983.136106,2117.329096
WB-E9,4250,1050,56369134.5,224,8956,8732,5017.151429,2305.155096
WB-H1,4250,1063,57067038.07,1276,8465,7189,6484.152399,1784.09691
WB-H10,4250,1062,57013353.18,1351,8208,6857,5455.955744,1920.800963
WB-H2,4250,1050,56369134.5,1542,8668,7126,6666.468571,1955.940894
WB-H3,4250,1060,56905983.4,1109,9158,8049,5805.251887,2350.110415
WB-H4,4250,1059,56852298.51,1468,8513,7045,6034.369216,2132.165723
WB-H5,4250,1058,56798613.62,882,9046,8164,5077.285444,2344.713204
WB-H6,4250,1058,56798613.62,-410,9958,10368,5622.733459,2719.707065
WB-H7,4250,1056,56691243.84,131,9987,9856,5839.102273,2551.614564
WB-H8,4250,1061,56959668.29,1902,8956,7054,6407.540999,1996.184488
WB-H9,4250,1058,56798613.62,587,9051,8464,4756.486767,2528.001435
WB-S1,4250,1060,56905983.4,-399,9849,10248,4437.268868,2878.713853
WB-S10,4250,1060,56905983.4,-1058,8711,9769,3827.751887,2531.196528
WB-S11,4250,1062,57013353.18,552,8000,7448,4793.885122,2471.858089
WB-S12,4250,1054,56583874.06,1194,8597,7403,4543.135674,2112.983508
WB-S13,4250,1053,56530189.17,882,8639,7757,5141.48528,2296.286103
WB-S14,4250,1048,56261764.72,1400,8736,7336,6777.062977,1452.747085
WB-S15,4250,1062,57013353.18,1446,8298,6852,6525.101695,1640.119927
WB-S16,4250,1050,56369134.5,222,8408,8186,5183.861905,2472.150268
WB-S17,4250,1057,56744928.73,2645,8521,5876,7173.391675,968.6818282
WB-S18,4250,1057,56744928.73,651,9203,8552,6443.642384,2353.043703
WB-S19,4250,1056,56691243.84,1383,8398,7015,6231.897727,1985.641929
WB-S2,4250,1052,56476504.28,-997,9932,10929,4275.578897,3746.803726
WB-S20,4250,1058,56798613.62,1335,8750,7415,7434.555766,1327.305738
WB-S21,4250,1063,57067038.07,1895,8399,6504,6913.837253,1302.176058
WB-S22,4250,1057,56744928.73,2822,8240,5418,7339.589404,643.7290396
WB-S23,4250,1060,56905983.4,680,8654,7974,6641.901887,1880.981193
WB-S24,4250,1058,56798613.62,587,9051,8464,4570.912098,2458.930966
WB-S25,4250,1059,56852298.51,2045,8570,6525,7441.628895,991.4748913
WB-S26,4250,1054,56583874.06,2902,8855,5953,7921.498102,1017.651431
WB-S27,4250,1058,56798613.62,4030,8958,4928,7861.824197,417.9824701
WB-S28,4250,1059,56852298.51,2838,8605,5767,7754.806421,747.0631864
WB-S29,4250,1062,57013353.18,2195,9712,7517,7523.181733,944.0004778
WB-S3,4250,1061,56959668.29,509,9322,8813,5614.852026,2109.707278
WB-S4,4250,1056,56691243.84,209,8830,8621,4573.13447,2751.150247
WB-S5,4250,1056,56691243.84,1938,8956,7018,6229.578598,2009.474916
WB-S6,4250,1057,56744928.73,1283,8513,7230,5241.358562,2300.121955
WB-S7,4250,1062,57013353.18,1715,8503,6788,7109.46516,1055.741889
WB-S8,4250,1058,56798613.62,301,8517,8216,7060.257089,1547.256525
WB-S9,4250,1052,56476504.28,-919,9979,10898,4838.910646,2587.730634
WB-W1,4250,1058,56798613.62,775,8539,7764,5920.324197,2125.860876
WB-W10,4250,1060,56905983.4,381,9000,8619,5567.7,2087.43356
WB-W2,4250,1054,56583874.06,2340,8875,6535,7623.652751,1035.387672
WB-W3,4250,1059,56852298.51,4532,9569,5037,7411.779037,822.8125091
WB-W4,4250,1056,56691243.84,3033,8332,5299,6620.200758,876.5619638
WB-W5,4250,1048,56261764.72,4367,8627,4260,7542.926527,715.4843188
WB-W6,4250,1055,56637558.95,1782,8668,6886,7535.579147,1235.183624
WB-W7,4250,1060,56905983.4,142,9919,9777,6018.611321,2607.655078
WB-W8,4250,1061,56959668.29,2956,8228,5272,7030.085768,824.615011
WB-W9,4250,1059,56852298.51,1432,9677,8245,6814.710104,1574.28442
W01,4500,1186,63670279.54,313,9911,9598,7113.026981,1912.293225
W02,4500,1187,63723964.43,1195,8861,7666,7572.760741,1224.517847
W03,4500,1184,63562909.76,879,8573,7694,6868.695946,1909.547819
W04,4500,1179,63294485.31,3182,8605,5423,7794.693808,689.806675
W05,4500,1187,63723964.43,2208,8875,6667,7341.866891,1306.747823
W06,4500,1187,63723964.43,1544,8828,7284,7590.120472,1012.32379
W07,4500,1185,63616594.65,775,9419,8644,6883.790717,1616.039738
W08,4500,1189,63831334.21,1374,8717,7343,6726.960471,1849.508862
W09,4500,1186,63670279.54,2195,9712,7517,7613.330523,965.4329842
W10,4500,1187,63723964.43,1550,8688,7138,6898.759056,1725.716183
W11,4500,1188,63777649.32,680,8539,7859,5923.441919,2080.69779
W12,4500,1185,63616594.65,680,8412,7732,5824.672574,1786.056594
W13,4500,1180,63348170.2,587,8832,8245,5856.305085,1737.450221
W14,4500,1182,63455539.98,867,8504,7637,6961.365482,1508.069287
W15,4500,1187,63723964.43,1554,8570,7016,6968.539174,1562.775637
W16,4500,1187,63723964.43,131,9860,9729,6936.67818,2099.473865
W17,4500,1186,63670279.54,-11,9679,9690,6557.424958,2292.000963
W18,4500,1183,63509224.87,301,8485,8184,7091.759932,1670.362449
W19,4500,1186,63670279.54,-93,8795,8888,6376.039629,2210.811592
W20,4500,1182,63455539.98,-867,9979,10846,6634.036379,1532.587805
W21,4500,1185,63616594.65,79,8953,8874,6316.03038,2255.641318
W22,4500,1182,63455539.98,-919,9979,10898,5174.274958,2592.1966
W23,4500,1187,63723964.43,-867,9979,10846,6239.709351,1360.124689
W24,4500,1185,63616594.65,222,8953,8731,5766.625316,2388.092178
W25,4500,1184,63562909.76,262,8843,8581,6362.193412,1810.465361
W26,4500,1185,63616594.65,-159,8511,8670,4117.496203,2523.24815
W27,4500,1189,63831334.21,368,8843,8475,6910.505467,1277.246206
W28,4500,1178,63240800.42,899,9012,8113,6689.148557,1890.278287
W29,4500,1184,63562909.76,1184,9012,7828,6732.404561,1665.347811
W30,4500,1188,63777649.32,2645,8182,5537,7129.140572,949.0040347
W31,4500,1188,63777649.32,6440,8745,2305,7898.569865,338.5082137
W32,4500,1191,63938703.99,3198,9001,5803,8011.253568,787.8026522
W33,4500,1186,63670279.54,1395,9004,7609,7580.747049,1332.680033
W34,4500,1194,64099758.66,1364,9134,7770,6053.540201,2282.748065
W35,4500,1189,63831334.21,1427,8470,7043,6772.754415,1637.335205
W36,4500,1192,63992388.88,1249,9107,7858,6916.801174,1524.142195
W37,4500,1185,63616594.65,1249,9107,7858,6509.940084,1943.737078
W38,4500,1193,64046073.77,3459,8750,5291,7782.313495,403.3903768
W39,4500,1184,63562909.76,1893,8399,6506,7278.371622,1017.243517
W40,4500,1189,63831334.21,1335,8893,7558,6865.920942,1556.962366
W41,4500,1187,63723964.43,2134,9046,6912,7033.979781,1250.506261
W42,4500,1186,63670279.54,2089,8476,6387,7186.743676,1147.472876
W43,4500,1186,63670279.54,2474,8390,5916,7165.643339,1065.528042
W44,4500,1185,63616594.65,1522,8265,6743,6880.95865,1382.196533
W45,4500,1189,63831334.21,1400,8736,7336,6465.005046,1677.524206
W46,4500,1189,63831334.21,1375,8298,6923,6380.095879,1727.816234
W47,4500,1188,63777649.32,1276,8465,7189,6234.473064,1884.663204
W48,4500,1187,63723964.43,2485,8772,6287,7531.906487,531.0110087
W49,4500,1184,63562909.76,1398,8820,7422,5764.068412,1887.104777
W50,4500,1187,63723964.43,1715,8985,7270,6896.529065,1493.918809
W51,4500,1187,63723964.43,2611,8484,5873,7193.759056,939.8541961
W52,4500,1185,63616594.65,1406,8356,6950,5638.21519,2148.24364
W53,4500,1188,63777649.32,2896,8865,5969,7166.757576,966.9176991
W54,4500,1194,64099758.66,1663,8495,6832,6169.743719,1685.676353
W55,4500,1179,63294485.31,1383,8623,7240,6417.831213,2006.975244
W56,4500,1187,63723964.43,1177,9919,8742,6356.871946,2147.419297
W57,4500,1191,63938703.99,1280,8990,7710,5172.752309,2118.180951
W58,4500,1186,63670279.54,1270,8990,7720,6627.309444,1940.415824
W59,4500,1185,63616594.65,377,8961,8584,4435.602532,2245.849528
W60,4500,1187,63723964.43,781,8486,7705,6822.52401,1512.396112
W61,4500,1190,63885019.1,890,8640,7750,7050.469748,1527.697254
W62,4500,1184,63562909.76,-1058,8536,9594,4755.059122,2717.182007
W63,4500,1188,63777649.32,-175,8300,8475,3266.265993,2275.596651
W64,4500,1193,64046073.77,893,8291,7398,6023.705784,1777.580956
W65,4500,1185,63616594.65,377,8000,7623,3802.658228,2402.002969
W66,4500,1189,63831334.21,-35,8359,8394,3611.571909,2346.428583
WB-E1,4500,1186,63670279.54,273,9051,8778,4547.964587,2569.670096
WB-E10,4500,1188,63777649.32,377,8791,8414,3569.180976,2128.721486
WB-E2,4500,1187,63723964.43,1192,8536,7344,6815.110362,1309.413071
WB-E3,4500,1188,63777649.32,2997,8694,5697,7431.170034,486.2092146
WB-E4,4500,1184,63562909.76,1542,8668,7126,7366.037162,1506.122745
WB-E5,4500,1183,63509224.87,273,9051,8778,4193.016061,2473.711179
WB-E6,4500,1184,63562909.76,2474,8390,5916,7271.440878,967.5240804
WB-E7,4500,1184,63562909.76,204,8511,8307,5867.765203,2154.909712
WB-E8,4500,1186,63670279.54,1200,8660,7460,5929.349073,2152.531501
WB-E9,4500,1178,63240800.42,224,8956,8732,5050.988115,2310.811476
WB-H1,4500,1194,64099758.66,1276,8465,7189,6523.265494,1745.201387
WB-H10,4500,1187,63723964.43,1351,8208,6857,5419.629318,1939.29903
WB-H2,4500,1179,63294485.31,1542,8668,7126,6717.545377,1932.703881
WB-H3,4500,1192,63992388.88,1109,9158,8049,5806.410235,2321.292594
WB-H4,4500,1187,63723964.43,1468,8513,7045,6037.89048,2129.212156
WB-H5,4500,1184,63562909.76,882,9046,8164,5182.298142,2329.669968
WB-H6,4500,1179,63294485.31,-410,9958,10368,5722.028838,2722.41943
WB-H7,4500,1186,63670279.54,131,9987,9856,5971.496627,2502.276279
WB-H8,4500,1192,63992388.88,1902,8956,7054,6498.91443,1975.641749
WB-H9,4500,1185,63616594.65,587,9051,8464,4923.455696,2549.85223
WB-S1,4500,1191,63938703.99,-448,9849,10297,4596.024349,2864.759509
WB-S10,4500,1185,63616594.65,-1058,8764,9822,3886.459072,2538.781751
WB-S11,4500,1188,63777649.32,552,8000,7448,4844.366162,2457.349472
WB-S12,4500,1183,63509224.87,1194,8597,7403,4515.732037,2113.305114
WB-S13,4500,1186,63670279.54,882,8639,7757,5237.908094,2305.825372
WB-S14,4500,1178,63240800.42,1400,8736,7336,6807.756367,1448.907544
WB-S15,4500,1194,64099758.66,1375,8298,6923,6497.89531,1659.631381
WB-S16,4500,1184,63562909.76,222,8843,8621,5270.334459,2475.135528
WB-S17,4500,1188,63777649.32,2645,8521,5876,7190.006734,953.5765
WB-S18,4500,1186,63670279.54,651,9203,8552,6455.250422,2352.137175
WB-S19,4500,1185,63616594.65,1383,8566,7183,6280.787342,1939.46315
WB-S2,4500,1181,63401855.09,-1349,9932,11281,4176.176969,3713.013048
WB-S20,4500,1186,63670279.54,1335,8750,7415,7385.243676,1395.189856
WB-S21,4500,1190,63885019.1,1893,8399,6506,6918.636134,1308.974997
WB-S22,4500,1188,63777649.32,2474,8694,6220,7333.714646,687.9643998
WB-S23,4500,1187,63723964.43,680,8657,7977,6642.648694,1854.062821
WB-S24,4500,1184,63562909.76,273,9051,8778,4606.032939,2472.982183
WB-S25,4500,1184,63562909.76,1753,8570,6817,7342.186655,1183.282157
WB-S26,4500,1188,63777649.32,2902,8855,5953,7873.305556,1065.508094
WB-S27,4500,1186,63670279.54,1548,8958,7410,7816.495784,608.1379956
WB-S28,4500,1187,63723964.43,2444,8629,6185,7719.599832,830.617572
WB-S29,4500,1186,63670279.54,2195,9712,7517,7499.259696,937.2186894
WB-S3,4500,1191,63938703.99,-35,9322,9357,5604.738035,2133.516462
WB-S4,4500,1186,63670279.54,209,8830,8621,4578.051433,2729.293354
WB-S5,4500,1184,63562909.76,1938,8956,7018,6224.623311,2018.882738
WB-S6,4500,1186,63670279.54,1283,8513,7230,5347.254637,2290.460941
WB-S7,4500,1189,63831334.21,1715,8541,6826,7054.015139,1192.924879
WB-S8,4500,1184,63562909.76,301,8801,8500,7024.672297,1579.206765
WB-S9,4500,1185,63616594.65,-919,9979,10898,4860.737553,2577.167984
WB-W1,4500,1192,63992388.88,680,8539,7859,5915.093121,2102.707538
WB-W10,4500,1179,63294485.31,381,9000,8619,5540.398643,2125.124852
WB-W2,4500,1185,63616594.65,2340,8875,6535,7575.957806,1064.472336
WB-W3,4500,1183,63509224.87,3881,9712,5831,7393.523246,855.4878886
WB-W4,4500,1185,63616594.65,1371,8332,6961,6616.066667,946.0994041
WB-W5,4500,1177,63187115.53,2665,8627,5962,7513.391674,770.1500215
WB-W6,4500,1185,63616594.65,1782,8668,6886,7492.462447,1287.526542
WB-W7,4500,1189,63831334.21,-130,9919,10049,5912.302775,2667.372934
WB-W8,4500,1186,63670279.54,2956,8228,5272,7041.96543,846.1534239
WB-W9,4500,1188,63777649.32,1432,9677,8245,6756.275253,1661.911706
W01,4750,1325,71132479.25,313,9911,9598,7110.342642,1915.82403
W02,4750,1322,70971424.58,1195,8861,7666,7566.416793,1225.488162
W03,4750,1321,70917739.69,775,8573,7798,6836.291446,1915.119586
W04,4750,1317,70703000.13,2838,8629,5791,7767.618071,737.9006395
W05,4750,1322,70971424.58,2208,8875,6667,7314.900151,1324.06158
W06,4750,1327,71239849.03,1544,8828,7284,7545.768651,1068.326294
W07,4750,1323,71025109.47,775,9491,8716,6834.515495,1673.703114
W08,4750,1327,71239849.03,1374,8717,7343,6798.49887,1792.232093
W09,4750,1325,71132479.25,2195,9712,7517,7561.382642,1025.887332
W10,4750,1320,70864054.8,1550,8688,7138,6876.721212,1743.706031
W11,4750,1327,71239849.03,680,8539,7859,5921.787491,2054.691193
W12,4750,1323,71025109.47,680,8412,7732,5810.343159,1826.761615
W13,4750,1317,70703000.13,587,8981,8394,5932.671222,1758.900414
W14,4750,1321,70917739.69,587,8832,8245,6881.230886,1621.864766
W15,4750,1325,71132479.25,1554,8570,7016,6954.615094,1571.616474
W16,4750,1325,71132479.25,131,9860,9729,6900.209057,2108.967776
W17,4750,1323,71025109.47,-11,9705,9716,6515.368103,2322.299631
W18,4750,1319,70810369.91,301,8485,8184,7006.806672,1711.949995
W19,4750,1321,70917739.69,-93,8795,8888,6356.507949,2231.543865
W20,4750,1316,70649315.24,-867,9979,10846,6586.651216,1624.525447
W21,4750,1323,71025109.47,79,8953,8874,6294.684807,2295.689841
W22,4750,1318,70756685.02,-919,9979,10898,5128.406677,2584.849933
W23,4750,1323,71025109.47,-867,9979,10846,6273.219955,1408.575606
W24,4750,1323,71025109.47,222,9248,9026,5772.764172,2376.30673
W25,4750,1320,70864054.8,262,8843,8581,6396.461364,1767.125286
W26,4750,1320,70864054.8,-159,8526,8685,4167.440152,2528.133625
W27,4750,1326,71186164.14,368,8843,8475,6847.551282,1354.298046
W28,4750,1323,71025109.47,368,9012,8644,6581.313681,1992.113627
W29,4750,1324,71078794.36,1002,9012,8010,6660.670695,1743.600802
W30,4750,1325,71132479.25,2645,8182,5537,7147.089811,925.715623
W31,4750,1320,70864054.8,6440,8816,2376,7903.941667,336.5228351
W32,4750,1327,71239849.03,1557,9001,7444,7961.412208,870.6098407
W33,4750,1323,71025109.47,1395,9004,7609,7532.719577,1387.688363
W34,4750,1322,70971424.58,1364,9158,7794,6127.982602,2249.312664
W35,4750,1328,71293533.92,1427,8549,7122,6830.028614,1594.520044
W36,4750,1323,71025109.47,1249,9107,7858,6876.415722,1557.866087
W37,4750,1317,70703000.13,1249,9107,7858,6543.164768,1923.971297
W38,4750,1324,71078794.36,3459,8750,5291,7781.286254,417.4342148
W39,4750,1319,70810369.91,1893,8399,6506,7297.548901,994.6975762
W40,4750,1322,70971424.58,1335,8893,7558,6804.085477,1608.494734
W41,4750,1322,70971424.58,1991,9046,7055,6959.930408,1315.882481
W42,4750,1321,70917739.69,2089,8476,6387,7199.261923,1126.447832
W43,4750,1319,70810369.91,2474,8390,5916,7199.970432,1028.935109
W44,4750,1325,71132479.25,1400,8265,6865,6808.529811,1462.029779
W45,4750,1324,71078794.36,1400,8736,7336,6449.002266,1691.423574
W46,4750,1326,71186164.14,1351,8298,6947,6324.394419,1766.147153
W47,4750,1324,71078794.36,1276,8465,7189,6262.5,1858.808698
W48,4750,1326,71186164.14,1636,8841,7205,7484.262443,746.5981384
W49,4750,1321,70917739.69,1398,8985,7587,5804.25511,1888.005419
W50,4750,1323,71025109.47,1715,8985,7270,6863.747543,1512.100059
W51,4750,1325,71132479.25,1967,8541,6574,7120.919245,1078.125888
W52,4750,1322,70971424.58,1406,8356,6950,5700.702723,2124.602993
W53,4750,1324,71078794.36,2896,8865,5969,7109.509063,1016.921531
W54,4750,1319,70810369.91,1663,8495,6832,6145.653525,1713.838656
W55,4750,1316,70649315.24,1175,8726,7551,6390.048632,2023.231387
W56,4750,1325,71132479.25,1177,9919,8742,6280.776604,2173.476692
W57,4750,1323,71025109.47,1280,8990,7710,5250.337868,2126.042236
W58,4750,1319,70810369.91,1158,8990,7832,6585.976497,1970.918058
W59,4750,1319,70810369.91,377,9020,8643,4374.803639,2281.095558
W60,4750,1321,70917739.69,781,8486,7705,6759.426949,1574.918801
W61,4750,1322,70971424.58,890,8640,7750,6963.782148,1657.338555
W62,4750,1322,70971424.58,-1058,8536,9594,4788.293495,2725.651644
W63,4750,1327,71239849.03,-175,8300,8475,3403.629239,2312.826891
W64,4750,1324,71078794.36,381,8343,7962,5932.677492,1886.605566
W65,4750,1321,70917739.69,377,8000,7623,3856.702498,2407.87204
W66,4750,1323,71025109.47,-35,8359,8394,3564.832955,2326.691471
WB-E1,4750,1320,70864054.8,273,9051,8778,4465.544697,2557.686903
WB-E10,4750,1324,71078794.36,377,8791,8414,3613.643505,2136.6176
WB-E2,4750,1323,71025109.47,1192,8536,7344,6728.823129,1409.710427
WB-E3,4750,1323,71025109.47,2997,8694,5697,7428.29932,475.2330705
WB-E4,4750,1325,71132479.25,1542,8668,7126,7356.255849,1522.315391
WB-E5,4750,1320,70864054.8,273,9157,8884,4288.068939,2469.25421
WB-E6,4750,1323,71025109.47,2474,8390,5916,7270.579743,958.51076
WB-E7,4750,1320,70864054.8,204,8511,8307,5829.103788,2177.691939
WB-E8,4750,1319,70810369.91,1200,8990,7790,5867.357847,2179.10026
WB-E9,4750,1312,70434575.68,224,8956,8732,5074.948171,2306.040505
WB-H1,4750,1323,71025109.47,1276,8465,7189,6557.535903,1712.510712
WB-H10,4750,1325,71132479.25,1313,8865,7552,5454.069434,1940.31545
WB-H2,4750,1317,70703000.13,1542,8717,7175,6754.574791,1927.678409
WB-H3,4750,1323,71025109.47,1109,9158,8049,5811.489796,2306.366839
WB-H4,4750,1321,70917739.69,1468,8513,7045,6016.203634,2147.981852
WB-H5,4750,1320,70864054.8,882,9046,8164,5298.673485,2310.864639
WB-H6,4750,1323,71025109.47,-410,9958,10368,5804.557823,2719.857456
WB-H7,4750,1319,70810369.91,131,9987,9856,6100.156179,2452.608695
WB-H8,4750,1325,71132479.25,1890,8956,7066,6577.889057,1955.906653
WB-H9,4750,1321,70917739.69,587,9051,8464,5057.876609,2548.151213
WB-S1,4750,1324,71078794.36,-448,9849,10297,4757.742447,2851.701782
WB-S10,4750,1324,71078794.36,-1058,8764,9822,3920.466012,2553.422729
WB-S11,4750,1328,71293533.92,552,8000,7448,4900.557229,2447.310241
WB-S12,4750,1318,70756685.02,1194,8597,7403,4501.064492,2147.111871
WB-S13,4750,1321,70917739.69,882,9046,8164,5338.297502,2310.025149
WB-S14,4750,1313,70488260.57,1400,8736,7336,6851.819497,1444.842537
WB-S15,4750,1324,71078794.36,1375,8298,6923,6466.59139,1675.841264
WB-S16,4750,1317,70703000.13,222,8902,8680,5325.545178,2486.568621
WB-S17,4750,1322,70971424.58,2172,8521,6349,7192.357035,962.8273298
WB-S18,4750,1321,70917739.69,651,9203,8552,6452.488266,2335.952992
WB-S19,4750,1318,70756685.02,1383,8566,7183,6336.569803,1900.211041
WB-S2,4750,1318,70756685.02,-1404,9932,11336,4057.305766,3667.184898
WB-S20,4750,1322,70971424.58,1335,8750,7415,7358.363843,1420.564517
WB-S21,4750,1328,71293533.92,1893,8399,6506,6930.213855,1306.365039
WB-S22,4750,1321,70917739.69,2474,8694,6220,7331.174111,701.0290705
WB-S23,4750,1322,70971424.58,680,8657,7977,6628.460666,1858.61742
WB-S24,4750,1321,70917739.69,273,9051,8778,4642.58592,2466.632592
WB-S25,4750,1321,70917739.69,1612,8570,6958,7253.549584,1312.07598
WB-S26,4750,1320,70864054.8,1582,8931,7349,7822.662121,1134.507404
WB-S27,4750,1316,70649315.24,1427,8958,7531,7772.598024,757.3942503
WB-S28,4750,1325,71132479.25,2085,8629,6544,7689.655094,899.6453127
WB-S29,4750,1323,71025109.47,2195,9712,7517,7473.839758,934.1536426
WB-S3,4750,1325,71132479.25,-35,9322,9357,5584.569057,2170.479714
WB-S4,4750,1320,70864054.8,209,8830,8621,4569.014394,2689.819712
WB-S5,4750,1320,70864054.8,1636,8956,7320,6208.694697,2035.668276
WB-S6,4750,1318,70756685.02,1230,8513,7283,5439.084977,2283.949173
WB-S7,4750,1326,71186164.14,1664,8985,7321,7006.423831,1298.906604
WB-S8,4750,1319,70810369.91,301,8801,8500,6985.047005,1622.57788
WB-S9,4750,1319,70810369.91,-919,9979,10898,4866.356331,2575.480713
WB-W1,4750,1319,70810369.91,680,8539,7859,5914.419257,2082.775676
WB-W10,4750,1322,70971424.58,381,9000,8619,5510.946293,2152.562803
WB-W2,4750,1321,70917739.69,1544,8875,7331,7527.773656,1111.639499
WB-W3,4750,1322,70971424.58,2229,9712,7483,7334.80711,944.4066351
WB-W4,4750,1318,70756685.02,1262,8332,7070,6562.869499,1112.703976
WB-W5,4750,1310,70327205.9,1461,8627,7166,7479.69542,858.3422294
WB-W6,4750,1317,70703000.13,1782,8668,6886,7445.177677,1324.104062
WB-W7,4750,1325,71132479.25,-202,9919,10121,5845.62717,2712.059785
WB-W8,4750,1325,71132479.25,2956,8228,5272,7053.242264,867.7758093
WB-W9,4750,1320,70864054.8,1249,9677,8428,6709.276515,1734.099546
W01,5000,1463,78540994.07,313,9911,9598,7072.055366,1942.993655
W02,5000,1461,78433624.29,1195,9008,7813,7560.341547,1228.287638
W03,5000,1464,78594678.96,775,8573,7798,6819.871585,1917.995651
W04,5000,1464,78594678.96,2838,8629,5791,7748.425546,774.1231157
W05,5000,1461,78433624.29,1987,8875,6888,7292.56742,1344.066243
W06,5000,1463,78540994.07,1544,8828,7284,7511.44771,1106.601609
W07,5000,1462,78487309.18,775,9491,8716,6801.344733,1691.185504
W08,5000,1462,78487309.18,1374,8793,7419,6862.084815,1747.21904
W09,5000,1463,78540994.07,2195,9712,7517,7513.539986,1082.935464
W10,5000,1465,78648363.85,1550,8688,7138,6849.982253,1768.996041
W11,5000,1463,78540994.07,680,8539,7859,5927.641832,2033.87757
W12,5000,1461,78433624.29,680,8881,8201,5818.514716,1839.61122
W13,5000,1466,78702048.74,587,9419,8832,5983.070259,1810.123709
W14,5000,1459,78326254.51,587,9390,8803,6802.138451,1736.090361
W15,5000,1463,78540994.07,1554,8570,7016,6950.150376,1590.481968
W16,5000,1462,78487309.18,131,9874,9743,6863.348153,2132.430664
W17,5000,1461,78433624.29,-11,9715,9726,6485.677618,2359.915494
W18,5000,1462,78487309.18,219,8485,8266,6966.050616,1724.990619
W19,5000,1463,78540994.07,-93,8795,8888,6339.841422,2251.811243
W20,5000,1461,78433624.29,-919,9979,10898,6563.18412,1666.561982
W21,5000,1461,78433624.29,-11,8953,8964,6283.817933,2311.971193
W22,5000,1462,78487309.18,-919,9979,10898,5051.285226,2577.838332
W23,5000,1462,78487309.18,-919,9979,10898,6280.290698,1482.82892
W24,5000,1462,78487309.18,222,9266,9044,5768.585499,2361.838052
W25,5000,1464,78594678.96,262,8843,8581,6387.881148,1759.626314
W26,5000,1463,78540994.07,-159,8711,8870,4242.961039,2537.177565
W27,5000,1463,78540994.07,368,8843,8475,6791.183869,1430.517607
W28,5000,1462,78487309.18,262,9012,8750,6492.321477,2072.506264
W29,5000,1463,78540994.07,852,9012,8160,6613.400547,1788.610162
W30,5000,1463,78540994.07,2645,8182,5537,7161.045113,909.5947574
W31,5000,1462,78487309.18,6440,8816,2376,7910.512312,334.5983374
W32,5000,1467,78755733.63,1406,9001,7595,7924.416496,913.0687855
W33,5000,1463,78540994.07,1395,9004,7609,7479.889952,1436.42474
W34,5000,1470,78916788.3,1364,9158,7794,6211.060544,2213.553427
W35,5000,1463,78540994.07,1427,8549,7122,6881.423103,1559.612731
W36,5000,1466,78702048.74,1249,9107,7858,6851.916098,1584.233918
W37,5000,1467,78755733.63,1249,9107,7858,6564.895706,1936.491637
W38,5000,1468,78809418.52,3459,8750,5291,7775.270436,438.7657087
W39,5000,1464,78594678.96,1893,8399,6506,7313.06694,970.6519475
W40,5000,1463,78540994.07,1335,8926,7591,6731.69583,1685.315421
W41,5000,1463,78540994.07,1991,9046,7055,6887.232399,1401.668788
W42,5000,1462,78487309.18,2089,9033,6944,7228.428181,1105.421075
W43,5000,1466,78702048.74,2474,8390,5916,7239.300819,990.4309149
W44,5000,1466,78702048.74,1400,8265,6865,6778.230559,1491.817371
W45,5000,1462,78487309.18,1400,8736,7336,6444.266074,1693.025202
W46,5000,1464,78594678.96,1351,8298,6947,6265.510246,1805.721355
W47,5000,1466,78702048.74,1276,8465,7189,6298.441337,1827.574556
W48,5000,1463,78540994.07,1545,8841,7296,7450.25974,869.0333963
W49,5000,1464,78594678.96,1398,8985,7587,5833.562842,1893.304344
W50,5000,1465,78648363.85,1715,8985,7270,6848.828669,1516.967839
W51,5000,1465,78648363.85,1619,9137,7518,7056.988396,1204.634923
W52,5000,1467,78755733.63,1406,8356,6950,5728.048398,2100.586804
W53,5000,1468,78809418.52,1808,8865,7057,7065.680518,1081.506874
W54,5000,1471,78970473.19,1610,8495,6885,6058.048266,1807.096251
W55,5000,1468,78809418.52,1175,8726,7551,6382.722752,2031.925621
W56,5000,1464,78594678.96,1136,9919,8783,6203.959699,2198.451191
W57,5000,1462,78487309.18,1280,8990,7710,5346.431601,2122.767108
W58,5000,1464,78594678.96,1158,8990,7832,6519.212432,2014.922722
W59,5000,1466,78702048.74,377,9020,8643,4386.169168,2320.064989
W60,5000,1463,78540994.07,781,8486,7705,6685.871497,1644.914968
W61,5000,1461,78433624.29,890,8640,7750,6878.232033,1760.049986
W62,5000,1462,78487309.18,-1058,8536,9594,4807.409713,2725.457031
W63,5000,1465,78648363.85,-175,8300,8475,3545.901024,2363.701114
W64,5000,1467,78755733.63,381,8532,8151,5808.268575,2009.741654
W65,5000,1462,78487309.18,377,8000,7623,3910.982216,2417.803704
W66,5000,1463,78540994.07,-35,8359,8394,3533.403281,2303.933114
WB-E1,5000,1461,78433624.29,273,9051,8778,4407.856263,2552.606022
WB-E10,5000,1464,78594678.96,377,8791,8414,3674.795082,2147.427789
WB-E2,5000,1462,78487309.18,860,8536,7676,6624.55814,1540.307632
WB-E3,5000,1467,78755733.63,2997,8694,5697,7422.751193,484.6174805
WB-E4,5000,1460,78379939.4,1542,8668,7126,7355.543151,1511.928504
WB-E5,5000,1462,78487309.18,273,9359,9086,4404.272914,2467.95334
WB-E6,5000,1465,78648363.85,2474,8390,5916,7270.539932,950.3480871
WB-E7,5000,1463,78540994.07,120,8511,8391,5790.522898,2204.948872
WB-E8,5000,1467,78755733.63,882,8990,8108,5798.61895,2212.454344
WB-E9,5000,1468,78809418.52,224,8956,8732,5141.576975,2308.303358
WB-H1,5000,1471,78970473.19,1276,8465,7189,6604.165194,1671.31105
WB-H10,5000,1465,78648363.85,1313,8865,7552,5504.741297,1945.467338
WB-H2,5000,1463,78540994.07,1542,8717,7175,6766.37799,1930.51343
WB-H3,5000,1467,78755733.63,961,9158,8197,5816.155419,2291.914442
WB-H4,5000,1465,78648363.85,1457,8513,7056,5996.346758,2163.836934
WB-H5,5000,1466,78702048.74,882,9046,8164,5416.464529,2289.768046
WB-H6,5000,1462,78487309.18,-410,9958,10368,5885.573187,2711.925908
WB-H7,5000,1464,78594678.96,131,9987,9856,6198.22541,2426.207956
WB-H8,5000,1466,78702048.74,1059,8956,7897,6609.691678,1954.100211
WB-H9,5000,1461,78433624.29,587,9051,8464,5174.650924,2542.394595
WB-S1,5000,1467,78755733.63,-448,9849,10297,4946.327198,2849.114535
WB-S10,5000,1464,78594678.96,-1058,8764,9822,3963.959016,2577.054175
WB-S11,5000,1463,78540994.07,552,8000,7448,4927.679426,2445.189365
WB-S12,5000,1462,78487309.18,765,8961,8196,4481.668947,2193.346115
WB-S13,5000,1463,78540994.07,882,9046,8164,5431.21326,2322.528405
WB-S14,5000,1468,78809418.52,1400,8736,7336,6889.296322,1424.294685
WB-S15,5000,1469,78863103.41,1276,8298,7022,6394.829816,1728.701389
WB-S16,5000,1461,78433624.29,222,9266,9044,5382.781656,2487.390375
WB-S17,5000,1463,78540994.07,1045,8617,7572,7180.613807,1016.493011
WB-S18,5000,1463,78540994.07,651,9203,8552,6460.487355,2303.232631
WB-S19,5000,1466,78702048.74,1383,8566,7183,6385.308322,1875.802013
WB-S2,5000,1461,78433624.29,-1404,9932,11336,3939.980151,3632.61614
WB-S20,5000,1466,78702048.74,1335,8750,7415,7331.933151,1456.446061
WB-S21,5000,1465,78648363.85,1893,8399,6506,6960.553584,1295.987148
WB-S22,5000,1468,78809418.52,2474,8694,6220,7335.536785,690.3434427
WB-S23,5000,1462,78487309.18,680,9081,8401,6605.549248,1867.001487
WB-S24,5000,1461,78433624.29,273,9051,8778,4701.613963,2459.837837
WB-S25,5000,1463,78540994.07,1554,8570,7016,7187.440191,1403.987861
WB-S26,5000,1465,78648363.85,1557,8931,7374,7768.00273,1205.60247
WB-S27,5000,1470,78916788.3,1427,8958,7531,7731.642177,866.7088048
WB-S28,5000,1464,78594678.96,1912,8629,6717,7670.114071,950.5890329
WB-S29,5000,1462,78487309.18,2195,9712,7517,7455.127223,948.0138141
WB-S3,5000,1466,78702048.74,-35,9322,9357,5549.332196,2200.923264
WB-S4,5000,1470,78916788.3,209,8830,8621,4552.307483,2637.940952
WB-S5,5000,1464,78594678.96,1593,8956,7363,6191.072404,2062.793073
WB-S6,5000,1469,78863103.41,1230,8513,7283,5535.815521,2261.691446
WB-S7,5000,1466,78702048.74,1664,8985,7321,6975.699181,1370.774358
WB-S8,5000,1461,78433624.29,36,8801,8765,6929.750171,1696.517338
WB-S9,5000,1462,78487309.18,-919,9979,10898,4861.848153,2575.189691
WB-W1,5000,1468,78809418.52,680,8539,7859,5945.333787,2059.999777
WB-W10,5000,1462,78487309.18,-320,9000,9320,5478.73803,2166.483956
WB-W2,5000,1461,78433624.29,1544,8875,7331,7495.950034,1145.234193
WB-W3,5000,1462,78487309.18,1236,9712,8476,7280.545828,1016.318779
WB-W4,5000,1465,78648363.85,580,8332,7752,6496.199317,1278.368573
WB-W5,5000,1468,78809418.52,1461,8627,7166,7431.649864,1007.251844
WB-W6,5000,1468,78809418.52,1782,8668,6886,7407.75,1356.12508
WB-W7,5000,1465,78648363.85,-202,9919,10121,5752.794539,2759.716365
WB-W8,5000,1464,78594678.96,2956,8422,5466,7068.105191,883.4511994
WB-W9,5000,1463,78540994.07,1249,9677,8428,6648.711552,1792.988494
W01,5250,1614,86647412.46,313,9911,9598,7075.899009,1920.848621
W02,5250,1608,86325303.12,1195,9008,7813,7537.968905,1242.280124
W03,5250,1617,86808467.13,775,8597,7822,6833.656153,1894.024272
W04,5250,1613,86593727.57,2838,8629,5791,7725.3261,825.1238613
W05,5250,1611,86486357.79,802,9891,9089,7270.38175,1381.667486
W06,5250,1615,86701097.35,1544,8828,7284,7465.985759,1162.172035
W07,5250,1612,86540042.68,775,9491,8716,6784.891439,1687.953658
W08,5250,1615,86701097.35,1374,8859,7485,6918.299071,1699.697754
W09,5250,1614,86647412.46,1374,9712,8338,7433.929988,1198.907342
W10,5250,1613,86593727.57,1502,8688,7186,6859.408555,1756.487655
W11,5250,1615,86701097.35,680,8539,7859,5935.814241,2027.460824
W12,5250,1614,86647412.46,680,8881,8201,5830.247831,1856.834505
W13,5250,1613,86593727.57,587,9419,8832,6026.929324,1850.152199
W14,5250,1615,86701097.35,587,9390,8803,6726.949845,1835.16713
W15,5250,1614,86647412.46,1554,8570,7016,6951.418835,1603.045802
W16,5250,1613,86593727.57,131,9874,9743,6813.030998,2182.519651
W17,5250,1612,86540042.68,-11,9834,9845,6467.330025,2375.099463
W18,5250,1616,86754782.24,96,8488,8392,6913.139851,1765.660442
W19,5250,1612,86540042.68,-93,8795,8888,6314.343672,2272.638591
W20,5250,1616,86754782.24,-919,9979,10898,6522.451733,1724.321435
W21,5250,1615,86701097.35,-11,8953,8964,6311.627245,2283.758708
W22,5250,1616,86754782.24,-919,9979,10898,4968.363243,2585.578097
W23,5250,1612,86540042.68,-919,9979,10898,6277.325682,1556.321232
W24,5250,1613,86593727.57,222,9482,9260,5763.718537,2359.909052
W25,5250,1613,86593727.57,262,8843,8581,6373.225666,1760.233506
W26,5250,1616,86754782.24,-159,8711,8870,4311.769802,2542.84414
W27,5250,1616,86754782.24,262,8843,8581,6730.235149,1505.868851
W28,5250,1618,86862152.02,262,9012,8750,6422.645859,2127.51332
W29,5250,1615,86701097.35,852,9012,8160,6569.297214,1832.184959
W30,5250,1615,86701097.35,2645,8521,5876,7178.508978,891.636218
W31,5250,1616,86754782.24,6440,8958,2518,7918.117574,334.461485
W32,5250,1616,86754782.24,1406,9001,7595,7884.290223,978.6180291
W33,5250,1613,86593727.57,1395,9004,7609,7424.131432,1480.426554
W34,5250,1610,86432672.9,1364,9158,7794,6285.182609,2182.768876
W35,5250,1615,86701097.35,1427,8549,7122,6928.767802,1522.077943
W36,5250,1616,86754782.24,1249,9107,7858,6826.118193,1615.533221
W37,5250,1616,86754782.24,1249,9107,7858,6584.514851,1943.69354
W38,5250,1611,86486357.79,3459,8750,5291,7776.844817,436.2488265
W39,5250,1617,86808467.13,1893,8399,6506,7315.858998,963.394311
W40,5250,1611,86486357.79,1034,8926,7892,6648.631285,1783.546491
W41,5250,1616,86754782.24,1991,9046,7055,6831.428837,1472.261798
W42,5250,1615,86701097.35,2089,9033,6944,7257.530031,1094.681305
W43,5250,1614,86647412.46,2474,8390,5916,7273.817224,953.716603
W44,5250,1616,86754782.24,1400,8736,7336,6763.405322,1501.97441
W45,5250,1616,86754782.24,1400,8736,7336,6439.256807,1690.975927
W46,5250,1614,86647412.46,1276,8298,7022,6221.944238,1832.279078
W47,5250,1615,86701097.35,1276,8465,7189,6336.593808,1792.043624
W48,5250,1618,86862152.02,1398,8848,7450,7388.060569,1018.182088
W49,5250,1618,86862152.02,1398,8985,7587,5893.145241,1890.732168
W50,5250,1617,86808467.13,1715,8985,7270,6853.768089,1500.477708
W51,5250,1616,86754782.24,1554,9463,7909,6997.628094,1325.745217
W52,5250,1617,86808467.13,1406,8356,6950,5753.747062,2077.571695
W53,5250,1614,86647412.46,1794,8865,7071,7000.570012,1183.277192
W54,5250,1611,86486357.79,1472,8495,7023,5980.504035,1887.367633
W55,5250,1618,86862152.02,1175,8726,7551,6389.380099,2028.608593
W56,5250,1613,86593727.57,1136,9919,8783,6166.9938,2178.365067
W57,5250,1612,86540042.68,1280,8990,7710,5447.264888,2123.490699
W58,5250,1620,86969521.8,863,8990,8127,6456.361111,2041.780578
W59,5250,1614,86647412.46,377,9020,8643,4411.405204,2351.887178
W60,5250,1615,86701097.35,781,8720,7939,6634.90774,1698.943007
W61,5250,1611,86486357.79,890,8640,7750,6772.209187,1875.471577
W62,5250,1617,86808467.13,-1058,8640,9698,4873.132344,2711.862313
W63,5250,1614,86647412.46,-175,8709,8884,3706.395291,2428.986822
W64,5250,1611,86486357.79,381,9000,8619,5699.697083,2090.736569
W65,5250,1615,86701097.35,377,8030,7653,3966.042724,2419.714942
W66,5250,1613,86593727.57,-35,8359,8394,3527.860508,2273.53258
WB-E1,5250,1615,86701097.35,273,9051,8778,4394.680495,2545.101372
WB-E10,5250,1615,86701097.35,377,8791,8414,3766.794427,2171.629626
WB-E2,5250,1613,86593727.57,860,8536,7676,6514.479851,1665.938735
WB-E3,5250,1614,86647412.46,2869,8694,5825,7420.302974,488.66117
WB-E4,5250,1613,86593727.57,1542,8668,7126,7361.222567,1491.496791
WB-E5,5250,1614,86647412.46,273,9523,9250,4542.284387,2479.937703
WB-E6,5250,1620,86969521.8,2474,8390,5916,7284.220988,925.902559
WB-E7,5250,1616,86754782.24,120,8511,8391,5742.936262,2240.04827
WB-E8,5250,1613,86593727.57,882,8990,8108,5749.33726,2238.234656
WB-E9,5250,1624,87184261.36,224,8956,8732,5209.939039,2303.770911
WB-H1,5250,1611,86486357.79,1276,8465,7189,6650.139044,1633.72382
WB-H10,5250,1616,86754782.24,1313,8865,7552,5531.212871,1954.317471
WB-H2,5250,1615,86701097.35,1542,8717,7175,6769.916409,1937.613139
WB-H3,5250,1615,86701097.35,890,9158,8268,5804.844582,2308.890481
WB-H4,5250,1617,86808467.13,1283,8513,7230,5972.001855,2172.7061
WB-H5,5250,1618,86862152.02,882,9046,8164,5519.02534,2261.505252
WB-H6,5250,1617,86808467.13,-410,9958,10368,5934.301793,2710.821104
WB-H7,5250,1611,86486357.79,131,9987,9856,6277.763501,2399.819865
WB-H8,5250,1617,86808467.13,1059,8956,7897,6631.097093,1950.964696
WB-H9,5250,1616,86754782.24,587,9051,8464,5261.475248,2530.317213
WB-S1,5250,1611,86486357.79,-448,9849,10297,5122.721912,2844.785907
WB-S10,5250,1613,86593727.57,-1058,8764,9822,3972.621203,2578.05233
WB-S11,5250,1616,86754782.24,552,8000,7448,4975.087252,2439.77105
WB-S12,5250,1614,86647412.46,534,9840,9306,4454.962206,2245.578126
WB-S13,5250,1618,86862152.02,882,9046,8164,5513.141533,2331.40133
WB-S14,5250,1624,87184261.36,1400,8736,7336,6909.839901,1411.161364
WB-S15,5250,1613,86593727.57,1276,8298,7022,6349.391197,1758.905933
WB-S16,5250,1614,86647412.46,222,9482,9260,5419.718711,2488.820023
WB-S17,5250,1612,86540042.68,1045,8617,7572,7154.539702,1083.589711
WB-S18,5250,1616,86754782.24,651,9203,8552,6459.193688,2276.945961
WB-S19,5250,1614,86647412.46,1383,8566,7183,6413.814746,1856.16442
WB-S2,5250,1615,86701097.35,-1404,9932,11336,3868.858824,3586.144178
WB-S20,5250,1617,86808467.13,1335,8927,7592,7325.147186,1470.78907
WB-S21,5250,1616,86754782.24,1893,8399,6506,6991.862005,1279.50302
WB-S22,5250,1617,86808467.13,2474,8694,6220,7339.928881,679.8468883
WB-S23,5250,1610,86432672.9,680,9081,8401,6585.217391,1864.327766
WB-S24,5250,1617,86808467.13,273,9051,8778,4757.363636,2439.711589
WB-S25,5250,1618,86862152.02,1554,8627,7073,7145.309023,1458.10113
WB-S26,5250,1614,86647412.46,1406,8931,7525,7736.454151,1248.206911
WB-S27,5250,1612,86540042.68,1427,8958,7531,7709.692308,910.4404918
WB-S28,5250,1612,86540042.68,1912,8629,6717,7642.765509,1003.508784
WB-S29,5250,1613,86593727.57,2195,9712,7517,7415.026038,1003.734375
WB-S3,5250,1615,86701097.35,-35,9322,9357,5519.303406,2230.074494
WB-S4,5250,1616,86754782.24,209,8830,8621,4514.402847,2596.441988
WB-S5,5250,1614,86647412.46,1453,8956,7503,6151.052045,2104.791851
WB-S6,5250,1616,86754782.24,1230,8831,7601,5616.324876,2238.504094
WB-S7,5250,1616,86754782.24,1664,8985,7321,6937.313119,1450.025921
WB-S8,5250,1616,86754782.24,36,8803,8767,6901.798267,1747.331694
WB-S9,5250,1613,86593727.57,-919,9979,10898,4847.181649,2573.571659
WB-W1,5250,1610,86432672.9,680,8539,7859,5976.406832,2036.920779
WB-W10,5250,1618,86862152.02,-320,9000,9320,5454.990729,2181.212461
WB-W2,5250,1612,86540042.68,1544,8875,7331,7473.740695,1162.965968
WB-W3,5250,1616,86754782.24,1152,9712,8560,7197.714728,1128.33598
WB-W4,5250,1613,86593727.57,368,8402,8034,6430.961562,1417.907707
WB-W5,5250,1624,87184261.36,1461,8627,7166,7382.929803,1140.641103
WB-W6,5250,1614,86647412.46,1542,8668,7126,7377.561338,1377.190591
WB-W7,5250,1612,86540042.68,-202,9919,10121,5693.649504,2805.691529
WB-W8,5250,1615,86701097.35,2956,8422,5466,7081.393189,904.2302569
WB-W9,5250,1616,86754782.24,1249,9677,8428,6611.072401,1825.294056
W01,5500,1769,94968570.41,313,9911,9598,7050.004522,1922.935923
W02,5500,1770,95022255.3,1195,9008,7813,7503.498305,1273.900554
W03,5500,1769,94968570.41,775,8597,7822,6856.074053,1870.520383
W04,5500,1778,95451734.42,2444,8629,6185,7701.787964,866.1295521
W05,5500,1767,94861200.63,802,9958,9156,7253.752122,1419.364184
W06,5500,1768,94914885.52,1544,8828,7284,7417.141403,1229.429946
W07,5500,1772,95129625.08,775,9491,8716,6775.957111,1676.386004
W08,5500,1768,94914885.52,1374,8859,7485,6955.902715,1661.260641
W09,5500,1769,94968570.41,1374,9712,8338,7359.69983,1289.924452
W10,5500,1770,95022255.3,1502,8688,7186,6843.119774,1768.584301
W11,5500,1767,94861200.63,680,8539,7859,5966.290323,2009.886331
W12,5500,1772,95129625.08,273,9153,8880,5851.973476,1890.270087
W13,5500,1775,95290679.75,587,9491,8904,6033.050704,1915.252627
W14,5500,1771,95075940.19,587,9712,9125,6649.850367,1927.873889
W15,5500,1769,94968570.41,1554,8570,7016,6954.343132,1604.719371
W16,5500,1768,94914885.52,7,9874,9867,6772.848982,2210.811132
W17,5500,1769,94968570.41,-11,9834,9845,6494.140192,2351.647864
W18,5500,1768,94914885.52,79,8488,8409,6872.807127,1801.810481
W19,5500,1776,95344364.64,-93,8795,8888,6310.807432,2258.553668
W20,5500,1774,95236994.86,-919,9979,10898,6475.322435,1789.379185
W21,5500,1772,95129625.08,-11,8953,8964,6334.06772,2253.169499
W22,5500,1777,95398049.53,-919,9979,10898,4913.418683,2584.121021
W23,5500,1771,95075940.19,-919,9979,10898,6242.600226,1630.363864
W24,5500,1769,94968570.41,222,9553,9331,5738.366309,2372.237208
W25,5500,1776,95344364.64,262,8843,8581,6334.216779,1790.730676
W26,5500,1769,94968570.41,-159,8711,8870,4386.189373,2531.977962
W27,5500,1766,94807515.74,204,8843,8639,6668.182333,1584.614246
W28,5500,1773,95183309.97,262,9012,8750,6378.551043,2149.738488
W29,5500,1772,95129625.08,852,9012,8160,6543.173251,1849.420353
W30,5500,1770,95022255.3,1900,8521,6621,7180.141243,930.7300587
W31,5500,1776,95344364.64,6440,8958,2518,7923.198761,334.1496627
W32,5500,1770,95022255.3,1406,9001,7595,7859.19887,996.6103461
W33,5500,1769,94968570.41,1395,9004,7609,7370.34935,1540.436832
W34,5500,1769,94968570.41,1364,9203,7839,6332.025438,2156.982937
W35,5500,1768,94914885.52,1427,8549,7122,6959.148756,1502.373001
W36,5500,1770,95022255.3,1249,9107,7858,6778.4,1671.945104
W37,5500,1773,95183309.97,1249,9107,7858,6601.847716,1946.847933
W38,5500,1772,95129625.08,3459,8750,5291,7777.53781,435.11941
W39,5500,1777,95398049.53,1893,8399,6506,7318.979178,957.8868538
W40,5500,1772,95129625.08,1034,9033,7999,6578.924944,1858.931193
W41,5500,1772,95129625.08,1196,9046,7850,6778.441309,1532.71245
W42,5500,1775,95290679.75,2089,9046,6957,7274.359437,1096.794369
W43,5500,1777,95398049.53,2474,8411,5937,7303.402926,918.3613571
W44,5500,1775,95290679.75,1400,8736,7336,6761.947042,1503.693209
W45,5500,1772,95129625.08,1400,8736,7336,6466.946388,1677.667416
W46,5500,1769,94968570.41,1276,8298,7022,6176.718485,1848.615041
W47,5500,1773,95183309.97,1276,8465,7189,6349.909757,1780.093113
W48,5500,1774,95236994.86,1398,8848,7450,7346.30947,1098.166501
W49,5500,1776,95344364.64,1398,8985,7587,5947.109234,1892.807415
W50,5500,1774,95236994.86,1715,8994,7279,6861.187711,1509.87371
W51,5500,1772,95129625.08,1471,9463,7992,6941.701467,1433.247543
W52,5500,1771,95075940.19,1406,8356,6950,5786.393563,2049.606761
W53,5500,1774,95236994.86,1794,8865,7071,6911.057497,1305.692587
W54,5500,1771,95075940.19,1154,8495,7341,5920.397516,1958.435225
W55,5500,1778,95451734.42,1175,8832,7657,6391.580427,2038.408624
W56,5500,1770,95022255.3,1136,9919,8783,6152.672316,2149.014462
W57,5500,1771,95075940.19,1280,8990,7710,5528.511011,2125.948037
W58,5500,1778,95451734.42,863,8990,8127,6379.24297,2070.322142
W59,5500,1777,95398049.53,377,9877,9500,4481.179516,2390.428305
W60,5500,1774,95236994.86,781,8859,8078,6583.854566,1759.014148
W61,5500,1771,95075940.19,651,8640,7989,6691.193111,1936.135415
W62,5500,1770,95022255.3,-1058,8640,9698,4925.536723,2689.842537
W63,5500,1767,94861200.63,-1058,9508,10566,3854.054895,2488.175726
W64,5500,1772,95129625.08,381,9000,8619,5633.430587,2137.59977
W65,5500,1776,95344364.64,377,8030,7653,4029.244369,2422.165219
W66,5500,1768,94914885.52,-35,8359,8394,3564.889706,2259.205648
WB-E1,5500,1774,95236994.86,273,9051,8778,4403.591883,2533.390484
WB-E10,5500,1771,95075940.19,377,8791,8414,3874.019763,2204.740734
WB-E2,5500,1772,95129625.08,750,8536,7786,6394.553047,1793.244424
WB-E3,5500,1773,95183309.97,2869,8949,6080,7418.415116,477.3890344
WB-E4,5500,1772,95129625.08,1542,8668,7126,7373.067156,1466.536775
WB-E5,5500,1776,95344364.64,273,9606,9333,4632.070383,2487.826344
WB-E6,5500,1774,95236994.86,2474,8390,5916,7294.53664,905.2730499
WB-E7,5500,1769,94968570.41,120,8511,8391,5720.829847,2253.002973
WB-E8,5500,1773,95183309.97,882,8990,8108,5700.606317,2260.756961
WB-E9,5500,1783,95720158.87,224,8956,8732,5291.556927,2300.212889
WB-H1,5500,1772,95129625.08,1276,8465,7189,6681.639955,1608.009713
WB-H10,5500,1770,95022255.3,1313,8865,7552,5577.253672,1965.247691
WB-H2,5500,1776,95344364.64,1496,8717,7221,6759.333896,1955.219082
WB-H3,5500,1770,95022255.3,651,9158,8507,5828.138418,2330.406499
WB-H4,5500,1772,95129625.08,1283,8513,7230,5971.480248,2159.357685
WB-H5,5500,1771,95075940.19,882,9046,8164,5592.348955,2228.434539
WB-H6,5500,1772,95129625.08,-410,9958,10368,5996.5886,2701.427341
WB-H7,5500,1769,94968570.41,102,9987,9885,6327.936687,2387.397909
WB-H8,5500,1770,95022255.3,1059,8956,7897,6613.324859,1958.651766
WB-H9,5500,1769,94968570.41,587,9051,8464,5309.091577,2522.672133
WB-S1,5500,1769,94968570.41,-448,9899,10347,5295.32052,2829.331904
WB-S10,5500,1768,94914885.52,-1058,8764,9822,3970.929299,2587.546801
WB-S11,5500,1767,94861200.63,377,8000,7623,5006.694963,2433.987923
WB-S12,5500,1774,95236994.86,377,9876,9499,4447.689966,2300.260238
WB-S13,5500,1776,95344364.64,882,9046,8164,5580.271396,2332.543045
WB-S14,5500,1784,95773843.76,1400,8736,7336,6919.956278,1408.67771
WB-S15,5500,1772,95129625.08,1276,8298,7022,6316.737585,1791.33043
WB-S16,5500,1773,95183309.97,222,9553,9331,5462.394247,2486.317728
WB-S17,5500,1772,95129625.08,890,8617,7727,7133.904628,1143.923946
WB-S18,5500,1771,95075940.19,651,9203,8552,6420.710333,2268.698919
WB-S19,5500,1773,95183309.97,1383,8566,7183,6427.836435,1844.633028
WB-S2,5500,1774,95236994.86,-1404,9932,11336,3810.447576,3558.524546
WB-S20,5500,1770,95022255.3,1335,9107,7772,7332.49435,1458.647002
WB-S21,5500,1769,94968570.41,1893,8411,6518,7027.386094,1253.694509
WB-S22,5500,1775,95290679.75,2474,8694,6220,7336.181408,691.0298033
WB-S23,5500,1771,95075940.19,680,9081,8401,6544.800678,1870.653525
WB-S24,5500,1770,95022255.3,273,9051,8778,4824.057627,2413.386277
WB-S25,5500,1769,94968570.41,1554,8962,7408,7124.611645,1478.041036
WB-S26,5500,1773,95183309.97,1406,9001,7595,7700.469825,1294.091751
WB-S27,5500,1772,95129625.08,1427,8958,7531,7699.111174,927.1114597
WB-S28,5500,1770,95022255.3,1912,8768,6856,7627.712994,1040.036807
WB-S29,5500,1769,94968570.41,1374,9712,8338,7382.768796,1064.598567
WB-S3,5500,1770,95022255.3,-320,9322,9642,5488.850282,2268.9258
WB-S4,5500,1770,95022255.3,209,8830,8621,4471.244068,2562.652143
WB-S5,5500,1778,95451734.42,1248,8956,7708,6124.127109,2149.880031
WB-S6,5500,1775,95290679.75,1230,8831,7601,5689.261972,2216.181471
WB-S7,5500,1771,95075940.19,1307,8985,7678,6869.803501,1556.897409
WB-S8,5500,1768,94914885.52,36,8803,8767,6875.005656,1802.944984
WB-S9,5500,1775,95290679.75,-919,9979,10898,4822.452394,2587.510569
WB-W1,5500,1769,94968570.41,680,8539,7859,6019.572075,2014.888512
WB-W10,5500,1775,95290679.75,-320,9706,10026,5411.99831,2199.719488
WB-W2,5500,1768,94914885.52,1544,8875,7331,7451.959276,1176.48988
WB-W3,5500,1772,95129625.08,826,9712,8886,7132.322235,1203.190248
WB-W4,5500,1775,95290679.75,262,8718,8456,6372.561127,1531.998106
WB-W5,5500,1783,95720158.87,1461,8627,7166,7336.8424,1234.14156
WB-W6,5500,1770,95022255.3,1542,8668,7126,7343.69322,1414.69015
WB-W7,5500,1768,94914885.52,-202,9919,10121,5640.378394,2854.744644
WB-W8,5500,1767,94861200.63,2767,8502,5735,7110.268817,921.0537583
WB-W9,5500,1773,95183309.97,1249,9677,8428,6585.972927,1836.628658
W01,5750,1930,103611837.7,313,9911,9598,7029.115544,1937.031393
W02,5750,1936,103933947,1195,9008,7813,7463.928202,1311.786211
W03,5750,1936,103933947,775,8605,7830,6902.669938,1830.334705
W04,5750,1937,103987631.9,1912,8861,6949,7678.611255,914.447075
W05,5750,1935,103880262.1,802,9958,9156,7238.903876,1455.024116
W06,5750,1932,103719207.5,1544,9377,7833,7364.320393,1283.89888
W07,5750,1933,103772892.4,775,9491,8716,6761.371443,1678.681325
W08,5750,1932,103719207.5,1374,8944,7570,6983.703934,1637.397497
W09,5750,1930,103611837.7,1374,9712,8338,7296.490155,1345.503675
W10,5750,1939,104095001.7,1502,8688,7186,6828.112945,1775.861232
W11,5750,1931,103665522.6,680,8539,7859,5999.824443,1992.086998
W12,5750,1934,103826577.3,273,9266,8993,5867.513961,1951.446092
W13,5750,1936,103933947,587,9712,9125,6054.963326,1954.359046
W14,5750,1937,103987631.9,587,9712,9125,6581.982963,1984.085656
W15,5750,1930,103611837.7,1554,8710,7156,6936.527979,1626.323011
W16,5750,1931,103665522.6,7,9874,9867,6706.535992,2258.982239
W17,5750,1934,103826577.3,-11,9834,9845,6513.562565,2330.863665
W18,5750,1938,104041316.8,-8,8728,8736,6839.372549,1820.66124
W19,5750,1940,104148686.6,-93,8795,8888,6315.834536,2236.17039
W20,5750,1939,104095001.7,-919,9979,10898,6434.061372,1862.785687
W21,5750,1934,103826577.3,-11,8953,8964,6365.077042,2221.825332
W22,5750,1939,104095001.7,-919,9979,10898,4884.24033,2585.364603
W23,5750,1934,103826577.3,-919,9979,10898,6216.022234,1681.177834
W24,5750,1932,103719207.5,222,9560,9338,5718.795549,2383.901482
W25,5750,1938,104041316.8,262,8843,8581,6294.990196,1832.221085
W26,5750,1938,104041316.8,-426,8711,9137,4461.835913,2532.977306
W27,5750,1931,103665522.6,204,8843,8639,6555.617297,1712.012225
W28,5750,1936,103933947,262,9012,8750,6356.804236,2144.944341
W29,5750,1936,103933947,852,9012,8160,6522.25,1862.580961
W30,5750,1935,103880262.1,1045,8626,7581,7177.435142,977.7812598
W31,5750,1943,104309741.3,6440,8958,2518,7929.010808,334.70596
W32,5750,1932,103719207.5,1406,9001,7595,7817.713768,1066.74807
W33,5750,1935,103880262.1,1395,9004,7609,7327.001034,1584.388382
W34,5750,1932,103719207.5,1109,9203,8094,6362.019669,2133.685648
W35,5750,1932,103719207.5,1427,8562,7135,6997.649586,1480.546388
W36,5750,1930,103611837.7,1249,9107,7858,6729.422798,1743.279593
W37,5750,1940,104148686.6,1227,9107,7880,6625.89433,1945.399907
W38,5750,1933,103772892.4,3223,8750,5527,7770.652871,473.4250641
W39,5750,1942,104256056.4,1893,8519,6626,7318.53656,959.6954989
W40,5750,1940,104148686.6,1034,9046,8012,6500.665979,1948.518504
W41,5750,1939,104095001.7,1196,9046,7850,6717.495616,1592.856899
W42,5750,1940,104148686.6,2089,9046,6957,7291.39433,1083.320609
W43,5750,1941,104202371.5,2474,8411,5937,7330.435343,887.3236732
W44,5750,1938,104041316.8,1400,8736,7336,6757.526832,1501.324718
W45,5750,1938,104041316.8,1400,8736,7336,6496.805986,1667.715411
W46,5750,1937,103987631.9,1276,8298,7022,6171.079504,1847.61055
W47,5750,1938,104041316.8,1276,8465,7189,6335.574303,1804.860803
W48,5750,1936,103933947,1398,8848,7450,7304.860537,1152.248081
W49,5750,1944,104363426.2,1398,8985,7587,6016.006173,1890.22524
W50,5750,1939,104095001.7,1664,9018,7354,6873.762249,1503.059286
W51,5750,1939,104095001.7,1318,9463,8145,6884.754513,1537.17937
W52,5750,1940,104148686.6,1406,8356,6950,5832.620103,2009.546391
W53,5750,1938,104041316.8,1586,8865,7279,6804.267286,1429.378119
W54,5750,1937,103987631.9,1154,8495,7341,5853.217863,2019.599801
W55,5750,1941,104202371.5,1175,8832,7657,6378.531685,2062.577814
W56,5750,1936,103933947,1136,9919,8783,6137.180269,2126.540151
W57,5750,1938,104041316.8,1280,8990,7710,5598.73065,2127.804103
W58,5750,1941,104202371.5,803,8990,8187,6310.229778,2084.970539
W59,5750,1940,104148686.6,377,9877,9500,4516.817526,2406.732744
W60,5750,1939,104095001.7,781,8859,8078,6557.427024,1786.240791
W61,5750,1937,103987631.9,651,8640,7989,6628.391843,1972.486385
W62,5750,1938,104041316.8,-1058,8640,9698,4992.03354,2659.073297
W63,5750,1931,103665522.6,-1058,9508,10566,3983.867426,2529.821809
W64,5750,1932,103719207.5,381,9000,8619,5589.007246,2173.741734
W65,5750,1942,104256056.4,377,8030,7653,4097.224511,2414.868865
W66,5750,1939,104095001.7,-35,8359,8394,3637.302218,2265.412957
WB-E1,5750,1942,104256056.4,273,9051,8778,4423.200824,2510.243869
WB-E10,5750,1935,103880262.1,377,8791,8414,3978.977261,2234.658913
WB-E2,5750,1934,103826577.3,750,8536,7786,6294.999483,1897.158422
WB-E3,5750,1945,104417111,2869,8949,6080,7412.147558,467.6083659
WB-E4,5750,1936,103933947,1542,8668,7126,7386.733471,1438.582922
WB-E5,5750,1938,104041316.8,273,9667,9394,4737.630031,2500.495719
WB-E6,5750,1939,104095001.7,2474,8390,5916,7311.716349,881.3258777
WB-E7,5750,1938,104041316.8,120,8511,8391,5686.995356,2273.74354
WB-E8,5750,1941,104202371.5,882,8990,8108,5654.413704,2269.37175
WB-E9,5750,1940,104148686.6,224,8956,8732,5359.555155,2286.642722
WB-H1,5750,1933,103772892.4,1276,8465,7189,6692.539576,1600.96145
WB-H10,5750,1935,103880262.1,1307,8865,7558,5610.510078,1977.51622
WB-H2,5750,1941,104202371.5,1496,8717,7221,6772.238022,1952.723198
WB-H3,5750,1929,103558152.8,651,9203,8552,5882.520995,2342.611192
WB-H4,5750,1940,104148686.6,1230,8513,7283,5994.475258,2148.658632
WB-H5,5750,1940,104148686.6,882,9046,8164,5650.099485,2193.051688
WB-H6,5750,1936,103933947,-410,9958,10368,6037.802686,2695.539863
WB-H7,5750,1937,103987631.9,-240,9987,10227,6360.844605,2384.681216
WB-H8,5750,1932,103719207.5,1059,8956,7897,6580.998965,1961.307441
WB-H9,5750,1938,104041316.8,273,9051,8778,5345.739422,2519.806794
WB-S1,5750,1928,103504467.9,-448,9899,10347,5443.184647,2809.392512
WB-S10,5750,1931,103665522.6,-1058,8764,9822,3973.190575,2599.848049
WB-S11,5750,1935,103880262.1,377,8000,7623,5045.346253,2424.126746
WB-S12,5750,1942,104256056.4,377,9877,9500,4451.65448,2349.248041
WB-S13,5750,1942,104256056.4,882,9046,8164,5626.621524,2322.14045
WB-S14,5750,1942,104256056.4,1400,8736,7336,6935.356849,1405.96689
WB-S15,5750,1934,103826577.3,1276,8298,7022,6286.446225,1806.658106
WB-S16,5750,1941,104202371.5,222,9560,9338,5479.450283,2485.218514
WB-S17,5750,1939,104095001.7,890,8622,7732,7098.601857,1203.590514
WB-S18,5750,1938,104041316.8,651,9203,8552,6372.167183,2271.059017
WB-S19,5750,1940,104148686.6,1383,8566,7183,6447.991237,1842.508979
WB-S2,5750,1940,104148686.6,-1404,9932,11336,3811.090722,3545.043166
WB-S20,5750,1938,104041316.8,1335,9107,7772,7334.374097,1446.665952
WB-S21,5750,1934,103826577.3,1893,8411,6518,7055.745088,1231.583125
WB-S22,5750,1942,104256056.4,2474,8694,6220,7329.160144,715.8416036
WB-S23,5750,1936,103933947,680,9081,8401,6501.882748,1880.876869
WB-S24,5750,1938,104041316.8,273,9051,8778,4898.651187,2390.128257
WB-S25,5750,1938,104041316.8,1554,8962,7408,7117.103199,1469.774461
WB-S26,5750,1938,104041316.8,1406,9001,7595,7671.873581,1319.961064
WB-S27,5750,1940,104148686.6,1427,8958,7531,7704.437113,922.1599922
WB-S28,5750,1929,103558152.8,1912,8768,6856,7596.918092,1082.680285
WB-S29,5750,1933,103772892.4,1374,9712,8338,7351.752199,1115.568027
WB-S3,5750,1931,103665522.6,-320,9322,9642,5474.651994,2295.952236
WB-S4,5750,1941,104202371.5,209,8830,8621,4419.679547,2539.7994
WB-S5,5750,1942,104256056.4,1158,8956,7798,6081.388774,2195.371594
WB-S6,5750,1941,104202371.5,1230,8831,7601,5754.464709,2200.652464
WB-S7,5750,1935,103880262.1,1307,8985,7678,6800.05478,1645.827005
WB-S8,5750,1938,104041316.8,36,8803,8767,6857.26935,1842.010863
WB-S9,5750,1939,104095001.7,-919,9979,10898,4807.433729,2595.094013
WB-W1,5750,1933,103772892.4,680,8573,7893,6050.505432,1985.783658
WB-W10,5750,1937,103987631.9,-320,9706,10026,5381.246773,2205.28336
WB-W2,5750,1937,103987631.9,1544,8875,7331,7429.670625,1187.660319
WB-W3,5750,1937,103987631.9,775,9712,8937,7065.969541,1284.528548
WB-W4,5750,1939,104095001.7,262,8718,8456,6308.750387,1616.442373
WB-W5,5750,1939,104095001.7,1457,8627,7170,7300.615781,1298.448028
WB-W6,5750,1939,104095001.7,1542,8668,7126,7309.74884,1435.823772
WB-W7,5750,1928,103504467.9,-256,9919,10175,5598.060685,2874.126932
WB-W8,5750,1934,103826577.3,1395,8627,7232,7133.22544,950.6834954
WB-W9,5750,1940,104148686.6,1249,9677,8428,6561.88866,1843.876697
W01,6000,2108,113167748.1,313,9911,9598,6982.639469,1982.074926
W02,6000,2109,113221433,1195,9008,7813,7427.055477,1348.833911
W03,6000,2104,112953008.6,775,8605,7830,6951.04943,1793.348122
W04,6000,2114,113489857.5,1912,8861,6949,7653.739357,977.3995719
W05,6000,2108,113167748.1,802,9958,9156,7232.238615,1481.069579
W06,6000,2104,112953008.6,1544,9377,7833,7341.144962,1306.267708
W07,6000,2104,112953008.6,775,9491,8716,6756.509981,1665.663731
W08,6000,2104,112953008.6,1374,9451,8077,6980.293726,1644.877913
W09,6000,2109,113221433,1374,9712,8338,7244.16643,1383.38202
W10,6000,2109,113221433,1502,8688,7186,6785.094358,1817.811587
W11,6000,2104,112953008.6,680,8573,7893,6035.919202,1959.449655
W12,6000,2108,113167748.1,273,9484,9211,5868.650854,2017.42818
W13,6000,2114,113489857.5,587,9712,9125,6056.407758,2003.775703
W14,6000,2107,113114063.2,587,9712,9125,6513.714286,2040.169115
W15,6000,2107,113114063.2,1180,8710,7530,6918.602278,1668.700639
W16,6000,2110,113275117.9,7,9874,9867,6644.737915,2292.516789
W17,6000,2109,113221433,-11,9834,9845,6536.463253,2311.001165
W18,6000,2106,113060378.3,-11,8953,8964,6814.340456,1845.607526
W19,6000,2108,113167748.1,-93,9268,9361,6318.570209,2223.698426
W20,6000,2115,113543542.4,-919,9979,10898,6433.623641,1887.974879
W21,6000,2107,113114063.2,-11,8953,8964,6384.66113,2192.044533
W22,6000,2114,113489857.5,-919,9979,10898,4847.648061,2596.045234
W23,6000,2105,113006693.4,-919,9979,10898,6161.331591,1745.835108
W24,6000,2108,113167748.1,222,9560,9338,5696.902751,2381.760928
W25,6000,2108,113167748.1,262,8843,8581,6253.394213,1874.503942
W26,6000,2107,113114063.2,-502,8711,9213,4509.138586,2538.098745
W27,6000,2104,112953008.6,204,8843,8639,6457.371673,1806.290276
W28,6000,2108,113167748.1,262,9012,8750,6368.518501,2119.845597
W29,6000,2107,113114063.2,852,9012,8160,6514.992406,1871.377298
W30,6000,2106,113060378.3,890,8626,7736,7174.736467,1023.465259
W31,6000,2112,113382487.7,4809,8958,4149,7925.358428,353.148396
W32,6000,2104,112953008.6,1406,9001,7595,7776.665875,1125.603306
W33,6000,2108,113167748.1,1395,9004,7609,7301.067837,1608.119539
W34,6000,2104,112953008.6,1109,9203,8094,6370.611692,2122.383127
W35,6000,2104,112953008.6,1427,8562,7135,7026.325095,1468.130098
W36,6000,2109,113221433,1249,9107,7858,6691.990517,1796.622914
W37,6000,2112,113382487.7,1177,9107,7930,6678.401989,1925.33932
W38,6000,2101,112791953.9,3186,8750,5564,7766.901951,496.0550398
W39,6000,2115,113543542.4,1893,8519,6626,7303.733333,979.6108108
W40,6000,2113,113436172.6,1034,9046,8012,6446.557974,2008.489873
W41,6000,2111,113328802.8,1196,9046,7850,6666.606821,1637.744871
W42,6000,2112,113382487.7,2089,9046,6957,7304.568655,1068.245021
W43,6000,2112,113382487.7,2474,8411,5937,7356.195076,858.864884
W44,6000,2108,113167748.1,1400,8736,7336,6748.745731,1513.097573
W45,6000,2107,113114063.2,1400,8736,7336,6545.196963,1654.515011
W46,6000,2114,113489857.5,1276,8298,7022,6149.585147,1853.039278
W47,6000,2115,113543542.3,1276,8465,7189,6313.355556,1846.115952
W48,6000,2112,113382487.7,1398,8848,7450,7284.715909,1171.908427
W49,6000,2116,113597227.2,1398,8985,7587,6071.667769,1882.704793
W50,6000,2111,113328802.8,1664,9018,7354,6878.626717,1501.320474
W51,6000,2111,113328802.8,1318,9463,8145,6839.168167,1596.896773
W52,6000,2108,113167748.1,1406,8356,6950,5872.218691,1972.71277
W53,6000,2112,113382487.7,1515,8865,7350,6691.306345,1562.421692
W54,6000,2102,112845638.8,1059,8495,7436,5819.690295,2045.25552
W55,6000,2115,113543542.4,1175,8832,7657,6360.92766,2087.995009
W56,6000,2110,113275117.9,1136,9919,8783,6124.18436,2108.305071
W57,6000,2109,113221433,1280,8990,7710,5624.885254,2133.776411
W58,6000,2116,113597227.2,803,8990,8187,6235.324669,2102.059642
W59,6000,2110,113275117.9,377,9877,9500,4547.800948,2431.799563
W60,6000,2110,113275117.9,675,8859,8184,6545.804739,1802.840789
W61,6000,2108,113167748.1,651,8640,7989,6595.93074,1981.250353
W62,6000,2105,113006693.5,-1058,8640,9698,5039.870309,2636.507756
W63,6000,2106,113060378.3,-1058,9508,10566,4086.49905,2544.476129
W64,6000,2100,112738269,381,9000,8619,5540.410476,2212.794759
W65,6000,2111,113328802.8,377,8030,7653,4155.198484,2400.992244
W66,6000,2112,113382487.7,-35,8572,8607,3729.558239,2291.867175
WB-E1,6000,2109,113221433,273,9051,8778,4446.265055,2495.89578
WB-E10,6000,2109,113221433,377,8791,8414,4055.822665,2257.118218
WB-E2,6000,2107,113114063.2,750,8536,7786,6190.270052,1990.351661
WB-E3,6000,2114,113489857.5,2869,8949,6080,7399.550142,466.234579
WB-E4,6000,2110,113275117.9,1542,8668,7126,7404.321327,1398.711949
WB-E5,6000,2110,113275117.9,273,9667,9394,4821.822275,2511.115785
WB-E6,6000,2110,113275117.9,2474,8411,5937,7325.040758,865.5063752
WB-E7,6000,2108,113167748.1,120,8511,8391,5664.314991,2298.668857
WB-E8,6000,2112,113382487.7,882,8990,8108,5619.421875,2269.035683
WB-E9,6000,2115,113543542.4,224,8956,8732,5437.866667,2276.283844
WB-H1,6000,2104,112953008.6,1276,8465,7189,6673.735741,1618.315837
WB-H10,6000,2110,113275117.9,1307,8865,7558,5662.841706,1983.386412
WB-H2,6000,2115,113543542.3,1496,8717,7221,6769.995745,1952.001063
WB-H3,6000,2106,113060378.3,651,9203,8552,5945.404558,2345.210103
WB-H4,6000,2111,113328802.8,1230,8788,7558,6028.63856,2128.814248
WB-H5,6000,2108,113167748.1,882,9046,8164,5702.993833,2175.556974
WB-H6,6000,2104,112953008.6,-410,9958,10368,6086.386407,2685.635155
WB-H7,6000,2112,113382487.7,-240,9987,10227,6378.883996,2386.416876
WB-H8,6000,2110,113275117.9,1059,8956,7897,6511.582938,1981.880601
WB-H9,6000,2102,112845638.8,273,9051,8778,5370.529496,2506.405586
WB-S1,6000,2103,112899323.7,-448,9899,10347,5592.123157,2776.815212
WB-S10,6000,2110,113275117.9,-1058,8764,9822,3984.466825,2605.571387
WB-S11,6000,2106,113060378.3,377,8000,7623,5064.504748,2413.589558
WB-S12,6000,2116,113597227.2,377,9877,9500,4507.312854,2376.631557
WB-S13,6000,2112,113382487.7,882,9046,8164,5651.136837,2316.13904
WB-S14,6000,2114,113489857.5,1400,8736,7336,6947.83964,1401.389195
WB-S15,6000,2102,112845638.8,1276,8298,7022,6270.132731,1807.635082
WB-S16,6000,2111,113328802.8,222,9560,9338,5531.158693,2465.876595
WB-S17,6000,2113,113436172.6,890,8640,7750,7071.472788,1251.359115
WB-S18,6000,2108,113167748.1,651,9203,8552,6299.667457,2290.774529
WB-S19,6000,2111,113328802.8,1249,8566,7317,6471.184747,1836.203533
WB-S2,6000,2116,113597227.2,-1438,9932,11370,3798.854915,3534.166514
WB-S20,6000,2107,113114063.2,1335,9107,7772,7321.789748,1443.007306
WB-S21,6000,2104,112953008.6,1893,8411,6518,7082.584125,1209.329222
WB-S22,6000,2108,113167748.1,2474,8694,6220,7324.723435,743.1181152
WB-S23,6000,2108,113167748.1,680,9081,8401,6465.141366,1898.749866
WB-S24,6000,2103,112899323.7,273,9051,8778,4978.506895,2374.827176
WB-S25,6000,2108,113167748.1,1554,8962,7408,7107.127609,1455.323061
WB-S26,6000,2111,113328802.8,1406,9001,7595,7636.663193,1366.501272
WB-S27,6000,2110,113275117.9,1427,8958,7531,7712.187678,911.679721
WB-S28,6000,2108,113167748.1,1777,8828,7051,7561.544118,1131.592941
WB-S29,6000,2109,113221433,1374,9712,8338,7337.390706,1126.310126
WB-S3,6000,2109,113221433,-320,9706,10026,5472.290185,2316.590609
WB-S4,6000,2107,113114063.2,209,8830,8621,4368.668249,2539.745162
WB-S5,6000,2113,113436172.6,863,8956,8093,6062.420729,2230.929814
WB-S6,6000,2112,113382487.7,1230,8831,7601,5799.855587,2185.870642
WB-S7,6000,2109,113221433,1307,8985,7678,6730.339497,1714.627223
WB-S8,6000,2104,112953008.6,-16,8803,8819,6826.315114,1891.561142
WB-S9,6000,2111,113328802.8,-919,9979,10898,4756.771198,2609.857705
WB-W1,6000,2099,112684584.1,680,8573,7893,6079.199142,1958.879108
WB-W10,6000,2109,113221433,-320,9706,10026,5380.165481,2226.53661
WB-W2,6000,2111,113328802.8,1544,8875,7331,7408.781146,1192.550015
WB-W3,6000,2106,113060378.3,775,9712,8937,7013.276828,1364.574077
WB-W4,6000,2112,113382487.7,262,8843,8581,6257.866951,1681.649252
WB-W5,6000,2109,113221433,1457,8627,7170,7273.280702,1340.694571
WB-W6,6000,2106,113060378.3,1542,8668,7126,7279.964862,1457.49479
WB-W7,6000,2103,112899323.7,-256,9919,10175,5579.508321,2873.958032
WB-W8,6000,2106,113060378.3,1395,8627,7232,7142.789649,999.8175788
WB-W9,6000,2107,113114063.2,1249,9677,8428,6528.728049,1864.441805
W01,6250,2284,122616288.8,313,9911,9598,6959.514886,2001.80553
W02,6250,2288,122831028.3,858,9008,8150,7404.726836,1374.374646
W03,6250,2289,122884713.2,775,8733,7958,7008.169506,1745.640474
W04,6250,2289,122884713.2,1777,8861,7084,7624.132809,1042.484344
W05,6250,2289,122884713.2,802,9958,9156,7219.667977,1516.558981
W06,6250,2279,122347864.3,1544,9428,7884,7335.232119,1303.566959
W07,6250,2283,122562603.9,775,9569,8794,6758.83399,1655.528895
W08,6250,2279,122347864.3,1374,9451,8077,6988.071961,1654.262187
W09,6250,2285,122669973.7,1374,9712,8338,7205.819256,1404.668582
W10,6250,2290,122938398.1,1502,8688,7186,6737.921834,1850.715076
W11,6250,2279,122347864.3,680,8573,7893,6067.382185,1927.455244
W12,6250,2281,122455234.1,273,9573,9300,5860.480491,2080.899721
W13,6250,2288,122831028.3,587,9712,9125,6059.862762,2041.043769
W14,6250,2288,122831028.3,587,9712,9125,6463.243007,2080.842061
W15,6250,2288,122831028.3,1180,8962,7782,6877.52229,1727.764519
W16,6250,2286,122723658.5,7,9874,9867,6577.673666,2327.812331
W17,6250,2290,122938398.1,-11,9834,9845,6572.867686,2295.725914
W18,6250,2289,122884713.2,-11,8953,8964,6789.595893,1868.264362
W19,6250,2289,122884713.2,-93,9268,9361,6326.387069,2214.716995
W20,6250,2290,122938398.1,-919,9979,10898,6429.779476,1911.392049
W21,6250,2280,122401549.2,-11,8953,8964,6406.317544,2163.112883
W22,6250,2292,123045767.9,-919,9979,10898,4844.55541,2601.563582
W23,6250,2281,122455234.1,-919,9979,10898,6126.665936,1794.427224
W24,6250,2288,122831028.3,222,9560,9338,5695.469406,2368.190954
W25,6250,2289,122884713.2,262,8843,8581,6219.157711,1913.840961
W26,6250,2289,122884713.2,-1058,8711,9769,4561.765837,2560.731204
W27,6250,2282,122508919,204,8843,8639,6352.409728,1899.937025
W28,6250,2283,122562603.9,262,9012,8750,6397.824354,2086.089813
W29,6250,2287,122777343.4,852,9012,8160,6520.373852,1875.149922
W30,6250,2282,122508919,890,8626,7736,7164.265118,1069.228515
W31,6250,2293,123099452.8,3893,8958,5065,7914.793284,391.3124628
W32,6250,2278,122294179.4,1406,9001,7595,7731.410009,1197.157695
W33,6250,2287,122777343.4,1109,9004,7895,7277.577613,1625.097994
W34,6250,2286,122723658.5,1033,9203,8170,6361.715661,2131.587705
W35,6250,2279,122347864.3,1427,8562,7135,7046.13032,1468.028877
W36,6250,2284,122616288.8,1249,9107,7858,6656.570053,1838.340237
W37,6250,2292,123045767.9,1177,9107,7930,6730.363438,1898.364572
W38,6250,2286,122723658.5,3186,8750,5564,7750.517498,532.6104701
W39,6250,2293,123099452.8,1893,8555,6662,7288.289141,996.7292554
W40,6250,2293,123099452.8,882,9046,8164,6399.49324,2063.316837
W41,6250,2291,122992083,1196,9046,7850,6603.004801,1698.765118
W42,6250,2292,123045767.9,1893,9046,7153,7308.721204,1071.781913
W43,6250,2293,123099452.8,2474,8411,5937,7376.245094,831.9506333
W44,6250,2290,122938398.1,1400,8736,7336,6731.005677,1528.631524
W45,6250,2284,122616288.8,1400,8736,7336,6574.876095,1644.878472
W46,6250,2289,122884713.2,1276,8298,7022,6143.514635,1859.003404
W47,6250,2292,123045767.9,1276,8465,7189,6303.712914,1877.769114
W48,6250,2288,122831028.3,1398,8848,7450,7256.92264,1198.262368
W49,6250,2293,123099452.8,1398,8985,7587,6141.439163,1876.684403
W50,6250,2292,123045767.9,1664,9018,7354,6883.467277,1495.309677
W51,6250,2287,122777343.4,1318,9463,8145,6772.739397,1674.514015
W52,6250,2293,123099452.8,1406,8356,6950,5923.930659,1941.220449
W53,6250,2292,123045767.9,1491,8865,7374,6583.997382,1684.290896
W54,6250,2289,122884713.2,1059,8495,7436,5795.065094,2054.85442
W55,6250,2289,122884713.2,1007,8832,7825,6341.884229,2105.343693
W56,6250,2289,122884713.2,1136,9919,8783,6101.21232,2115.754386
W57,6250,2291,122992083,1280,8990,7710,5646.283282,2146.476276
W58,6250,2297,123314192.3,803,8990,8187,6170.871572,2114.158501
W59,6250,2291,122992083,377,9877,9500,4550.896552,2436.588763
W60,6250,2288,122831028.3,675,9100,8425,6543.785839,1824.559449
W61,6250,2287,122777343.4,651,8640,7989,6581.40927,1974.81987
W62,6250,2289,122884713.2,-1058,8640,9698,5091.20664,2621.132531
W63,6250,2283,122562603.9,-1058,9508,10566,4183.22777,2548.465477
W64,6250,2285,122669973.7,381,9000,8619,5484.141794,2259.064678
W65,6250,2292,123045767.9,264,8030,7766,4204.369546,2391.596178
W66,6250,2291,122992083,-35,8572,8607,3833.648625,2324.316686
WB-E1,6250,2292,123045767.9,273,9051,8778,4483.143106,2503.748038
WB-E10,6250,2288,122831028.3,377,8791,8414,4136.946678,2280.751912
WB-E2,6250,2282,122508919,750,8536,7786,6107.291849,2045.482405
WB-E3,6250,2292,123045767.9,2869,8949,6080,7387.886998,474.415254
WB-E4,6250,2286,122723658.5,1542,8668,7126,7410.454506,1361.230195
WB-E5,6250,2290,122938398.1,273,9667,9394,4924.092576,2512.307495
WB-E6,6250,2291,122992083,2474,8411,5937,7326.807071,863.4670055
WB-E7,6250,2289,122884713.2,120,8718,8598,5630.713849,2318.940198
WB-E8,6250,2294,123153137.7,882,8990,8108,5605.117698,2259.260121
WB-E9,6250,2292,123045767.9,224,8956,8732,5510.239092,2262.831568
WB-H1,6250,2289,122884713.2,1276,8465,7189,6645.792923,1654.924036
WB-H10,6250,2285,122669973.7,1276,8865,7589,5715.461707,1989.412155
WB-H2,6250,2293,123099452.8,1496,8717,7221,6790.836023,1934.382804
WB-H3,6250,2284,122616288.8,651,9203,8552,6012.829247,2349.985386
WB-H4,6250,2291,122992083,1230,8788,7558,6074.373636,2109.537981
WB-H5,6250,2291,122992083,882,9046,8164,5765.749018,2162.123469
WB-H6,6250,2287,122777343.4,-410,9958,10368,6144.429821,2666.782895
WB-H7,6250,2290,122938398.1,-240,9987,10227,6400.657205,2379.252601
WB-H8,6250,2285,122669973.7,1059,8956,7897,6434.673523,2014.631731
WB-H9,6250,2289,122884713.2,273,9051,8778,5388.179991,2494.427568
WB-S1,6250,2284,122616288.8,-448,9899,10347,5716.377846,2745.265045
WB-S10,6250,2286,122723658.5,-1058,8764,9822,3998.327647,2610.879554
WB-S11,6250,2283,122562603.9,377,8000,7623,5089.009198,2407.383723
WB-S12,6250,2291,122992083,377,9877,9500,4552.109996,2383.620785
WB-S13,6250,2292,123045767.9,882,9046,8164,5662.602094,2308.95521
WB-S14,6250,2292,123045767.9,1400,8736,7336,6955.897033,1400.287291
WB-S15,6250,2288,122831028.3,1276,8441,7165,6259.056381,1810.323437
WB-S16,6250,2293,123099452.8,222,9560,9338,5571.509376,2441.183138
WB-S17,6250,2291,122992083,890,8640,7750,7045.140986,1311.601803
WB-S18,6250,2290,122938398.1,651,9203,8552,6250.327511,2306.271191
WB-S19,6250,2290,122938398.1,1249,8566,7317,6498.533188,1830.851896
WB-S2,6250,2287,122777343.4,-1438,9932,11370,3834.229996,3528.68965
WB-S20,6250,2294,123153137.7,1335,9107,7772,7312.528771,1439.963034
WB-S21,6250,2282,122508919,1893,8411,6518,7103.447415,1185.303184
WB-S22,6250,2291,122992083,2474,8694,6220,7330.316892,741.2017617
WB-S23,6250,2289,122884713.2,680,9081,8401,6457.585408,1892.982799
WB-S24,6250,2288,122831028.3,273,9051,8778,5068.906469,2361.56672
WB-S25,6250,2291,122992083,1461,8962,7501,7093.171541,1448.45124
WB-S26,6250,2290,122938398.1,1406,9001,7595,7595.200437,1416.374117
WB-S27,6250,2292,123045767.9,1427,8958,7531,7715.229494,908.9667094
WB-S28,6250,2283,122562603.9,1544,8828,7284,7509.415243,1208.522053
WB-S29,6250,2287,122777343.4,1374,9712,8338,7325.321382,1131.572137
WB-S3,6250,2285,122669973.7,-320,9934,10254,5460.355361,2325.651691
WB-S4,6250,2294,123153137.7,209,8830,8621,4323.380558,2534.4228
WB-S5,6250,2293,123099452.8,224,8956,8732,6030.805495,2267.345732
WB-S6,6250,2292,123045767.9,1230,8831,7601,5847.910995,2169.940602
WB-S7,6250,2286,122723658.5,1307,8985,7678,6667.007437,1763.275402
WB-S8,6250,2288,122831028.3,-16,8803,8819,6792.94493,1932.749386
WB-S9,6250,2291,122992083,-919,9979,10898,4714.105194,2619.841406
WB-W1,6250,2285,122669973.7,680,8573,7893,6116.191685,1924.615812
WB-W10,6250,2283,122562603.9,-320,9934,10254,5372.12177,2258.601144
WB-W2,6250,2288,122831028.3,1544,8875,7331,7388.552448,1211.323242
WB-W3,6250,2287,122777343.4,775,9712,8937,6969.39965,1434.969077
WB-W4,6250,2291,122992083,262,8843,8581,6197.613706,1747.353228
WB-W5,6250,2292,123045767.9,1418,8627,7209,7234.888743,1396.863406
WB-W6,6250,2290,122938398.1,1542,8668,7126,7263.578603,1474.192431
WB-W7,6250,2283,122562603.9,-256,9919,10175,5558.257994,2870.868918
WB-W8,6250,2285,122669973.7,1395,8627,7232,7131.728665,1068.61891
WB-W9,6250,2289,122884713.2,1249,9677,8428,6486.625164,1882.885543
W01,6500,2471,132655363.2,313,9911,9598,6932.445164,2028.076176
W02,6500,2476,132923787.6,809,9008,8199,7388.384895,1398.592519
W03,6500,2470,132601678.3,775,8768,7993,7048.592308,1700.949061
W04,6500,2474,132816417.9,1195,8875,7680,7579.784964,1133.568411
W05,6500,2474,132816417.9,802,9958,9156,7207.821342,1541.46099
W06,6500,2472,132709048.1,1236,9428,8192,7338.033172,1308.699914
W07,6500,2474,132816417.9,775,9569,8794,6783.235247,1639.753984
W08,6500,2472,132709048.1,1374,9569,8195,6983.985032,1667.604074
W09,6500,2473,132762733,1374,9712,8338,7174.003235,1423.874614
W10,6500,2475,132870102.8,1502,8688,7186,6690.869495,1882.767761
W11,6500,2471,132655363.2,680,8573,7893,6110.371105,1894.305574
W12,6500,2475,132870102.8,273,9667,9394,5834.669899,2137.632165
W13,6500,2477,132977472.5,587,9712,9125,6072.77069,2063.585754
W14,6500,2474,132816417.9,587,9712,9125,6437.201293,2104.150256
W15,6500,2474,132816417.9,1180,8962,7782,6845.694422,1771.321144
W16,6500,2472,132709048.1,7,9874,9867,6514.385113,2351.781533
W17,6500,2472,132709048.1,-11,9834,9845,6600.146036,2282.714593
W18,6500,2472,132709048.1,-11,8953,8964,6747.847087,1903.829152
W19,6500,2473,132762733,-93,9268,9361,6337.016983,2215.148537
W20,6500,2476,132923787.6,-919,9979,10898,6414.832795,1944.964042
W21,6500,2476,132923787.6,-11,8953,8964,6427.999192,2132.541009
W22,6500,2476,132923787.6,-919,9979,10898,4837.457997,2618.845653
W23,6500,2473,132762733,-919,9979,10898,6105.182774,1828.95207
W24,6500,2474,132816417.9,222,9560,9338,5716.802749,2350.01209
W25,6500,2474,132816417.9,222,8843,8621,6181.651981,1944.692624
W26,6500,2475,132870102.8,-1058,8711,9769,4616.975354,2576.955041
W27,6500,2472,132709048.1,204,8843,8639,6282.02589,1956.249109
W28,6500,2477,132977472.5,262,9012,8750,6434.588615,2040.799027
W29,6500,2473,132762733,852,9012,8160,6521.207845,1880.827605
W30,6500,2474,132816417.9,890,8627,7737,7144.308003,1120.589544
W31,6500,2475,132870102.8,1548,8958,7410,7898.241212,491.2714631
W32,6500,2471,132655363.2,1406,9001,7595,7698.966815,1234.501036
W33,6500,2478,133031157.4,1109,9158,8049,7262.668281,1628.887594
W34,6500,2470,132601678.3,1033,9203,8170,6356.704049,2138.125843
W35,6500,2474,132816417.9,1427,8958,7531,7053.046079,1488.986584
W36,6500,2476,132923787.6,1249,9107,7858,6643.71042,1855.97826
W37,6500,2476,132923787.6,1136,9401,8265,6775.811389,1871.787805
W38,6500,2472,132709048.1,1855,8909,7054,7730.346683,604.6008773
W39,6500,2478,133031157.4,1893,8555,6662,7268.357143,1023.547787
W40,6500,2477,132977472.5,882,9046,8164,6359.278563,2096.471006
W41,6500,2477,132977472.5,1196,9046,7850,6551.302786,1733.39067
W42,6500,2479,133084842.3,1893,9046,7153,7297.027834,1089.882394
W43,6500,2476,132923787.6,2474,8411,5937,7393.819063,808.8023913
W44,6500,2475,132870102.8,1400,8736,7336,6725.914747,1529.616293
W45,6500,2480,133138527.2,1400,8736,7336,6598.727823,1628.903355
W46,6500,2479,133084842.3,1276,8441,7165,6134.471158,1872.783001
W47,6500,2474,132816417.9,1276,8465,7189,6302.277284,1901.129622
W48,6500,2484,133353266.8,1398,8848,7450,7234.183172,1234.17246
W49,6500,2478,133031157.4,1398,8985,7587,6200.803874,1862.952151
W50,6500,2476,132923787.6,1664,9020,7356,6881.476171,1494.000178
W51,6500,2476,132923787.6,1318,9463,8145,6714.102181,1736.889866
W52,6500,2475,132870102.8,1406,8484,7078,5963.666667,1920.252879
W53,6500,2474,132816417.9,1491,8865,7374,6483.605901,1790.058905
W54,6500,2473,132762733,1059,8495,7436,5753.706834,2064.702452
W55,6500,2477,132977472.5,1007,8832,7825,6341.324182,2106.70519
W56,6500,2479,133084842.3,1136,9919,8783,6095.128681,2116.839396
W57,6500,2477,132977472.5,1280,8990,7710,5642.50222,2160.802742
W58,6500,2476,132923787.6,803,8990,8187,6123.684168,2127.956967
W59,6500,2474,132816417.9,377,9877,9500,4563.334276,2444.815005
W60,6500,2475,132870102.8,552,9203,8651,6533.953535,1852.445216
W61,6500,2476,132923787.6,651,8640,7989,6591.153069,1954.752358
W62,6500,2474,132816417.9,-1058,8640,9698,5128.38076,2615.612931
W63,6500,2471,132655363.2,-1058,9508,10566,4276.354917,2557.034888
W64,6500,2470,132601678.3,381,9000,8619,5434.45668,2297.984196
W65,6500,2474,132816417.9,-35,8030,8065,4261.525465,2381.460966
W66,6500,2476,132923787.6,-35,9000,9035,3949.350162,2370.473601
WB-E1,6500,2475,132870102.8,273,9357,9084,4537.242424,2510.409985
WB-E10,6500,2475,132870102.8,377,8961,8584,4223.108283,2305.387854
WB-E2,6500,2476,132923787.6,750,8536,7786,6018.771809,2108.720908
WB-E3,6500,2479,133084842.3,2869,8949,6080,7381.713998,477.7128211
WB-E4,6500,2475,132870102.8,1542,8668,7126,7407.821818,1346.290425
WB-E5,6500,2473,132762733,273,9667,9394,5026.823292,2503.672553
WB-E6,6500,2476,132923787.6,2474,8411,5937,7336.972536,849.3720036
WB-E7,6500,2475,132870102.8,37,8843,8806,5634.052121,2311.570771
WB-E8,6500,2474,132816417.9,882,8990,8108,5600.437753,2252.63105
WB-E9,6500,2480,133138527.2,224,8956,8732,5550.588306,2240.189354
WB-H1,6500,2474,132816417.9,1276,8465,7189,6615.409863,1692.258755
WB-H10,6500,2477,132977472.5,1276,8865,7589,5779.730319,1986.538346
WB-H2,6500,2476,132923787.6,1447,8717,7270,6802.406704,1927.234876
WB-H3,6500,2473,132762733,651,9203,8552,6087.044076,2332.607429
WB-H4,6500,2477,132977472.5,1230,8831,7601,6121.766249,2092.511051
WB-H5,6500,2475,132870102.8,882,9046,8164,5828.369293,2158.206783
WB-H6,6500,2473,132762733,-410,9958,10368,6196.928427,2651.8965
WB-H7,6500,2475,132870102.8,-240,9987,10227,6426.779798,2367.610813
WB-H8,6500,2474,132816417.9,1059,8956,7897,6333.905416,2063.284277
WB-H9,6500,2472,132709048.1,273,9051,8778,5414.294903,2483.270488
WB-S1,6500,2470,132601678.3,-448,9913,10361,5836.160324,2714.701324
WB-S10,6500,2472,132709048.1,-1058,9508,10566,4016.167476,2615.723786
WB-S11,6500,2475,132870102.8,377,8000,7623,5107.751515,2407.907925
WB-S12,6500,2478,133031157.4,377,9919,9542,4647.889023,2401.378599
WB-S13,6500,2475,132870102.8,882,9046,8164,5665.97899,2302.302692
WB-S14,6500,2479,133084842.3,1400,8736,7336,6957.440904,1408.666009
WB-S15,6500,2474,132816417.9,1276,8465,7189,6240.71059,1826.094606
WB-S16,6500,2474,132816417.9,222,9560,9338,5638.209378,2409.711503
WB-S17,6500,2477,132977472.5,890,8640,7750,7030.850626,1358.228087
WB-S18,6500,2475,132870102.8,651,9203,8552,6206.248485,2319.833701
WB-S19,6500,2476,132923787.6,1249,8566,7317,6522.747173,1817.490729
WB-S2,6500,2478,133031157.4,-1438,9932,11370,3860.484665,3521.772336
WB-S20,6500,2473,132762733,1249,9107,7858,7307.625556,1430.576465
WB-S21,6500,2475,132870102.8,1893,8411,6518,7122.682828,1159.876477
WB-S22,6500,2475,132870102.8,2474,8694,6220,7331.108687,750.9824654
WB-S23,6500,2474,132816417.9,502,9081,8579,6452.798302,1894.084446
WB-S24,6500,2474,132816417.9,273,9051,8778,5149.389248,2355.263735
WB-S25,6500,2472,132709048.1,1461,8962,7501,7063.151294,1484.795108
WB-S26,6500,2476,132923787.6,1406,9001,7595,7565.886107,1448.599651
WB-S27,6500,2472,132709048.1,1427,8958,7531,7711.482605,914.446732
WB-S28,6500,2472,132709048.1,1225,8828,7603,7441.596278,1309.199217
WB-S29,6500,2475,132870102.8,1374,9712,8338,7317.423838,1123.397968
WB-S3,6500,2473,132762733,-320,9934,10254,5457.971694,2340.915084
WB-S4,6500,2474,132816417.9,209,8830,8621,4270.335085,2526.98879
WB-S5,6500,2477,132977472.5,224,8956,8732,6004.971336,2291.429134
WB-S6,6500,2476,132923787.6,1230,8831,7601,5890.026656,2160.802908
WB-S7,6500,2478,133031157.4,1307,8985,7678,6610.305085,1801.994219
WB-S8,6500,2474,132816417.9,-93,8803,8896,6754.54325,1970.206546
WB-S9,6500,2474,132816417.9,-919,9979,10898,4677.320129,2632.798331
WB-W1,6500,2467,132440623.6,680,8733,8053,6154.496149,1896.246793
WB-W10,6500,2479,133084842.3,-320,9934,10254,5368.07261,2278.027705
WB-W2,6500,2472,132709048.1,1544,8875,7331,7371.709142,1231.485267
WB-W3,6500,2472,132709048.1,775,9712,8937,6934.653722,1486.160266
WB-W4,6500,2473,132762733,262,8843,8581,6158.729478,1793.279714
WB-W5,6500,2478,133031157.4,1415,8627,7212,7193.299839,1438.483086
WB-W6,6500,2473,132762733,1542,8668,7126,7263.803882,1471.86073
WB-W7,6500,2471,132655363.2,-399,9919,10318,5540.192635,2866.671512
WB-W8,6500,2475,132870102.8,1192,8627,7435,7114.143434,1143.483318
WB-W9,6500,2475,132870102.8,1249,9677,8428,6468.510707,1896.015242
W01,6750,2665,143070231.8,313,9911,9598,6939.028143,2025.547429
W02,6750,2666,143123916.7,714,9008,8294,7362.32108,1438.306323
W03,6750,2665,143070231.8,775,8768,7993,7078.469043,1663.66882
W04,6750,2669,143284971.4,1195,8875,7680,7523.714125,1217.184462
W05,6750,2667,143177601.6,802,9958,9156,7212.011999,1543.611183
W06,6750,2665,143070231.8,1004,9428,8424,7326.893433,1344.663953
W07,6750,2667,143177601.6,775,9712,8937,6802.87964,1628.120098
W08,6750,2665,143070231.8,1374,9569,8195,6978.585741,1681.832017
W09,6750,2667,143177601.6,1374,9712,8338,7133.683915,1442.882918
W10,6750,2668,143231286.5,1356,8688,7332,6655.962144,1907.525007
W11,6750,2665,143070231.8,680,8733,8053,6150.491557,1865.12072
W12,6750,2668,143231286.5,273,9667,9394,5797.417541,2191.38435
W13,6750,2670,143338656.3,587,9712,9125,6084.011985,2079.719583
W14,6750,2667,143177601.6,587,9712,9125,6420.473191,2126.015648
W15,6750,2667,143177601.6,1058,8962,7904,6815.059993,1807.519616
W16,6750,2665,143070231.8,-240,9874,10114,6449.857036,2380.409684
W17,6750,2664,143016547,-11,9834,9845,6622.918919,2264.657062
W18,6750,2664,143016547,-11,8953,8964,6717.450075,1914.048048
W19,6750,2671,143392341.2,-93,9268,9361,6333.926994,2223.226113
W20,6750,2666,143123916.7,-919,9979,10898,6398.482371,1968.275972
W21,6750,2668,143231286.5,-11,8953,8964,6437.086582,2109.660185
W22,6750,2669,143284971.4,-919,9979,10898,4833.218059,2642.258059
W23,6750,2668,143231286.5,-919,9979,10898,6076.529235,1876.510065
W24,6750,2664,143016547,222,9560,9338,5749.712087,2329.810361
W25,6750,2669,143284971.4,222,8843,8621,6141.846759,1965.475433
W26,6750,2666,143123916.7,-1058,8764,9822,4661.969242,2587.473026
W27,6750,2670,143338656.3,204,8843,8639,6200.298502,2022.21058
W28,6750,2669,143284971.4,262,9012,8750,6461.219558,1999.837101
W29,6750,2667,143177601.6,852,9012,8160,6521.977878,1882.642608
W30,6750,2666,143123916.7,890,8627,7737,7117.789572,1164.253932
W31,6750,2671,143392341.2,1430,8958,7528,7883.564583,574.5432065
W32,6750,2669,143284971.4,1406,9001,7595,7656.079805,1294.577645
W33,6750,2669,143284971.4,1109,9158,8049,7248.70326,1631.817042
W34,6750,2674,143553395.9,651,9203,8552,6325.868362,2155.954677
W35,6750,2667,143177601.6,1427,8958,7531,7038.828271,1547.803013
W36,6750,2670,143338656.3,1249,9107,7858,6630.680899,1865.766691
W37,6750,2670,143338656.3,1136,9677,8541,6809.534457,1852.963628
W38,6750,2673,143499711,1525,8909,7384,7698.547325,685.3052767
W39,6750,2670,143338656.3,1893,8555,6662,7259.520225,1036.792298
W40,6750,2669,143284971.4,882,9046,8164,6332.686399,2104.964016
W41,6750,2668,143231286.5,1196,9046,7850,6482.75075,1790.986855
W42,6750,2670,143338656.3,1893,9046,7153,7276.350562,1101.609346
W43,6750,2671,143392341.2,2474,8411,5937,7389.412205,812.9401477
W44,6750,2669,143284971.4,1400,8736,7336,6716.258149,1533.212167
W45,6750,2670,143338656.3,1400,8736,7336,6608.455805,1623.838513
W46,6750,2670,143338656.3,1276,8465,7189,6141.050187,1874.362931
W47,6750,2673,143499711,1276,8465,7189,6280.614291,1940.149936
W48,6750,2670,143338656.3,1398,8848,7450,7226.205618,1238.89413
W49,6750,2670,143338656.3,1398,8985,7587,6256.313483,1847.69313
W50,6750,2672,143446026.1,1664,9463,7799,6870.445734,1504.824479
W51,6750,2675,143607080.7,1318,9463,8145,6643.744299,1792.706683
W52,6750,2669,143284971.4,1406,8484,7078,6005.376546,1895.34633
W53,6750,2671,143392341.2,1307,8865,7558,6401.639086,1863.913461
W54,6750,2681,143929190.1,1059,8508,7449,5710.512868,2069.114619
W55,6750,2670,143338656.3,1007,8890,7883,6349.404869,2113.448454
W56,6750,2668,143231286.5,1136,9919,8783,6079.407796,2119.186783
W57,6750,2668,143231286.5,1280,8990,7710,5617.007871,2190.898201
W58,6750,2674,143553395.9,803,8990,8187,6071.646971,2145.798965
W59,6750,2669,143284971.4,377,9877,9500,4587.106782,2449.142555
W60,6750,2668,143231286.5,552,9203,8651,6512.801724,1895.442354
W61,6750,2667,143177601.6,651,8823,8172,6605.689164,1940.157428
W62,6750,2668,143231286.5,-1058,8640,9698,5186.491379,2607.831577
W63,6750,2669,143284971.4,-1058,9508,10566,4362.398277,2557.702042
W64,6750,2672,143446026.1,264,9000,8736,5379.188623,2338.248171
W65,6750,2669,143284971.4,-35,8030,8065,4316.271637,2372.297513
W66,6750,2669,143284971.4,-35,9000,9035,4062.312477,2410.514593
WB-E1,6750,2669,143284971.4,273,9560,9287,4605.730236,2526.661117
WB-E10,6750,2670,143338656.3,377,9020,8643,4286.547191,2325.705952
WB-E2,6750,2668,143231286.5,750,8536,7786,5951.657046,2155.882467
WB-E3,6750,2670,143338656.3,2869,8949,6080,7367.801498,501.1778198
WB-E4,6750,2665,143070231.9,1542,8668,7126,7399.609756,1340.448944
WB-E5,6750,2668,143231286.5,273,9667,9394,5144.242879,2488.507035
WB-E6,6750,2672,143446026.1,2474,8411,5937,7345.886228,831.9824872
WB-E7,6750,2667,143177601.6,37,8843,8806,5634.59805,2311.60219
WB-E8,6750,2669,143284971.4,882,8990,8108,5596.460472,2250.480562
WB-E9,6750,2676,143660765.6,224,8956,8732,5561.35725,2221.442637
WB-H1,6750,2682,143982875,1276,8465,7189,6585.613348,1726.41807
WB-H10,6750,2673,143499711,1276,8865,7589,5853.260007,1980.961127
WB-H2,6750,2669,143284971.4,1447,8717,7270,6828.586737,1917.051763
WB-H3,6750,2668,143231286.5,651,9203,8552,6168.166417,2311.784333
WB-H4,6750,2667,143177601.6,1230,8865,7635,6164.722535,2071.6131
WB-H5,6750,2666,143123916.7,882,9046,8164,5892.36159,2150.983874
WB-H6,6750,2667,143177601.6,-410,9958,10368,6266.340457,2622.637879
WB-H7,6750,2667,143177601.6,-240,9987,10227,6468.487064,2345.853168
WB-H8,6750,2669,143284971.4,1059,8956,7897,6245.375047,2098.240762
WB-H9,6750,2667,143177601.6,273,9051,8778,5429.261717,2479.168635
WB-S1,6750,2668,143231286.5,-448,9919,10367,5954.348951,2683.999519
WB-S10,6750,2665,143070231.8,-1058,9508,10566,4021.503565,2615.629177
WB-S11,6750,2670,143338656.3,377,8145,7768,5123.951311,2410.821597
WB-S12,6750,2668,143231286.5,377,9919,9542,4754.604198,2405.728988
WB-S13,6750,2670,143338656.3,882,9046,8164,5678.352434,2287.018028
WB-S14,6750,2674,143553395.9,1400,8865,7465,6945.928571,1426.675605
WB-S15,6750,2675,143607080.7,1276,8465,7189,6235.557757,1834.378022
WB-S16,6750,2668,143231286.5,222,9560,9338,5697.279235,2381.529296
WB-S17,6750,2665,143070231.8,890,8640,7750,7017.623265,1391.291359
WB-S18,6750,2666,143123916.7,651,9203,8552,6178.963241,2315.872748
WB-S19,6750,2669,143284971.4,1249,8597,7348,6537.916073,1807.944717
WB-S2,6750,2669,143284971.4,-1438,9985,11423,3902.647059,3520.954996
WB-S20,6750,2669,143284971.4,1249,9107,7858,7296.943425,1430.295976
WB-S21,6750,2669,143284971.4,1893,8411,6518,7139.555264,1136.910481
WB-S22,6750,2670,143338656.3,2474,8694,6220,7313.802622,802.3393234
WB-S23,6750,2666,143123916.7,290,9266,8976,6441.533008,1905.496606
WB-S24,6750,2667,143177601.6,273,9051,8778,5231.857893,2339.525238
WB-S25,6750,2666,143123916.7,1457,8962,7505,7025.187547,1539.276798
WB-S26,6750,2669,143284971.4,1406,9004,7598,7530.127014,1486.280287
WB-S27,6750,2668,143231286.5,1427,8958,7531,7708.849325,928.0388976
WB-S28,6750,2665,143070231.8,904,8861,7957,7370.197373,1401.27028
WB-S29,6750,2665,143070231.8,1374,9712,8338,7315.37561,1125.287256
WB-S3,6750,2668,143231286.5,-320,9934,10254,5424.669415,2356.653135
WB-S4,6750,2667,143177601.6,209,8830,8621,4221.886014,2510.229473
WB-S5,6750,2671,143392341.2,224,8990,8766,5967.292774,2309.455132
WB-S6,6750,2670,143338656.3,1230,8831,7601,5920.29176,2157.691009
WB-S7,6750,2674,143553395.9,1307,9137,7830,6566.081526,1834.344272
WB-S8,6750,2667,143177601.6,-93,8803,8896,6698.740532,2024.432616
WB-S9,6750,2668,143231286.5,-919,9979,10898,4670.393178,2636.374231
WB-W1,6750,2670,143338656.3,680,8733,8053,6189.270037,1871.703948
WB-W10,6750,2669,143284971.4,-320,9934,10254,5351.447733,2296.624244
WB-W2,6750,2667,143177601.6,802,9377,8575,7353.602925,1274.634737
WB-W3,6750,2667,143177601.6,775,9712,8937,6925.070116,1506.553951
WB-W4,6750,2667,143177601.6,-9,8843,8852,6119.055118,1839.684356
WB-W5,6750,2674,143553395.9,1415,8627,7212,7156.405385,1471.134302
WB-W6,6750,2666,143123916.7,1542,8668,7126,7266.922356,1458.826926
WB-W7,6750,2667,143177601.6,-448,9919,10367,5503.885264,2861.648232
WB-W8,6750,2669,143284971.4,890,8627,7737,7094.857999,1215.891049
WB-W9,6750,2669,143284971.4,1227,9877,8650,6444.348445,1918.447838
W01,7000,2866,153860894.7,313,9911,9598,6941.424983,2031.41717
W02,7000,2865,153807209.8,714,9008,8294,7340.253403,1465.943704
W03,7000,2873,154236689,775,8768,7993,7093.451444,1632.809591
W04,7000,2866,153860894.7,1195,8875,7680,7457.894278,1285.609701
W05,7000,2866,153860894.7,802,9958,9156,7223.636776,1540.633994
W06,7000,2868,153968264.5,904,9428,8524,7310.142608,1370.036774
W07,7000,2868,153968264.5,775,9712,8937,6826.464435,1616.550576
W08,7000,2868,153968264.5,1374,9712,8338,6973.603905,1695.203216
W09,7000,2870,154075634.3,1374,9712,8338,7108.547038,1447.968999
W10,7000,2865,153807209.8,1356,8688,7332,6626.645026,1929.361853
W11,7000,2869,154021949.4,680,8733,8053,6186.626002,1848.10673
W12,7000,2869,154021949.4,273,9667,9394,5760.613106,2237.890748
W13,7000,2864,153753525,587,9712,9125,6088.324721,2092.515287
W14,7000,2874,154290373.9,587,9712,9125,6410.116562,2139.664919
W15,7000,2869,154021949.4,1058,8962,7904,6792.775183,1829.916019
W16,7000,2865,153807209.8,-240,9874,10114,6388.324607,2410.751702
W17,7000,2870,154075634.3,-11,9834,9845,6624.383275,2256.639171
W18,7000,2871,154129319.2,-11,8953,8964,6684.370254,1930.409617
W19,7000,2867,153914579.6,-93,9268,9361,6327.117893,2223.821255
W20,7000,2864,153753525,-919,9979,10898,6384.07507,1989.108778
W21,7000,2872,154183004.1,-11,8953,8964,6443.147981,2086.540583
W22,7000,2862,153646155.2,-919,9979,10898,4841.930119,2659.744364
W23,7000,2869,154021949.4,-919,9979,10898,6051.333217,1924.846931
W24,7000,2866,153860894.7,222,9560,9338,5779.140963,2312.946605
W25,7000,2867,153914579.6,222,8843,8621,6113.673526,1975.821602
W26,7000,2871,154129319.2,-1058,8764,9822,4692.58342,2590.029681
W27,7000,2870,154075634.3,204,8843,8639,6136.632753,2073.654374
W28,7000,2874,154290373.9,262,9012,8750,6484.979819,1961.960097
W29,7000,2870,154075634.3,852,9012,8160,6517.705923,1892.45217
W30,7000,2872,154183004.1,890,8627,7737,7094.762883,1195.090848
W31,7000,2868,153968264.5,1427,8958,7531,7865.147141,645.3644381
W32,7000,2871,154129319.2,1406,9001,7595,7624.083595,1332.538154
W33,7000,2869,154021949.4,1109,9158,8049,7236.35901,1630.424423
W34,7000,2873,154236689,651,9203,8552,6307.803341,2167.880318
W35,7000,2872,154183004.1,1427,8958,7531,7032.730153,1588.977785
W36,7000,2873,154236689,1249,9401,8152,6646.926906,1858.027756
W37,7000,2869,154021949.4,1136,9677,8541,6830.417219,1837.327262
W38,7000,2876,154397743.6,1525,8909,7384,7661.360223,772.2461524
W39,7000,2867,153914579.6,1893,8909,7016,7264.100453,1040.047133
W40,7000,2869,154021949.4,882,9046,8164,6313.347856,2110.006945
W41,7000,2872,154183004.1,1196,9046,7850,6447.852019,1824.379003
W42,7000,2874,154290373.9,1893,9046,7153,7256.558107,1107.877687
W43,7000,2868,153968264.5,2474,8411,5937,7370.298466,846.6252822
W44,7000,2874,154290373.9,1400,8736,7336,6721.261656,1520.566632
W45,7000,2872,154183004.1,1400,8865,7465,6602.904944,1625.042836
W46,7000,2875,154344058.7,1276,8465,7189,6130.648348,1882.469305
W47,7000,2874,154290373.9,1276,8465,7189,6264.392484,1969.14686
W48,7000,2878,154505113.4,1398,8848,7450,7220.078527,1236.905421
W49,7000,2868,153968264.5,1398,8985,7587,6302.396095,1831.069949
W50,7000,2878,154505113.4,1664,9463,7799,6860.096595,1508.618311
W51,7000,2873,154236689,1318,9463,8145,6601.824922,1822.123231
W52,7000,2878,154505113.4,1406,8484,7078,6044.664003,1879.264907
W53,7000,2874,154290373.9,1307,8865,7558,6335.57968,1912.08097
W54,7000,2873,154236689,1059,8729,7670,5684.669335,2074.252145
W55,7000,2867,153914579.6,1007,9503,8496,6345.677014,2113.6464
W56,7000,2871,154129319.2,1136,9919,8783,6060.091606,2122.702692
W57,7000,2871,154129319.2,1259,8990,7731,5577.141414,2222.465592
W58,7000,2864,153753525,803,8990,8187,6029.239525,2163.426664
W59,7000,2868,153968264.5,377,9919,9542,4634.69212,2453.219971
W60,7000,2870,154075634.3,552,9203,8651,6474.905923,1943.964643
W61,7000,2868,153968264.5,651,9021,8370,6635.888424,1912.879169
W62,7000,2875,154344058.8,-1058,8640,9698,5225.086609,2595.245249
W63,7000,2870,154075634.3,-1058,9508,10566,4442.717073,2555.213285
W64,7000,2874,154290373.9,264,9000,8736,5325.56437,2368.041742
W65,7000,2866,153860894.7,-35,8109,8144,4362.827285,2367.357911
W66,7000,2869,154021949.4,-35,9000,9035,4170.032067,2447.614232
WB-E1,7000,2865,153807209.9,273,9560,9287,4687.193717,2540.315192
WB-E10,7000,2870,154075634.3,377,9020,8643,4326.715679,2339.876434
WB-E2,7000,2871,154129319.2,675,8536,7861,5902.563218,2195.390607
WB-E3,7000,2869,154021949.4,1648,8949,7301,7354.725688,552.6139548
WB-E4,7000,2876,154397743.6,1542,8668,7126,7384.811892,1336.563728
WB-E5,7000,2866,153860894.7,273,9726,9453,5238.448011,2470.915815
WB-E6,7000,2876,154397743.6,2474,8411,5937,7356.832058,815.9732689
WB-E7,7000,2872,154183004.1,37,8843,8806,5629.387187,2324.788284
WB-E8,7000,2867,153914579.6,882,8990,8108,5606.019184,2241.970781
WB-E9,7000,2875,154344058.8,224,8956,8732,5563.800348,2208.886509
WB-H1,7000,2873,154236689,1276,8465,7189,6556.63418,1761.330121
WB-H10,7000,2875,154344058.7,1276,8865,7589,5908.811478,1976.991431
WB-H2,7000,2863,153699840.1,1447,8793,7346,6853.76598,1900.210658
WB-H3,7000,2870,154075634.3,651,9203,8552,6242.887108,2289.476585
WB-H4,7000,2874,154290373.9,1230,8865,7635,6190.881698,2053.622685
WB-H5,7000,2873,154236689,882,9046,8164,5947.732684,2150.705148
WB-H6,7000,2871,154129319.2,-410,9958,10368,6319.653083,2595.344502
WB-H7,7000,2865,153807209.8,-240,9987,10227,6514.823735,2320.692052
WB-H8,7000,2875,154344058.7,1059,8956,7897,6139.29913,2139.887282
WB-H9,7000,2874,154290373.9,273,9051,8778,5466.324287,2466.446649
WB-S1,7000,2871,154129319.2,-448,9919,10367,6059.064089,2643.5688
WB-S10,7000,2869,154021949.4,-1058,9508,10566,4011.718717,2624.511753
WB-S11,7000,2870,154075634.3,377,8145,7768,5138.285714,2410.095473
WB-S12,7000,2866,153860894.7,377,9919,9542,4838.168528,2402.937345
WB-S13,7000,2868,153968264.5,882,9046,8164,5709.247211,2273.478266
WB-S14,7000,2870,154075634.3,1400,8865,7465,6925.414286,1445.039397
WB-S15,7000,2876,154397743.6,1276,8465,7189,6217.922114,1849.078525
WB-S16,7000,2867,153914579.6,222,9560,9338,5749.411231,2356.33073
WB-S17,7000,2866,153860894.7,890,8640,7750,7012.876832,1413.273718
WB-S18,7000,2871,154129319.2,651,9203,8552,6164.832114,2308.48766
WB-S19,7000,2869,154021949.4,1249,9401,8152,6554.984664,1797.880767
WB-S2,7000,2864,153753525,-1438,9985,11423,3945.73324,3528.51557
WB-S20,7000,2874,154290373.9,1249,9107,7858,7278.005915,1448.372112
WB-S21,7000,2873,154236689,1893,8411,6518,7163.287156,1108.240664
WB-S22,7000,2872,154183004.1,2474,8694,6220,7301.295961,835.2442812
WB-S23,7000,2868,153968264.5,290,9266,8976,6435.117503,1921.264896
WB-S24,7000,2873,154236689,273,9051,8778,5311.218587,2316.428549
WB-S25,7000,2872,154183004.1,1180,8962,7782,6986.560585,1589.009998
WB-S26,7000,2868,153968264.5,1406,9004,7598,7485.265342,1523.443811
WB-S27,7000,2866,153860894.7,1427,8958,7531,7699.611305,966.5561925
WB-S28,7000,2867,153914579.6,904,8875,7971,7314.505058,1458.414692
WB-S29,7000,2865,153807209.8,1374,9712,8338,7305.660035,1139.358381
WB-S3,7000,2872,154183004.1,-320,9934,10254,5389.854109,2380.242286
WB-S4,7000,2872,154183004.1,209,8830,8621,4174.472493,2496.365301
WB-S5,7000,2869,154021949.4,224,8990,8766,5938.085744,2311.424501
WB-S6,7000,2871,154129319.2,1230,8831,7601,5936.0721,2158.116919
WB-S7,7000,2875,154344058.7,1307,9463,8156,6533.61113,1858.805096
WB-S8,7000,2873,154236689,-93,9233,9326,6663.410024,2049.417384
WB-S9,7000,2866,153860894.7,-919,9979,10898,4674.624913,2642.23299
WB-W1,7000,2873,154236689,680,8733,8053,6225.39993,1845.924317
WB-W10,7000,2874,154290373.9,-320,9934,10254,5332.307237,2307.174938
WB-W2,7000,2867,153914579.6,802,9891,9089,7343.085106,1320.26798
WB-W3,7000,2869,154021949.4,775,9712,8937,6924.217497,1515.963474
WB-W4,7000,2865,153807209.9,-9,8843,8852,6097.98185,1875.769673
WB-W5,7000,2868,153968264.5,1415,8702,7287,7118.7106,1506.509582
WB-W6,7000,2868,153968264.5,1542,8668,7126,7284.934798,1432.109485
WB-W7,7000,2869,154021949.4,-448,9919,10367,5465.277797,2863.001369
WB-W8,7000,2868,153968264.5,890,8627,7737,7073.41841,1284.774684
WB-W9,7000,2871,154129319.2,1227,9877,8650,6427.955068,1939.164683
W01,7250,3084,165564200.8,313,9911,9598,6950.162776,2024.853365
W02,7250,3076,165134721.6,313,9008,8695,7298.800715,1525.961385
W03,7250,3071,164866297.2,775,8768,7993,7108.834582,1610.994629
W04,7250,3077,165188406.5,1195,8875,7680,7382.535912,1374.218456
W05,7250,3076,165134721.6,802,9958,9156,7231.774707,1541.273327
W06,7250,3079,165295776.3,904,9428,8524,7269.392335,1431.738523
W07,7250,3076,165134721.6,775,9712,8937,6848.293888,1605.017985
W08,7250,3082,165456831,1374,9712,8338,6966.216418,1712.274201
W09,7250,3084,165564200.8,1374,9712,8338,7093.661154,1443.299819
W10,7250,3078,165242091.4,1356,8688,7332,6613.401235,1936.480303
W11,7250,3085,165617885.6,680,8733,8053,6218.155267,1832.401048
W12,7250,3076,165134721.6,273,9743,9470,5726.043888,2279.895145
W13,7250,3080,165349461.2,587,9712,9125,6091.147078,2097.284102
W14,7250,3078,165242091.4,587,9712,9125,6413.619233,2136.322741
W15,7250,3084,165564200.8,962,8962,8000,6761.5869,1857.115291
W16,7250,3081,165403146.1,-240,9874,10114,6329.315807,2438.173239
W17,7250,3076,165134721.6,-11,9834,9845,6604.236671,2262.234391
W18,7250,3071,164866297.2,-11,8953,8964,6656.312276,1942.074902
W19,7250,3071,164866297.2,-93,9277,9370,6328.737219,2218.713836
W20,7250,3074,165027351.9,-919,9979,10898,6351.596617,2010.150393
W21,7250,3076,165134721.6,-11,9100,9111,6454.81762,2061.973787
W22,7250,3076,165134721.6,-919,9979,10898,4862.924577,2677.881201
W23,7250,3075,165081036.7,-919,9979,10898,6019.499837,1975.46373
W24,7250,3081,165403146.1,222,9560,9338,5804.142486,2298.006744
W25,7250,3072,164919982.1,222,8843,8621,6084.216146,1987.712828
W26,7250,3071,164866297.2,-1058,8764,9822,4718.4028,2586.119218
W27,7250,3083,165510515.9,204,8843,8639,6082.11904,2116.738187
W28,7250,3077,165188406.5,262,9012,8750,6484.368541,1941.083419
W29,7250,3075,165081036.7,852,9012,8160,6519.511545,1887.503406
W30,7250,3080,165349461.2,890,8627,7737,7076.088636,1224.231684
W31,7250,3075,165081036.7,1427,8958,7531,7851.216585,681.6176841
W32,7250,3090,165886310.1,1406,9001,7595,7571.257282,1402.897664
W33,7250,3081,165403146.1,1109,9158,8049,7225.426485,1627.565141
W34,7250,3087,165725255.4,651,9203,8552,6277.836087,2185.570576
W35,7250,3087,165725255.4,1427,8958,7531,7021.890833,1628.090929
W36,7250,3088,165778940.3,1249,9401,8152,6664.232513,1850.43888
W37,7250,3077,165188406.5,1136,9677,8541,6847.823529,1813.758305
W38,7250,3088,165778940.3,1525,8909,7384,7630.830311,823.1434789
W39,7250,3078,165242091.4,1893,8909,7016,7269.584795,1037.030218
W40,7250,3082,165456831,882,9046,8164,6294.031798,2113.733645
W41,7250,3078,165242091.4,1196,9046,7850,6411.763483,1866.332476
W42,7250,3078,165242091.4,1585,9046,7461,7240.275179,1120.217178
W43,7250,3076,165134721.6,2474,8411,5937,7350.295839,876.691913
W44,7250,3080,165349461.2,1400,8736,7336,6708.038312,1523.630291
W45,7250,3078,165242091.4,1400,8865,7465,6606.508122,1622.391734
W46,7250,3085,165617885.6,1276,8465,7189,6131.054457,1887.670589
W47,7250,3081,165403146.1,1276,8465,7189,6253.852321,1987.482304
W48,7250,3079,165295776.3,1398,8848,7450,7218.097109,1225.686658
W49,7250,3079,165295776.3,1398,8985,7587,6349.348815,1816.649454
W50,7250,3078,165242091.4,1664,9463,7799,6836.384016,1538.944839
W51,7250,3085,165617885.6,1318,9463,8145,6557.596759,1855.397752
W52,7250,3079,165295776.3,1406,8484,7078,6083.097109,1861.78144
W53,7250,3080,165349461.2,1307,8865,7558,6295.299351,1943.602981
W54,7250,3089,165832625.2,1059,8956,7897,5660.700874,2079.881604
W55,7250,3079,165295776.3,1007,9503,8496,6320.738227,2127.974218
W56,7250,3084,165564200.8,1136,9919,8783,6031.651427,2131.98059
W57,7250,3082,165456831,1259,8990,7731,5543.18462,2238.558201
W58,7250,3080,165349461.2,781,8990,8209,5964.142857,2193.958918
W59,7250,3077,165188406.5,377,9919,9542,4708.917127,2455.155693
W60,7250,3075,165081036.7,552,9203,8651,6430.926829,1997.804919
W61,7250,3081,165403146.1,651,9021,8370,6663.610841,1887.540531
W62,7250,3076,165134721.6,-1058,8640,9698,5262.493173,2588.21039
W63,7250,3084,165564200.8,-1058,9508,10566,4508.799287,2547.266779
W64,7250,3086,165671570.5,264,9000,8736,5275.975697,2385.252038
W65,7250,3074,165027351.9,-35,8322,8357,4407.096942,2363.419169
W66,7250,3081,165403146.1,-35,9000,9035,4259.811425,2474.800974
WB-E1,7250,3071,164866297.2,222,9560,9338,4791.72973,2555.759824
WB-E10,7250,3079,165295776.3,377,9020,8643,4358.077947,2345.721422
WB-E2,7250,3075,165081036.7,552,8536,7984,5860.56878,2233.114814
WB-E3,7250,3080,165349461.2,1616,8949,7333,7340.898701,592.6081211
WB-E4,7250,3077,165188406.5,1542,8668,7126,7371.549886,1332.288057
WB-E5,7250,3072,164919982.1,273,9849,9576,5318.111654,2458.458649
WB-E6,7250,3082,165456831,2474,8411,5937,7367.49708,801.5484873
WB-E7,7250,3070,164812612.3,5,8843,8838,5632.523779,2338.804663
WB-E8,7250,3073,164973667,882,8990,8108,5621.819395,2234.364628
WB-E9,7250,3080,165349461.2,224,8956,8732,5573.47987,2197.583934
WB-H1,7250,3090,165886310.1,1276,8465,7189,6509.18479,1806.016817
WB-H10,7250,3084,165564200.8,1276,8865,7589,5969.291505,1967.684585
WB-H2,7250,3075,165081036.7,1447,8793,7346,6885.532033,1863.834368
WB-H3,7250,3087,165725255.4,651,9203,8552,6318.333333,2264.53429
WB-H4,7250,3076,165134721.6,1230,8865,7635,6210.784135,2034.725353
WB-H5,7250,3075,165081036.7,882,9046,8164,5989.538211,2146.539656
WB-H6,7250,3076,165134721.6,-410,9958,10368,6374.842653,2565.750866
WB-H7,7250,3077,165188406.5,-240,9987,10227,6543.242444,2314.989713
WB-H8,7250,3087,165725255.4,224,8956,8732,6027.784904,2193.161658
WB-H9,7250,3073,164973667,273,9051,8778,5489.795965,2453.309211
WB-S1,7250,3086,165671570.5,-448,9919,10367,6150.2372,2600.959066
WB-S10,7250,3084,165564200.8,-1058,9508,10566,3999.529183,2638.232757
WB-S11,7250,3082,165456831,377,8312,7935,5162.710253,2412.457499
WB-S12,7250,3075,165081036.7,377,9919,9542,4913.557724,2396.611595
WB-S13,7250,3074,165027351.9,882,9046,8164,5754.873455,2257.060166
WB-S14,7250,3081,165403146.1,1400,8865,7465,6902.638429,1460.097357
WB-S15,7250,3091,165939995,1276,8465,7189,6217.180848,1852.24123
WB-S16,7250,3072,164919982.1,222,9560,9338,5782.149089,2333.86794
WB-S17,7250,3077,165188406.5,890,8640,7750,7002.80013,1437.84235
WB-S18,7250,3074,165027351.9,651,9203,8552,6176.194209,2289.920603
WB-S19,7250,3077,165188406.5,1249,9401,8152,6572.420214,1788.831994
WB-S2,7250,3077,165188406.5,-1438,9985,11423,3978.546311,3529.778668
WB-S20,7250,3074,165027351.9,1136,9107,7971,7250.196812,1483.42903
WB-S21,7250,3090,165886310.1,1893,8411,6518,7185.647896,1079.293447
WB-S22,7250,3081,165403146.1,2474,8694,6220,7295.095748,846.2305576
WB-S23,7250,3077,165188406.5,290,9266,8976,6426.245694,1934.273529
WB-S24,7250,3075,165081036.7,273,9051,8778,5383.84,2289.659466
WB-S25,7250,3072,164919982.1,1180,8962,7782,6953.710612,1621.798504
WB-S26,7250,3075,165081036.7,1406,9004,7598,7448.057886,1556.528597
WB-S27,7250,3074,165027351.9,1427,8958,7531,7693.622316,987.8048326
WB-S28,7250,3083,165510515.9,879,8875,7996,7256.164775,1519.558942
WB-S29,7250,3081,165403146.1,1374,9712,8338,7292.84875,1169.980222
WB-S3,7250,3086,165671570.5,-320,9934,10254,5336.172715,2409.589845
WB-S4,7250,3077,165188406.5,209,8830,8621,4129.38544,2473.830434
WB-S5,7250,3078,165242091.4,224,8990,8766,5900.051982,2311.47728
WB-S6,7250,3077,165188406.5,1230,8831,7601,5937.882353,2160.155157
WB-S7,7250,3085,165617885.6,1307,9463,8156,6491.553971,1887.268618
WB-S8,7250,3077,165188406.5,-93,9233,9326,6638.470588,2059.976747
WB-S9,7250,3072,164919982.1,-919,9979,10898,4706.530273,2640.737798
WB-W1,7250,3083,165510515.9,680,8733,8053,6253.632176,1825.574265
WB-W10,7250,3078,165242091.4,-320,9934,10254,5307.792398,2324.268713
WB-W2,7250,3081,165403146.1,802,9958,9156,7326.202532,1362.589524
WB-W3,7250,3075,165081036.7,775,9712,8937,6927.759024,1521.159107
WB-W4,7250,3070,164812612.3,-867,8843,9710,6050.621824,1941.215039
WB-W5,7250,3077,165188406.5,1356,8702,7346,7080.964576,1550.82209
WB-W6,7250,3074,165027351.9,1542,8668,7126,7298.353286,1410.780255
WB-W7,7250,3082,165456831,-448,9919,10367,5436.347502,2863.292464
WB-W8,7250,3082,165456831,890,8627,7737,7058.204737,1344.877512
WB-W9,7250,3075,165081036.7,1177,9877,8700,6407.269268,1957.083674
W01,7500,3294,176838027.7,313,9911,9598,6953.197936,2023.936146
W02,7500,3296,176945397.4,313,9008,8695,7253.506371,1582.270409
W03,7500,3298,177052767.2,775,8768,7993,7112.581565,1591.944005
W04,7500,3280,176086439.2,1195,8875,7680,7322.496951,1441.648696
W05,7500,3297,176999082.3,688,9958,9270,7228.227783,1552.493738
W06,7500,3295,176891712.5,775,9428,8653,7244.318058,1468.883061
W07,7500,3295,176891712.6,775,9712,8937,6873.177845,1594.092464
W08,7500,3296,176945397.4,1374,9712,8338,6959.967536,1722.343123
W09,7500,3294,176838027.7,1374,9712,8338,7097.197328,1435.812419
W10,7500,3295,176891712.5,1356,8688,7332,6627.228528,1936.657074
W11,7500,3297,176999082.3,680,8733,8053,6239.798605,1829.517361
W12,7500,3295,176891712.6,273,9798,9525,5702.215781,2307.892304
W13,7500,3282,176193809,587,9712,9125,6094.372943,2097.551746
W14,7500,3293,176784342.8,587,9712,9125,6425.244762,2117.407475
W15,7500,3294,176838027.7,636,8962,8326,6729.074074,1877.443987
W16,7500,3294,176838027.7,-240,9874,10114,6299.649059,2448.139476
W17,7500,3299,177106452.1,-11,9834,9845,6576.325553,2282.784509
W18,7500,3297,176999082.3,-11,8953,8964,6613.33576,1976.966103
W19,7500,3291,176676973,-919,9979,10898,6315.702826,2254.769137
W20,7500,3282,176193809,-919,9979,10898,6319.56947,2040.450311
W21,7500,3295,176891712.6,-11,9100,9111,6475.034294,2030.120019
W22,7500,3282,176193809,-919,9979,10898,4883.169714,2692.28325
W23,7500,3295,176891712.5,-919,9979,10898,5973.970258,2030.522068
W24,7500,3296,176945397.4,222,9560,9338,5825.096177,2287.938586
W25,7500,3289,176569603.2,222,8843,8621,6068.153238,2001.413593
W26,7500,3297,176999082.3,-1058,8764,9822,4751.55505,2582.925698
W27,7500,3298,177052767.2,120,8843,8723,6035.240752,2148.168264
W28,7500,3294,176838027.7,262,9012,8750,6482.951123,1927.231437
W29,7500,3297,176999082.3,852,9012,8160,6517.156506,1884.160473
W30,7500,3296,176945397.4,890,8665,7775,7052.732706,1255.491526
W31,7500,3295,176891712.5,1427,8958,7531,7843.952656,695.5276729
W32,7500,3300,177160137,1406,9001,7595,7544.818182,1426.758332
W33,7500,3297,176999082.3,1109,9158,8049,7219.227176,1615.041376
W34,7500,3301,177213821.9,651,9203,8552,6247.760376,2195.494839
W35,7500,3300,177160137,1383,8958,7575,7024.341212,1646.257479
W36,7500,3298,177052767.2,1249,9677,8428,6695.39812,1834.558177
W37,7500,3296,176945397.4,1136,9677,8541,6867.165352,1793.221802
W38,7500,3300,177160137,1335,8909,7574,7596.252424,882.818052
W39,7500,3289,176569603.2,1893,8909,7016,7278.465491,1033.227029
W40,7500,3298,177052767.2,882,9046,8164,6287.969375,2113.650312
W41,7500,3298,177052767.2,882,9046,8164,6399.808065,1893.321208
W42,7500,3297,176999082.3,1335,9046,7711,7223.984531,1137.993926
W43,7500,3296,176945397.4,2474,8411,5937,7340.03125,884.7076707
W44,7500,3302,177267506.8,1400,8736,7336,6700.015142,1519.463299
W45,7500,3301,177213821.9,1400,8865,7465,6604.794608,1626.502569
W46,7500,3300,177160137,1276,8465,7189,6140.714545,1887.887001
W47,7500,3301,177213821.9,1276,8543,7267,6260.785217,1985.991057
W48,7500,3303,177321191.7,1398,8848,7450,7219.349985,1214.400004
W49,7500,3289,176569603.2,1398,8985,7587,6394.288842,1801.324942
W50,7500,3300,177160137,1664,9463,7799,6815.157576,1572.3225
W51,7500,3301,177213821.9,1307,9463,8156,6510.343532,1898.716131
W52,7500,3300,177160137,1406,8484,7078,6116.409394,1841.902519
W53,7500,3301,177213821.9,1307,8865,7558,6273.173887,1953.600232
W54,7500,3302,177267506.8,1059,8956,7897,5648.692913,2074.336952
W55,7500,3283,176247493.9,1007,9677,8670,6293.993908,2138.84461
W56,7500,3297,176999082.3,1136,9919,8783,5995.724295,2144.967449
W57,7500,3299,177106452.1,1200,9919,8719,5498.790543,2266.613107
W58,7500,3282,176193809,209,8990,8781,5901.958867,2229.246372
W59,7500,3290,176623288.1,377,9919,9542,4787.482371,2447.010916
W60,7500,3293,176784342.8,552,9203,8651,6386.664136,2052.12834
W61,7500,3299,177106452.1,651,9203,8552,6689.588966,1861.813286
W62,7500,3298,177052767.2,-1058,8711,9769,5313.956944,2578.940366
W63,7500,3296,176945397.4,-1058,9508,10566,4561.570085,2544.593652
W64,7500,3300,177160137,-35,9000,9035,5236.695758,2397.17259
W65,7500,3287,176462233.4,-35,9000,9035,4448.034378,2360.466363
W66,7500,3298,177052767.2,-35,9000,9035,4336.919648,2492.202099
WB-E1,7500,3288,176515918.3,222,9606,9384,4896.603406,2560.676596
WB-E10,7500,3297,176999082.3,377,9020,8643,4379.119199,2356.636993
WB-E2,7500,3296,176945397.4,552,8536,7984,5826.2946,2254.053718
WB-E3,7500,3299,177106452.1,1616,8949,7333,7315.473477,663.9541184
WB-E4,7500,3294,176838027.7,1542,8668,7126,7364.03643,1320.311805
WB-E5,7500,3286,176408548.5,273,9917,9644,5362.949483,2439.27907
WB-E6,7500,3302,177267506.8,2474,8411,5937,7375.473047,794.2855166
WB-E7,7500,3297,176999082.3,-100,8843,8943,5642.592963,2351.880818
WB-E8,7500,3296,176945397.4,882,9919,9037,5641.944782,2229.351982
WB-E9,7500,3282,176193809,224,8956,8732,5572.885436,2192.764225
WB-H1,7500,3304,177374876.6,1276,8465,7189,6475.042676,1830.235999
WB-H10,7500,3297,176999082.3,1276,8865,7589,6027.600546,1956.098699
WB-H2,7500,3283,176247493.9,1447,8807,7360,6908.107828,1830.199907
WB-H3,7500,3296,176945397.4,651,9203,8552,6387.855886,2237.883546
WB-H4,7500,3300,177160137,1230,8865,7635,6218.667879,2017.579245
WB-H5,7500,3300,177160137,882,9046,8164,6011.690606,2146.440604
WB-H6,7500,3293,176784342.8,-410,9958,10368,6410.312177,2549.894537
WB-H7,7500,3293,176784342.8,-240,9987,10227,6582.271181,2303.394941
WB-H8,7500,3297,176999082.3,224,8956,8732,5935.763118,2233.406217
WB-H9,7500,3296,176945397.4,273,9051,8778,5528.220267,2436.170355
WB-S1,7500,3295,176891712.5,-448,9919,10367,6216.288012,2563.976902
WB-S10,7500,3295,176891712.5,-1058,9508,10566,3974.794841,2654.287015
WB-S11,7500,3296,176945397.4,377,8663,8286,5177.192658,2413.512072
WB-S12,7500,3286,176408548.5,377,9919,9542,4945.226111,2392.995108
WB-S13,7500,3289,176569603.2,882,9046,8164,5815.73913,2233.066227
WB-S14,7500,3280,176086439.2,1400,8865,7465,6873.235061,1479.042996
WB-S15,7500,3301,177213821.9,1276,8465,7189,6207.306574,1865.088442
WB-S16,7500,3286,176408548.5,222,9560,9338,5806.621424,2322.91574
WB-S17,7500,3296,176945397.4,890,8640,7750,6981.806432,1472.328017
WB-S18,7500,3296,176945397.4,651,9203,8552,6192.577367,2273.302896
WB-S19,7500,3293,176784342.8,1249,9677,8428,6597.171272,1784.106291
WB-S2,7500,3284,176301178.8,-1438,9985,11423,4007.566991,3522.044324
WB-S20,7500,3302,177267506.8,1136,9107,7971,7218.826469,1517.657689
WB-S21,7500,3301,177213821.9,1893,8411,6518,7207.10724,1054.734778
WB-S22,7500,3300,177160137,2474,8694,6220,7291.060606,850.8416343
WB-S23,7500,3294,176838027.7,290,9266,8976,6434.041894,1948.825077
WB-S24,7500,3296,176945397.4,273,9051,8778,5446.367718,2266.488567
WB-S25,7500,3298,177052767.2,1058,8962,7904,6914.137356,1648.399149
WB-S26,7500,3296,176945397.4,1406,9158,7752,7410.209345,1595.96326
WB-S27,7500,3296,176945397.4,1427,8958,7531,7692.493932,992.3554818
WB-S28,7500,3293,176784342.8,775,8875,8100,7218.656848,1546.144783
WB-S29,7500,3297,176999082.3,1374,9712,8338,7272.289657,1208.773608
WB-S3,7500,3296,176945397.4,-320,9934,10254,5289.627124,2443.502263
WB-S4,7500,3300,177160137,209,8830,8621,4103.552424,2449.414187
WB-S5,7500,3288,176515918.3,224,8990,8766,5867.335766,2303.525743
WB-S6,7500,3297,176999082.3,1230,8831,7601,5949.03579,2151.37302
WB-S7,7500,3300,177160137,1307,9463,8156,6460.863636,1899.045196
WB-S8,7500,3294,176838027.7,-93,9310,9403,6633.91439,2051.421998
WB-S9,7500,3287,176462233.4,-919,9979,10898,4746.616368,2641.470687
WB-W1,7500,3299,177106452.1,680,8733,8053,6275.770233,1811.53146
WB-W10,7500,3296,176945397.4,-320,9934,10254,5271.831311,2342.000526
WB-W2,7500,3294,176838027.7,802,9958,9156,7306.986339,1396.14163
WB-W3,7500,3295,176891712.5,775,9712,8937,6926.396055,1526.460922
WB-W4,7500,3289,176569603.2,-867,9979,10846,6008.916996,1999.030074
WB-W5,7500,3280,176086439.2,1356,8750,7394,7053.965244,1588.039213
WB-W6,7500,3297,176999082.3,1542,8668,7126,7311.40825,1394.636535
WB-W7,7500,3295,176891712.6,-448,9919,10367,5439.71563,2856.526418
WB-W8,7500,3295,176891712.5,890,8627,7737,7042.362671,1399.464535
WB-W9,7500,3296,176945397.4,1177,9877,8700,6399.001214,1970.570803
W01,7750,3521,189024497.7,313,9911,9598,6962.784152,2016.138773
W02,7750,3517,188809758.1,313,9008,8695,7205.538527,1639.56274
W03,7750,3505,188165539.4,775,8828,8053,7119.872183,1568.12362
W04,7750,3513,188595018.6,879,8875,7996,7260.998861,1511.646695
W05,7750,3518,188863443,688,9958,9270,7214.352473,1564.422882
W06,7750,3520,188970812.8,775,9428,8653,7231.311648,1484.499793
W07,7750,3518,188863443,775,9712,8937,6898.210915,1580.133754
W08,7750,3519,188917127.9,1374,9712,8338,6954.809889,1731.311994
W09,7750,3522,189078182.6,1374,9712,8338,7103.907439,1430.69128
W10,7750,3519,188917127.9,1356,8688,7332,6636.149758,1939.429439
W11,7750,3520,188970812.8,680,8953,8273,6257.398011,1835.656608
W12,7750,3517,188809758.1,273,9849,9576,5693.379301,2318.770249
W13,7750,3515,188702388.3,273,9712,9439,6101.770128,2103.758018
W14,7750,3513,188595018.6,587,9712,9125,6441.152291,2092.606628
W15,7750,3520,188970812.8,636,8962,8326,6693.763352,1913.161415
W16,7750,3521,189024497.7,-240,9874,10114,6288.781028,2456.052967
W17,7750,3517,188809758.1,-11,9834,9845,6547.847597,2304.784685
W18,7750,3512,188541333.7,-11,9233,9244,6573.626708,2014.886638
W19,7750,3514,188648703.5,-919,9979,10898,6304.236767,2293.597501
W20,7750,3515,188702388.3,-919,9979,10898,6270.598578,2086.21233
W21,7750,3517,188809758.1,-11,9507,9518,6483.106056,2015.084897
W22,7750,3514,188648703.5,-919,9979,10898,4920.746443,2696.352571
W23,7750,3520,188970812.8,-919,9979,10898,5931.348011,2087.41479
W24,7750,3521,189024497.7,222,9560,9338,5845.628231,2271.148546
W25,7750,3516,188756073.2,222,9012,8790,6037.058589,2029.676319
W26,7750,3511,188487648.8,-1058,8764,9822,4785.749644,2577.000061
W27,7750,3524,189185552.4,120,8843,8723,5999.514188,2164.004094
W28,7750,3510,188433963.9,262,9012,8750,6475.197721,1920.310693
W29,7750,3515,188702388.3,852,9012,8160,6510.149644,1885.39801
W30,7750,3521,189024497.7,890,9012,8122,7022.152229,1311.220227
W31,7750,3518,188863443,1427,8958,7531,7831.832291,722.422831
W32,7750,3530,189507661.7,1406,9001,7595,7523.169688,1435.27245
W33,7750,3520,188970812.8,1109,9158,8049,7205.569034,1611.08161
W34,7750,3521,189024497.7,651,9203,8552,6225.099972,2201.723109
W35,7750,3529,189453976.8,1383,8958,7575,7028.689147,1655.027874
W36,7750,3529,189453976.8,1249,9677,8428,6724.442052,1821.32605
W37,7750,3514,188648703.5,1136,9677,8541,6883.912635,1781.039376
W38,7750,3527,189346607,1335,8909,7574,7560.770343,942.4392556
W39,7750,3520,188970812.8,1893,8909,7016,7287.071023,1025.662437
W40,7750,3521,189024497.7,882,9046,8164,6290.022721,2108.403197
W41,7750,3517,188809758.1,882,9046,8164,6378.324424,1918.987358
W42,7750,3519,188917127.9,1335,9046,7711,7195.92782,1169.774275
W43,7750,3517,188809758.1,2474,8411,5937,7329.798408,889.0935546
W44,7750,3518,188863443,1400,8736,7336,6697.83826,1512.836532
W45,7750,3526,189292922.1,1400,8865,7465,6612.442428,1618.714336
W46,7750,3523,189131867.5,1276,8465,7189,6170.18365,1876.083485
W47,7750,3522,189078182.6,1276,8543,7267,6266.156161,1981.288822
W48,7750,3522,189078182.6,1398,8848,7450,7218.13004,1210.331022
W49,7750,3522,189078182.6,1398,8985,7587,6437.459682,1790.626432
W50,7750,3519,188917127.9,1589,9463,7874,6776.947428,1619.302648
W51,7750,3521,189024497.7,1307,9463,8156,6456.890372,1941.83726
W52,7750,3516,188756073.2,1406,8484,7078,6149.115472,1827.744281
W53,7750,3520,188970812.8,1307,8865,7558,6263.925284,1956.703442
W54,7750,3523,189131867.5,1059,8956,7897,5652.59069,2060.164156
W55,7750,3517,188809758.1,1007,9677,8670,6259.116861,2150.714122
W56,7750,3523,189131867.5,1136,9919,8783,5953.646892,2153.619916
W57,7750,3521,189024497.7,1200,9919,8719,5446.00852,2293.809404
W58,7750,3519,188917127.9,209,8990,8781,5813.87468,2272.792877
W59,7750,3514,188648703.5,377,9919,9542,4869.674161,2441.992343
W60,7750,3514,188648703.5,552,9203,8651,6336.157655,2102.265686
W61,7750,3521,189024497.7,651,9203,8552,6709.39023,1841.301731
W62,7750,3507,188272909.2,-1058,8711,9769,5355.981751,2567.881637
W63,7750,3524,189185552.4,-1058,9508,10566,4606.656356,2542.404418
W64,7750,3525,189239237.2,-35,9000,9035,5193.388936,2410.452128
W65,7750,3519,188917127.9,-35,9000,9035,4487.396419,2356.773012
W66,7750,3520,188970812.8,-35,9000,9035,4389.108807,2505.812744
WB-E1,7750,3516,188756073.2,222,9667,9445,4997.486917,2559.488365
WB-E10,7750,3523,189131867.5,377,9020,8643,4398.248084,2358.132412
WB-E2,7750,3522,189078182.6,552,8536,7984,5791.447473,2275.799028
WB-E3,7750,3522,189078182.6,1507,8949,7442,7283.27314,759.3626907
WB-E4,7750,3517,188809758.1,1542,8668,7126,7360.090702,1307.384085
WB-E5,7750,3516,188756073.2,273,9983,9710,5370.467861,2444.123333
WB-E6,7750,3512,188541333.7,2474,8694,6220,7378.252278,792.5301976
WB-E7,7750,3511,188487648.8,-159,8843,9002,5664.291655,2357.133361
WB-E8,7750,3513,188595018.6,882,9919,9037,5662.588386,2223.673556
WB-E9,7750,3512,188541333.7,224,8956,8732,5581.59795,2189.089079
WB-H1,7750,3521,189024497.7,1276,8465,7189,6439.851747,1855.861368
WB-H10,7750,3523,189131867.5,1276,8865,7589,6083.003974,1942.729559
WB-H2,7750,3515,188702388.3,1374,8859,7485,6925.133997,1805.477267
WB-H3,7750,3527,189346607,651,9203,8552,6444.729515,2204.88487
WB-H4,7750,3516,188756073.2,1230,8865,7635,6237.28413,2003.977396
WB-H5,7750,3514,188648703.5,882,9046,8164,6041.186113,2141.964442
WB-H6,7750,3509,188380279,-410,9958,10368,6437.579367,2531.239019
WB-H7,7750,3515,188702388.3,-240,9987,10227,6598.365292,2297.421149
WB-H8,7750,3529,189453976.8,224,8990,8766,5857.688297,2260.580568
WB-H9,7750,3507,188272909.2,273,9051,8778,5572.925577,2424.23803
WB-S1,7750,3523,189131867.5,-448,9919,10367,6271.261993,2530.01196
WB-S10,7750,3524,189185552.4,-1058,9508,10566,3948.492906,2672.439412
WB-S11,7750,3518,188863443,377,8663,8286,5189.27942,2415.020328
WB-S12,7750,3514,188648703.5,377,9919,9542,4957.784007,2384.292177
WB-S13,7750,3520,188970812.8,882,9046,8164,5873.470739,2207.200322
WB-S14,7750,3514,188648703.5,1283,8865,7582,6823.575982,1519.513616
WB-S15,7750,3528,189400291.9,1276,8465,7189,6219.350624,1865.487454
WB-S16,7750,3516,188756073.2,222,9560,9338,5817.501138,2319.907415
WB-S17,7750,3518,188863443,890,8640,7750,6959.618818,1501.01683
WB-S18,7750,3515,188702388.3,651,9203,8552,6214.717781,2251.650919
WB-S19,7750,3514,188648703.5,1249,9677,8428,6624.524474,1778.457058
WB-S2,7750,3513,188595018.6,-1438,9985,11423,4024.338173,3503.410739
WB-S20,7750,3508,188326594.1,1136,9107,7971,7185.868016,1547.925403
WB-S21,7750,3530,189507661.7,1893,8411,6518,7225.743059,1028.732919
WB-S22,7750,3516,188756073.2,2474,8949,6475,7292.783561,844.6031717
WB-S23,7750,3514,188648703.5,290,9266,8976,6443.914912,1954.367569
WB-S24,7750,3507,188272909.2,273,9051,8778,5503.270887,2244.727452
WB-S25,7750,3513,188595018.6,1058,8962,7904,6876.674637,1683.94713
WB-S26,7750,3520,188970812.8,1395,9158,7763,7366.20625,1633.989788
WB-S27,7750,3516,188756073.2,1427,8958,7531,7689.117463,1001.117063
WB-S28,7750,3523,189131867.5,775,8875,8100,7183.373829,1576.325559
WB-S29,7750,3521,189024497.7,1374,9712,8338,7244.936098,1252.46127
WB-S3,7750,3527,189346607,-1422,9934,11356,5243.948398,2470.351632
WB-S4,7750,3510,188433963.9,209,8830,8621,4093.647293,2427.763969
WB-S5,7750,3518,188863443,224,8990,8766,5822.986924,2300.347181
WB-S6,7750,3515,188702388.3,1230,8831,7601,5962.950782,2146.684105
WB-S7,7750,3522,189078182.6,1307,9463,8156,6422.811471,1916.012725
WB-S8,7750,3506,188219224.3,-93,9310,9403,6627.316885,2050.600768
WB-S9,7750,3515,188702388.3,-919,9979,10898,4795.462873,2638.726014
WB-W1,7750,3523,189131867.5,680,8733,8053,6298.794209,1812.487375
WB-W10,7750,3510,188433963.9,-320,9934,10254,5242.32963,2362.517634
WB-W2,7750,3515,188702388.3,802,9958,9156,7289.480228,1420.649941
WB-W3,7750,3515,188702388.3,775,9712,8937,6933.742248,1531.175287
WB-W4,7750,3513,188595018.6,-867,9979,10846,5957.596356,2049.118406
WB-W5,7750,3510,188433963.9,1356,8962,7606,7035.625641,1621.927896
WB-W6,7750,3508,188326594.1,1496,8668,7172,7317.572691,1378.493304
WB-W7,7750,3524,189185552.4,-448,9919,10367,5452.65891,2853.571988
WB-W8,7750,3520,188970812.8,890,9004,8114,7025.605114,1447.29049
WB-W9,7750,3515,188702388.3,1177,9919,8742,6391.598578,1983.321619
W01,8000,3746,201103597.9,313,9911,9598,6966.35024,2011.196008
W02,8000,3746,201103597.9,313,9008,8695,7167.551255,1676.077484
W03,8000,3749,201264652.6,775,8861,8086,7122.021606,1549.292744
W04,8000,3734,200459379.3,879,8875,7996,7214.862882,1559.261564
W05,8000,3750,201318337.5,688,9958,9270,7198.001333,1577.570767
W06,8000,3749,201264652.6,775,9428,8653,7214.694318,1503.867728
W07,8000,3748,201210967.7,775,9712,8937,6919.536019,1566.811848
W08,8000,3747,201157282.8,1374,9712,8338,6946.121164,1747.191544
W09,8000,3746,201103597.9,1374,9712,8338,7111.986652,1429.898957
W10,8000,3746,201103597.9,1356,8688,7332,6646.971703,1935.771484
W11,8000,3748,201210967.7,680,9266,8586,6268.96905,1853.837716
W12,8000,3747,201157282.8,273,9983,9710,5702.234588,2327.127468
W13,8000,3737,200620433.9,273,9712,9439,6109.508162,2102.187404
W14,8000,3749,201264652.6,587,9712,9125,6458.467325,2067.894346
W15,8000,3747,201157282.8,587,8962,8375,6661.15479,1944.475778
W16,8000,3745,201049913.1,-240,9874,10114,6292.937784,2448.892519
W17,8000,3747,201157282.8,-11,9834,9845,6514.844676,2319.297785
W18,8000,3747,201157282.8,-11,9310,9321,6532.937817,2050.885182
W19,8000,3746,201103597.9,-919,9979,10898,6297.139883,2316.205005
W20,8000,3739,200727803.7,-919,9979,10898,6231.913881,2124.527041
W21,8000,3747,201157282.8,-11,9507,9518,6497.28316,2000.429659
W22,8000,3739,200727803.7,-919,9979,10898,4942.046002,2701.315063
W23,8000,3749,201264652.6,-919,9979,10898,5882.547346,2154.233882
W24,8000,3748,201210967.7,222,9917,9695,5860.85539,2263.529664
W25,8000,3747,201157282.8,222,9012,8790,6020.85028,2045.571182
W26,8000,3748,201210967.7,-1058,8764,9822,4824.32524,2570.898619
W27,8000,3749,201264652.6,120,8843,8723,5972.627634,2178.608297
W28,8000,3749,201264652.6,262,9012,8750,6456.94932,1917.560261
W29,8000,3751,201372022.4,852,9012,8160,6500.837377,1893.258673
W30,8000,3750,201318337.5,890,9012,8122,6979.862133,1383.426511
W31,8000,3746,201103597.9,1427,8958,7531,7823.73732,728.6523159
W32,8000,3748,201210967.7,1406,9001,7595,7506.624333,1444.072896
W33,8000,3751,201372022.4,1109,9158,8049,7202.01173,1597.822116
W34,8000,3748,201210967.7,651,9203,8552,6213.897812,2214.608998
W35,8000,3749,201264652.6,1383,8958,7575,7047.571886,1647.752409
W36,8000,3748,201210967.7,1249,9677,8428,6752.843383,1808.494714
W37,8000,3752,201425707.3,1136,9677,8541,6898.047974,1773.82533
W38,8000,3751,201372022.4,1335,8909,7574,7536.270861,976.1588334
W39,8000,3747,201157282.8,1893,8909,7016,7304.293568,1008.102807
W40,8000,3752,201425707.3,882,9046,8164,6302.799041,2099.891703
W41,8000,3754,201533077.1,882,9046,8164,6363.685136,1934.756633
W42,8000,3752,201425707.3,1335,9046,7711,7161.566898,1220.02901
W43,8000,3754,201533077.1,2474,8411,5937,7322.57805,882.4578494
W44,8000,3754,201533077.1,1400,8736,7336,6702.265317,1506.805326
W45,8000,3751,201372022.4,1400,8865,7465,6630.280725,1598.40456
W46,8000,3753,201479392.2,1276,8865,7589,6205.475087,1860.092565
W47,8000,3758,201747816.6,1276,8543,7267,6280.188664,1966.800632
W48,8000,3754,201533077.1,1398,8848,7450,7219.400373,1204.655697
W49,8000,3748,201210967.7,1398,8985,7587,6473.052028,1785.945178
W50,8000,3756,201640446.8,1471,9463,7992,6724.606763,1675.374109
W51,8000,3755,201586762,1307,9463,8156,6408.831158,1969.698361
W52,8000,3758,201747816.6,1406,8484,7078,6183.747206,1820.519278
W53,8000,3757,201694131.7,1307,8865,7558,6264.434389,1950.070685
W54,8000,3751,201372022.4,1059,8956,7897,5666.561717,2049.814181
W55,8000,3739,200727803.7,1007,9677,8670,6230.432469,2162.527716
W56,8000,3749,201264652.6,1104,9919,8815,5903.393972,2167.358447
W57,8000,3752,201425707.3,1097,9919,8822,5400.638859,2322.867181
W58,8000,3741,200835173.5,209,8990,8781,5747.785886,2295.783407
W59,8000,3748,201210967.7,377,9919,9542,4932.976254,2434.512441
W60,8000,3750,201318337.5,552,9203,8651,6269.102133,2154.298534
W61,8000,3751,201372022.4,651,9203,8552,6720.646494,1830.598752
W62,8000,3754,201533077.1,-1058,8711,9769,5393.884923,2557.838071
W63,8000,3748,201210967.7,-1058,9706,10764,4633.979189,2546.830824
W64,8000,3748,201210967.7,-35,9000,9035,5156.435165,2427.525122
W65,8000,3747,201157282.8,-35,9000,9035,4520.568188,2358.560121
W66,8000,3751,201372022.4,-35,9322,9357,4434.834178,2513.762457
WB-E1,8000,3745,201049913.1,222,9667,9445,5089.083578,2548.381102
WB-E10,8000,3751,201372022.4,377,9877,9500,4426.145561,2364.85118
WB-E2,8000,3749,201264652.6,552,8536,7984,5744.241931,2302.675231
WB-E3,8000,3752,201425707.3,1507,8949,7442,7247.603412,850.5425269
WB-E4,8000,3748,201210967.7,1542,8668,7126,7361.688634,1288.29411
WB-E5,8000,3746,201103597.9,222,9983,9761,5360.354511,2449.431627
WB-E6,8000,3758,201747816.6,2474,8694,6220,7366.926291,805.5318297
WB-E7,8000,3748,201210967.7,-159,8843,9002,5681.049626,2357.896074
WB-E8,8000,3753,201479392.2,882,9919,9037,5663.289901,2223.727957
WB-E9,8000,3744,200996228.2,224,8956,8732,5592.999733,2190.290933
WB-H1,8000,3751,201372022.4,1276,8465,7189,6419.179952,1865.792507
WB-H10,8000,3755,201586762,1276,8865,7589,6135.046871,1927.547294
WB-H2,8000,3739,200727803.7,1374,8859,7485,6945.460016,1783.295929
WB-H3,8000,3749,201264652.6,651,9203,8552,6487.672179,2171.810923
WB-H4,8000,3755,201586762,1230,8865,7635,6245.954993,1994.404279
WB-H5,8000,3755,201586762,882,9919,9037,6059.864447,2145.314896
WB-H6,8000,3748,201210967.7,-410,9958,10368,6464.222519,2503.302298
WB-H7,8000,3745,201049913.1,-240,9987,10227,6631.137517,2277.727228
WB-H8,8000,3750,201318337.5,224,8990,8766,5799.615733,2275.069503
WB-H9,8000,3753,201479392.2,273,9051,8778,5612.671463,2410.406141
WB-S1,8000,3744,200996228.2,-448,9919,10367,6310.646902,2501.105852
WB-S10,8000,3748,201210967.7,-1058,9508,10566,3941.141676,2687.907297
WB-S11,8000,3751,201372022.4,377,8663,8286,5197.984004,2419.152794
WB-S12,8000,3748,201210967.7,377,9919,9542,4955.700374,2381.684667
WB-S13,8000,3748,201210967.7,882,9046,8164,5925.724653,2185.270469
WB-S14,8000,3743,200942543.3,1283,8865,7582,6771.174459,1559.65194
WB-S15,8000,3751,201372022.4,1276,8465,7189,6235.022927,1854.888366
WB-S16,8000,3744,200996228.2,222,9560,9338,5811.874733,2328.961616
WB-S17,8000,3746,201103597.9,651,8640,7989,6932.762947,1532.479386
WB-S18,8000,3751,201372022.4,651,9203,8552,6233.63583,2235.718552
WB-S19,8000,3750,201318337.5,1249,9677,8428,6646.172533,1781.333644
WB-S2,8000,3736,200566749,-1438,9985,11423,4030.109475,3483.946449
WB-S20,8000,3757,201694131.7,1136,9107,7971,7149.631887,1574.467372
WB-S21,8000,3752,201425707.3,1893,8411,6518,7241.054638,1008.643849
WB-S22,8000,3754,201533077.1,2474,8949,6475,7297.338306,832.9015034
WB-S23,8000,3748,201210967.7,290,9518,9228,6471.140075,1948.242551
WB-S24,8000,3752,201425707.3,273,9051,8778,5563.661247,2230.21309
WB-S25,8000,3749,201264652.6,1058,8962,7904,6857.2486,1697.254027
WB-S26,8000,3746,201103597.9,1109,9158,8049,7312.231714,1680.958845
WB-S27,8000,3750,201318337.5,1427,8958,7531,7683.0432,1005.446251
WB-S28,8000,3747,201157282.8,775,8875,8100,7165.805711,1586.54931
WB-S29,8000,3748,201210967.7,1152,9712,8560,7211.633138,1319.819015
WB-S3,8000,3749,201264652.6,-1422,9934,11356,5193.750067,2497.04139
WB-S4,8000,3755,201586762,209,8830,8621,4113.649268,2405.125388
WB-S5,8000,3748,201210967.7,224,8990,8766,5792.33778,2295.614826
WB-S6,8000,3754,201533077.1,1196,8831,7635,6002.387054,2134.715662
WB-S7,8000,3754,201533077.1,1307,9463,8156,6398.358551,1924.10898
WB-S8,8000,3753,201479392.2,-93,9834,9927,6617.840927,2049.316283
WB-S9,8000,3746,201103597.9,-919,9979,10898,4829.16284,2636.353827
WB-W1,8000,3745,201049913.1,680,9266,8586,6313.200267,1828.298432
WB-W10,8000,3750,201318337.5,-320,9934,10254,5220.144,2378.277622
WB-W2,8000,3746,201103597.9,802,9958,9156,7276.194608,1433.532122
WB-W3,8000,3748,201210967.7,775,9712,8937,6931.277481,1547.574221
WB-W4,8000,3744,200996228.2,-867,9979,10846,5903.159722,2106.316052
WB-W5,8000,3738,200674118.8,1356,8962,7606,7032.249331,1629.791113
WB-W6,8000,3749,201264652.6,1496,8668,7172,7326.701254,1359.69039
WB-W7,8000,3746,201103597.9,-448,9919,10367,5472.513881,2860.656197
WB-W8,8000,3750,201318337.5,890,9004,8114,7012.688533,1483.308464
WB-W9,8000,3753,201479392.2,1136,9919,8783,6393.107381,1997.871222
W01,8250,3988,214095341.3,313,9911,9598,6974.326981,2014.596778
W02,8250,3982,213773232,313,9008,8695,7137.697388,1705.610746
W03,8250,3983,213826916.9,775,8861,8086,7120.724831,1536.953498
W04,8250,3989,214149026.2,879,9008,8129,7168.716972,1610.438788
W05,8250,3981,213719547.1,688,9958,9270,7182.351922,1591.904734
W06,8250,3984,213880601.8,775,9428,8653,7202.715863,1519.070627
W07,8250,3983,213826916.9,775,9712,8937,6936.093397,1554.277095
W08,8250,3984,213880601.8,1374,9712,8338,6933.641817,1769.144106
W09,8250,3990,214202711.1,1374,9712,8338,7120.966416,1428.065032
W10,8250,3981,213719547.1,1356,8717,7361,6652.19995,1937.178138
W11,8250,3983,213826916.9,680,9266,8586,6285.981672,1865.884277
W12,8250,3980,213665862.2,273,9983,9710,5729.193216,2328.440174
W13,8250,3992,214310080.9,273,9712,9439,6117.776052,2102.457209
W14,8250,3981,213719547.1,587,9712,9125,6477.938458,2040.797959
W15,8250,3989,214149026.2,587,8962,8375,6638.526448,1971.025763
W16,8250,3988,214095341.3,-240,9874,10114,6314.249498,2436.20373
W17,8250,3982,213773232,-11,9834,9845,6494.030638,2315.557871
W18,8250,3981,213719547.1,-840,9310,10150,6491.720673,2081.656834
W19,8250,3981,213719547.1,-919,9979,10898,6299.011806,2315.787866
W20,8250,3985,213934286.7,-919,9979,10898,6207.674529,2137.26693
W21,8250,3981,213719547.1,-11,9507,9518,6495.267772,2000.650365
W22,8250,3986,213987971.5,-919,9979,10898,4961.838685,2710.258355
W23,8250,3985,213934286.7,-919,9979,10898,5855.268758,2200.685168
W24,8250,3986,213987971.5,222,9917,9695,5886.165078,2257.838021
W25,8250,3985,213934286.7,222,9012,8790,6008.163112,2061.654078
W26,8250,3983,213826916.9,-1058,8764,9822,4846.186794,2570.009
W27,8250,3987,214041656.4,120,9012,8892,5949.48307,2189.513077
W28,8250,3981,213719547.1,262,9012,8750,6442.137403,1920.221288
W29,8250,3983,213826916.9,852,9012,8160,6489.633944,1907.907165
W30,8250,3987,214041656.4,890,9012,8122,6928.412591,1473.573901
W31,8250,3985,213934286.7,1427,8958,7531,7816.492848,730.9415286
W32,8250,3987,214041656.4,1406,9001,7595,7488.402307,1458.171333
W33,8250,3986,213987971.5,1109,9158,8049,7186.07727,1598.430981
W34,8250,3992,214310080.9,651,9203,8552,6203.356713,2226.710122
W35,8250,3985,213934286.7,1383,8958,7575,7069.492848,1625.422378
W36,8250,3991,214256396,1249,9677,8428,6778.703583,1792.7164
W37,8250,3987,214041656.4,1136,9677,8541,6910.202659,1765.077201
W38,8250,3993,214363765.8,1335,8909,7574,7522.235913,990.994702
W39,8250,3991,214256396,1893,8909,7016,7318.63994,992.0467196
W40,8250,3985,213934286.7,882,9046,8164,6320.955332,2093.40412
W41,8250,3987,214041656.4,882,9046,8164,6345.301981,1946.719892
W42,8250,3985,213934286.7,1034,9046,8012,7124.25596,1276.099884
W43,8250,3992,214310080.9,2474,8694,6220,7313.830661,878.8789876
W44,8250,3987,214041656.4,1400,8736,7336,6715.80311,1499.366829
W45,8250,3990,214202711.1,1400,8865,7465,6652.784712,1579.185369
W46,8250,3992,214310080.9,1276,8865,7589,6235.485972,1844.73476
W47,8250,3989,214149026.2,1276,8543,7267,6302.207069,1952.127282
W48,8250,3991,214256396,1398,8848,7450,7223.637434,1196.900333
W49,8250,3995,214471135.6,1398,8985,7587,6508.596746,1776.09585
W50,8250,3987,214041656.4,1318,9463,8145,6680.029095,1724.714562
W51,8250,3989,214149026.2,1307,9463,8156,6385.248935,1973.260347
W52,8250,3984,213880601.8,1406,8557,7151,6213.443524,1815.985578
W53,8250,3987,214041656.4,1307,8865,7558,6261.885127,1948.982488
W54,8250,3991,214256396,1059,8956,7897,5691.215986,2041.781042
W55,8250,3995,214471135.6,1007,9677,8670,6217.603254,2157.429117
W56,8250,3990,214202711.1,1104,9919,8815,5850.150376,2180.234399
W57,8250,3984,213880601.8,882,9919,9037,5356.862952,2342.351671
W58,8250,3991,214256396,209,8990,8781,5674.68429,2312.633599
W59,8250,3992,214310080.9,377,9919,9542,4975.184118,2427.645286
W60,8250,3984,213880601.8,552,9203,8651,6201.374749,2190.196229
W61,8250,3983,213826916.9,651,9203,8552,6726.723324,1820.823321
W62,8250,3983,213826916.9,-1058,8711,9769,5420.511675,2550.902063
W63,8250,3987,214041656.4,-1058,9706,10764,4651.897918,2548.740648
W64,8250,3992,214310080.9,-320,9000,9320,5111.856212,2452.446999
W65,8250,3987,214041656.4,-35,9000,9035,4552.24304,2359.376372
W66,8250,3987,214041656.4,-35,9322,9357,4459.364936,2513.492087
WB-E1,8250,3981,213719547.1,222,9667,9445,5172.079879,2536.371182
WB-E10,8250,3986,213987971.5,377,9877,9500,4451.884596,2368.476341
WB-E2,8250,3986,213987971.5,-1058,8536,9594,5700.148269,2325.516075
WB-E3,8250,3984,213880601.8,1507,8949,7442,7230.495984,887.0429453
WB-E4,8250,3982,213773232,1542,8668,7126,7359.951783,1274.687409
WB-E5,8250,3983,213826916.9,222,9983,9761,5358.428822,2459.221982
WB-E6,8250,3988,214095341.3,2474,8694,6220,7342.773821,842.6741501
WB-E7,8250,3982,213773232,-1058,8843,9901,5693.660221,2363.394238
WB-E8,8250,3989,214149026.2,882,9919,9037,5667.290048,2224.715482
WB-E9,8250,3996,214524820.4,-1051,8956,10007,5605.846346,2192.003388
WB-H1,8250,3993,214363765.8,1276,8465,7189,6404.19985,1869.16393
WB-H10,8250,3990,214202711.1,1276,8865,7589,6184.494737,1908.622113
WB-H2,8250,3986,213987971.5,1374,8859,7485,6967.947316,1755.850508
WB-H3,8250,3989,214149026.2,651,9203,8552,6522.991727,2137.530761
WB-H4,8250,3988,214095341.3,1230,8865,7635,6259.043631,1988.439387
WB-H5,8250,3986,213987971.5,882,9919,9037,6060.498996,2155.606969
WB-H6,8250,3981,213719547.1,-410,9958,10368,6485.998995,2477.041683
WB-H7,8250,3981,213719547.1,-240,9987,10227,6658.123838,2257.528078
WB-H8,8250,3993,214363765.8,224,8990,8766,5745.278237,2286.643514
WB-H9,8250,3980,213665862.2,273,9051,8778,5632.567588,2399.536537
WB-S1,8250,3987,214041656.4,-448,9919,10367,6333.567595,2484.536202
WB-S10,8250,3989,214149026.2,-1058,9508,10566,3943.887942,2697.816435
WB-S11,8250,3991,214256396,264,8663,8399,5206.468304,2421.45043
WB-S12,8250,3993,214363765.8,377,9919,9542,4949.238668,2379.232434
WB-S13,8250,3988,214095341.3,882,9046,8164,5970.357573,2164.387746
WB-S14,8250,3998,214632190.2,1230,8865,7635,6714.323912,1600.034215
WB-S15,8250,3995,214471135.5,1276,8465,7189,6259.939675,1840.88491
WB-S16,8250,3982,213773232,222,9560,9338,5806.823707,2337.520888
WB-S17,8250,3984,213880601.8,651,8640,7989,6900.279367,1567.288422
WB-S18,8250,3985,213934286.7,651,9203,8552,6253.53601,2218.184848
WB-S19,8250,3988,214095341.3,1249,9677,8428,6663.768556,1788.666208
WB-S2,8250,3987,214041656.4,-1438,9985,11423,4040.411337,3459.773604
WB-S20,8250,3987,214041656.4,1136,9107,7971,7128.097818,1585.880246
WB-S21,8250,3989,214149026.2,1893,8411,6518,7245.702432,999.285565
WB-S22,8250,3992,214310080.9,2474,8949,6475,7302.574399,821.1332911
WB-S23,8250,3982,213773232,290,9593,9303,6494.702411,1943.173992
WB-S24,8250,3981,213719547.1,273,9157,8884,5615.452148,2226.280312
WB-S25,8250,3983,213826916.9,1058,8962,7904,6854.148381,1698.047123
WB-S26,8250,3984,213880601.8,1109,9158,8049,7273.009789,1711.483689
WB-S27,8250,3990,214202711.1,1427,8958,7531,7670.921303,1025.059366
WB-S28,8250,3989,214149026.2,775,9377,8602,7148.685635,1593.109072
WB-S29,8250,3985,213934286.7,826,9712,8886,7176.292597,1382.084214
WB-S3,8250,3990,214202711.1,-1422,9934,11356,5147.780702,2517.782622
WB-S4,8250,3988,214095341.3,209,8830,8621,4139.607823,2390.578155
WB-S5,8250,3994,214417450.7,224,8990,8766,5751.692288,2293.597699
WB-S6,8250,3989,214149026.2,1196,8831,7635,6035.084482,2126.736815
WB-S7,8250,3992,214310080.9,1307,9463,8156,6377.487475,1929.703647
WB-S8,8250,3980,213665862.2,-840,9834,10674,6602.454271,2052.238806
WB-S9,8250,3984,213880601.8,-919,9979,10898,4850.253263,2640.387981
WB-W1,8250,3989,214149026.2,680,9266,8586,6328.61444,1840.741385
WB-W10,8250,3983,213826916.9,-320,9934,10254,5215.253076,2388.353304
WB-W2,8250,3982,213773232,802,9958,9156,7270.200653,1440.293069
WB-W3,8250,3981,213719547.1,775,9712,8937,6933.473248,1565.313611
WB-W4,8250,3987,214041656.4,-919,9979,10898,5833.194131,2173.355738
WB-W5,8250,3996,214524820.4,1356,8962,7606,7040.401652,1622.646347
WB-W6,8250,3987,214041656.4,1496,8668,7172,7330.370454,1352.047167
WB-W7,8250,3986,213987971.5,-448,9919,10367,5492.626944,2864.124001
WB-W8,8250,3984,213880601.8,890,9004,8114,6997.010542,1513.328113
WB-W9,8250,3988,214095341.3,1136,9919,8783,6392.822969,1994.678984
W01,8500,4227,226926030,313,9911,9598,6979.536551,2017.969056
W02,8500,4225,226818660.2,313,9008,8695,7116.481893,1725.643309
W03,8500,4232,227194454.5,775,8861,8086,7115.448724,1521.187097
W04,8500,4227,226926030,775,9008,8233,7136.451621,1639.268417
W05,8500,4224,226764975.4,688,9958,9270,7178.4491,1590.949894
W06,8500,4231,227140769.6,775,9579,8804,7194.541952,1529.692215
W07,8500,4234,227301824.3,775,9712,8937,6946.891356,1554.529319
W08,8500,4231,227140769.6,1374,9712,8338,6915.721815,1786.476171
W09,8500,4227,226926030,1374,9712,8338,7116.022475,1438.893705
W10,8500,4227,226926030,1356,8717,7361,6669.299503,1933.432859
W11,8500,4228,226979714.9,680,9266,8586,6303.553217,1883.579709
W12,8500,4233,227248139.4,273,9983,9710,5758.237893,2327.80719
W13,8500,4230,227087084.7,273,9712,9439,6119.727896,2104.71677
W14,8500,4235,227355509.2,587,9712,9125,6484.353247,2024.638151
W15,8500,4228,226979714.9,587,8962,8375,6632.232025,1983.183909
W16,8500,4227,226926030,-240,9987,10227,6340.048971,2414.942568
W17,8500,4227,226926030,-11,9834,9845,6463.113319,2321.086289
W18,8500,4233,227248139.4,-867,9834,10701,6441.770848,2114.213451
W19,8500,4228,226979714.9,-919,9979,10898,6306.632923,2307.288725
W20,8500,4234,227301824.3,-919,9979,10898,6191.584081,2151.993796
W21,8500,4233,227248139.4,-11,9507,9518,6487.479802,2002.445742
W22,8500,4234,227301824.3,-919,9979,10898,4970.606282,2723.405624
W23,8500,4232,227194454.5,-919,9979,10898,5816.443289,2255.832593
W24,8500,4228,226979714.9,222,9983,9761,5908.442999,2261.280644
W25,8500,4228,226979714.9,222,9248,9026,5993.387181,2074.799442
W26,8500,4232,227194454.5,-1058,8764,9822,4855.577505,2587.639114
W27,8500,4230,227087084.7,120,9012,8892,5929.854137,2204.780201
W28,8500,4237,227462878.9,262,9012,8750,6424.944772,1918.615176
W29,8500,4234,227301824.3,262,9012,8750,6469.086915,1935.705576
W30,8500,4232,227194454.5,890,9012,8122,6878.299386,1559.879655
W31,8500,4231,227140769.6,1427,8958,7531,7808.30442,726.2787658
W32,8500,4228,226979714.9,1406,9001,7595,7474.791864,1470.54296
W33,8500,4230,227087084.7,1109,9158,8049,7173.775887,1589.576155
W34,8500,4224,226764975.4,651,9203,8552,6204.895597,2228.167541
W35,8500,4230,227087084.7,1383,8958,7575,7087.033333,1604.766132
W36,8500,4228,226979714.9,1249,9677,8428,6799.835147,1778.615685
W37,8500,4234,227301824.3,1136,9677,8541,6919.736183,1758.027185
W38,8500,4226,226872345.1,1335,9107,7772,7509.522717,1008.728293
W39,8500,4237,227462878.9,1893,8909,7016,7325.236252,979.9255913
W40,8500,4229,227033399.8,882,9046,8164,6341.221802,2082.226881
W41,8500,4238,227516563.8,882,9046,8164,6344.337423,1948.850678
W42,8500,4235,227355509.2,1034,9046,8012,7094.931051,1321.17388
W43,8500,4237,227462878.9,2474,8694,6220,7306.234836,875.9959577
W44,8500,4240,227623933.6,1400,8736,7336,6741.951179,1483.107778
W45,8500,4239,227570248.7,1400,8865,7465,6675.542817,1556.869599
W46,8500,4232,227194454.5,1276,8865,7589,6269.010633,1829.511154
W47,8500,4239,227570248.7,1276,8543,7267,6325.61925,1938.044431
W48,8500,4240,227623933.6,1398,8848,7450,7227.539151,1186.077162
W49,8500,4240,227623933.6,1362,8985,7623,6541.792453,1759.054006
W50,8500,4241,227677618.5,-858,9463,10321,6627.627682,1769.100446
W51,8500,4241,227677618.5,1307,9463,8156,6382.180146,1967.508129
W52,8500,4242,227731303.4,1406,8557,7151,6238.159123,1817.043711
W53,8500,4239,227570248.7,1307,8865,7558,6252.127153,1949.984435
W54,8500,4229,227033399.8,1059,8956,7897,5712.225585,2037.825027
W55,8500,4233,227248139.4,1007,9677,8670,6212.951335,2147.965582
W56,8500,4231,227140769.6,1104,9919,8815,5794.49161,2199.853308
W57,8500,4230,227087084.7,882,9919,9037,5329.525768,2353.160393
W58,8500,4238,227516563.8,209,8990,8781,5617.869514,2323.908448
W59,8500,4233,227248139.4,377,9919,9542,4999.397354,2417.763153
W60,8500,4235,227355509.2,552,9203,8651,6134.707202,2224.453781
W61,8500,4226,226872345.1,651,9203,8552,6713.484146,1822.173387
W62,8500,4234,227301824.3,-1058,8711,9769,5449.081483,2548.509659
W63,8500,4233,227248139.4,-1058,9706,10764,4660.128042,2554.629303
W64,8500,4224,226764975.4,-320,9000,9320,5088.259943,2465.013367
W65,8500,4234,227301824.3,-35,9000,9035,4591.753897,2361.802066
W66,8500,4230,227087084.7,-1422,9322,10744,4487.060757,2512.854209
WB-E1,8500,4229,227033399.8,222,9667,9445,5252.22724,2525.275538
WB-E10,8500,4233,227248139.4,377,9877,9500,4496.358611,2378.359995
WB-E2,8500,4236,227409194,-1058,8536,9594,5656.360482,2350.876317
WB-E3,8500,4231,227140769.6,1507,8949,7442,7220.386433,898.2382164
WB-E4,8500,4234,227301824.3,1542,8668,7126,7360.743033,1261.038016
WB-E5,8500,4228,226979714.9,222,9983,9761,5367.170057,2460.534521
WB-E6,8500,4242,227731303.4,2474,8694,6220,7317.938472,878.2542665
WB-E7,8500,4234,227301824.3,-1058,8843,9901,5693.571327,2373.027721
WB-E8,8500,4236,227409194,882,9919,9037,5662.395184,2230.202813
WB-E9,8500,4230,227087084.7,-1051,8956,10007,5617.863357,2188.091656
WB-H1,8500,4233,227248139.4,1276,8465,7189,6400.296008,1865.4692
WB-H10,8500,4237,227462878.9,1276,8865,7589,6231.389662,1886.040349
WB-H2,8500,4234,227301824.3,1374,8859,7485,6997.49693,1725.774703
WB-H3,8500,4226,226872345.1,651,9203,8552,6556.538097,2108.993968
WB-H4,8500,4237,227462878.9,1230,8865,7635,6266.403587,1989.925791
WB-H5,8500,4236,227409194,882,9919,9037,6051.798631,2161.983818
WB-H6,8500,4235,227355509.2,-410,9958,10368,6506.663991,2452.992766
WB-H7,8500,4225,226818660.2,-240,9987,10227,6686.544379,2228.61489
WB-H8,8500,4231,227140769.6,224,8990,8766,5696.205389,2295.949009
WB-H9,8500,4232,227194454.5,273,9051,8778,5655.068053,2383.433988
WB-S1,8500,4224,226764975.4,-448,9919,10367,6347.84233,2476.148274
WB-S10,8500,4230,227087084.7,-1058,9508,10566,3969.743499,2704.554746
WB-S11,8500,4231,227140769.6,264,8791,8527,5239.043252,2413.956726
WB-S12,8500,4239,227570248.7,377,9919,9542,4952.004482,2376.343084
WB-S13,8500,4236,227409194,882,9046,8164,6005.279509,2155.5928
WB-S14,8500,4233,227248139.4,1230,8865,7635,6667.050555,1632.764418
WB-S15,8500,4226,226872345.1,1276,8865,7589,6286.508519,1830.261358
WB-S16,8500,4232,227194454.5,222,9560,9338,5802.407609,2336.575195
WB-S17,8500,4226,226872345.1,651,8665,8014,6852.988642,1616.795237
WB-S18,8500,4233,227248139.4,651,9203,8552,6244.453815,2219.324347
WB-S19,8500,4232,227194454.5,1249,9677,8428,6667.664934,1796.916561
WB-S2,8500,4233,227248139.4,-1438,9985,11423,4040.357902,3444.374761
WB-S20,8500,4238,227516563.8,1136,9107,7971,7111.756489,1590.248728
WB-S21,8500,4233,227248139.4,1684,8411,6727,7245.192535,998.8252249
WB-S22,8500,4238,227516563.8,2474,8949,6475,7309.742803,812.7417629
WB-S23,8500,4224,226764975.4,290,9673,9383,6513.546402,1947.278939
WB-S24,8500,4234,227301824.3,273,9390,9117,5675.914265,2230.534211
WB-S25,8500,4235,227355509.2,1058,8962,7904,6849.793152,1705.246626
WB-S26,8500,4230,227087084.7,1109,9158,8049,7237.785816,1729.237368
WB-S27,8500,4236,227409194,1427,8958,7531,7659.72474,1042.061275
WB-S28,8500,4226,226872345.1,775,9377,8602,7129.362754,1601.327054
WB-S29,8500,4229,227033399.8,775,9712,8937,7124.782927,1463.291138
WB-S3,8500,4230,227087084.7,-1422,9934,11356,5115.239243,2531.148311
WB-S4,8500,4235,227355509.1,209,8830,8621,4164.254309,2378.6687
WB-S5,8500,4239,227570248.7,224,8990,8766,5715.037037,2299.747761
WB-S6,8500,4236,227409194,1196,8956,7760,6071.59136,2116.680092
WB-S7,8500,4237,227462878.9,1307,9463,8156,6345.063252,1937.084276
WB-S8,8500,4235,227355509.2,-867,9979,10846,6580.275325,2062.92636
WB-S9,8500,4231,227140769.6,-919,9979,10898,4866.84519,2647.438184
WB-W1,8500,4223,226711290.5,680,9266,8586,6339.908122,1851.493775
WB-W10,8500,4238,227516563.8,-320,9934,10254,5218.27513,2400.615384
WB-W2,8500,4226,226872345.1,802,9958,9156,7268.228348,1450.139882
WB-W3,8500,4231,227140769.6,775,9712,8937,6931.142283,1590.882941
WB-W4,8500,4232,227194454.5,-919,9979,10898,5773.810728,2227.109178
WB-W5,8500,4228,226979714.9,1356,8962,7606,7041.46878,1614.803387
WB-W6,8500,4232,227194454.5,1496,8717,7221,7329.011342,1346.847716
WB-W7,8500,4226,226872345.1,-448,9919,10367,5493.381685,2862.817214
WB-W8,8500,4232,227194454.5,890,9004,8114,6984.129962,1537.650427
WB-W9,8500,4236,227409194,1136,9919,8783,6392.755194,1992.947245
W01,8750,4474,240186197.9,-410,9911,10321,6979.562584,2024.073494
W02,8750,4479,240454622.3,313,9080,8767,7102.965841,1734.787913
W03,8750,4481,240561992.1,775,8998,8223,7106.284535,1507.746507
W04,8750,4488,240937786.3,775,9008,8233,7109.475936,1659.64601
W05,8750,4475,240239882.8,657,9958,9301,7184.479777,1587.955376
W06,8750,4477,240347252.5,775,9579,8804,7192.540094,1530.121541
W07,8750,4481,240561992.1,775,9712,8937,6960.723946,1554.055405
W08,8750,4476,240293567.6,1374,9712,8338,6899.294906,1801.917008
W09,8750,4476,240293567.6,1374,9712,8338,7109.683646,1452.473799
W10,8750,4484,240723046.8,1356,8717,7361,6680.561329,1929.367759
W11,8750,4475,240239882.8,680,9266,8586,6317.154413,1898.914785
W12,8750,4484,240723046.8,273,9983,9710,5797.431088,2323.060334
W13,8750,4490,241045156.1,273,9712,9439,6126.944543,2104.849928
W14,8750,4481,240561992.1,587,9712,9125,6486.243696,2016.54365
W15,8750,4476,240293567.6,587,8962,8375,6615.494191,2001.854499
W16,8750,4475,240239882.8,-240,9987,10227,6370.541676,2395.409459
W17,8750,4481,240561992.1,-11,9874,9885,6456.95559,2305.699257
W18,8750,4481,240561992.1,-867,9834,10701,6403.980362,2135.711336
W19,8750,4488,240937786.3,-919,9979,10898,6320.619875,2295.681333
W20,8750,4489,240991471.2,-919,9979,10898,6185.423925,2159.625422
W21,8750,4483,240669361.9,-840,9507,10347,6464.668079,2019.670593
W22,8750,4490,241045156.1,-919,9979,10898,4989.59265,2736.836254
W23,8750,4481,240561992.1,-919,9979,10898,5776.732872,2298.898031
W24,8750,4477,240347252.5,222,9983,9761,5937.574045,2262.011184
W25,8750,4485,240776731.6,204,9266,9062,5977.171014,2098.284153
W26,8750,4483,240669361.9,-1058,9979,11037,4862.008253,2614.865634
W27,8750,4479,240454622.3,120,9012,8892,5913.400089,2217.244225
W28,8750,4474,240186197.9,222,9012,8790,6412.242736,1920.053262
W29,8750,4481,240561992.1,262,9012,8750,6447.746039,1971.912572
W30,8750,4482,240615677,651,9012,8361,6829.492414,1634.486187
W31,8750,4490,241045156.1,1427,8958,7531,7802.56971,720.7968698
W32,8750,4481,240561992.1,1406,9001,7595,7459.754073,1479.013008
W33,8750,4482,240615677,1109,9158,8049,7156.07809,1595.270377
W34,8750,4485,240776731.7,651,9203,8552,6207.126644,2229.296411
W35,8750,4478,240400937.4,1383,8958,7575,7093.267753,1597.580642
W36,8750,4482,240615677,1227,9677,8450,6812.731816,1771.271687
W37,8750,4491,241098841,1136,9677,8541,6929.371409,1747.060725
W38,8750,4487,240884101.4,1335,9107,7772,7489.868286,1036.131548
W39,8750,4493,241206210.8,1893,8909,7016,7329.168484,969.474876
W40,8750,4484,240723046.8,882,9046,8164,6362.458296,2066.771272
W41,8750,4487,240884101.4,882,9046,8164,6343.756185,1951.335901
W42,8750,4486,240830416.5,1034,9046,8012,7064.458761,1363.73054
W43,8750,4495,241313580.6,2474,8694,6220,7304.59733,868.9888432
W44,8750,4484,240723046.8,1400,8736,7336,6767.1938,1468.922156
W45,8750,4488,240937786.3,1400,8865,7465,6702.165107,1535.287367
W46,8750,4484,240723046.8,1276,8865,7589,6297.424844,1821.244306
W47,8750,4487,240884101.4,1276,8543,7267,6361.944283,1917.507691
W48,8750,4490,241045156.1,1398,8848,7450,7231.878619,1173.569471
W49,8750,4496,241367265.4,1362,8985,7623,6564.576068,1747.237664
W50,8750,4486,240830416.5,-858,9463,10321,6593.306063,1798.186178
W51,8750,4485,240776731.7,1307,9463,8156,6382.677592,1963.206703
W52,8750,4486,240830416.5,1406,8567,7161,6266.510477,1814.88562
W53,8750,4484,240723046.8,1307,8865,7558,6240.026539,1946.447298
W54,8750,4489,240991471.2,1059,8956,7897,5742.059479,2037.554997
W55,8750,4495,241313580.5,1007,9877,8870,6211.550834,2133.506801
W56,8750,4481,240561992.1,1104,9919,8815,5737.115376,2224.090055
W57,8750,4486,240830416.5,641,9919,9278,5297.980383,2363.268182
W58,8750,4496,241367265.4,209,8990,8781,5565.092082,2336.733151
W59,8750,4491,241098841,377,9919,9542,5014.566689,2409.020988
W60,8750,4484,240723046.8,552,9203,8651,6073.531891,2251.982107
W61,8750,4482,240615677,651,9203,8552,6703.006917,1821.819382
W62,8750,4481,240561992.1,-1058,8711,9769,5470.825932,2545.336391
W63,8750,4479,240454622.3,-1058,9934,10992,4654.628489,2570.66603
W64,8750,4487,240884101.4,-320,9706,10026,5077.804992,2472.62759
W65,8750,4491,241098841,-35,9000,9035,4635.079047,2363.913028
W66,8750,4481,240561992.1,-1422,9322,10744,4514.013613,2510.203138
WB-E1,8750,4487,240884101.4,222,9667,9445,5331.226209,2506.593543
WB-E10,8750,4487,240884101.4,377,9877,9500,4535.196345,2383.537717
WB-E2,8750,4483,240669361.9,-1058,8640,9698,5622.16083,2366.410164
WB-E3,8750,4492,241152525.9,1507,8949,7442,7221.429653,897.4663626
WB-E4,8750,4482,240615677,1496,8668,7172,7359.792057,1254.90421
WB-E5,8750,4485,240776731.6,222,9983,9761,5393.705463,2461.932095
WB-E6,8750,4482,240615677,2474,8694,6220,7304.787149,886.2590651
WB-E7,8750,4483,240669361.9,-1058,8843,9901,5676.767566,2392.375519
WB-E8,8750,4495,241313580.5,882,9919,9037,5662.455395,2232.366688
WB-E9,8750,4494,241259895.7,-1051,8956,10007,5634.199822,2177.617661
WB-H1,8750,4488,240937786.3,1276,8465,7189,6402.64082,1863.736671
WB-H10,8750,4489,240991471.2,1276,8865,7589,6271.87681,1862.388916
WB-H2,8750,4491,241098841,1374,8859,7485,7018.395012,1696.927534
WB-H3,8750,4480,240508307.2,651,9203,8552,6592.639286,2084.138315
WB-H4,8750,4488,240937786.3,1230,8865,7635,6266.476827,1991.948778
WB-H5,8750,4489,240991471.2,882,9919,9037,6040.851415,2171.776029
WB-H6,8750,4476,240293567.6,-410,9958,10368,6521.120643,2435.169516
WB-H7,8750,4482,240615677,-240,9987,10227,6697.36033,2211.132043
WB-H8,8750,4482,240615677,224,8990,8766,5658.725569,2302.717703
WB-H9,8750,4483,240669361.9,273,9051,8778,5677.520857,2362.017598
WB-S1,8750,4481,240561992.1,-448,9919,10367,6354.775943,2485.52734
WB-S10,8750,4478,240400937.4,-1058,9508,10566,4008.149174,2706.509848
WB-S11,8750,4481,240561992.1,-35,9000,9035,5257.374916,2409.895196
WB-S12,8750,4494,241259895.7,377,9919,9542,4952.398754,2376.474312
WB-S13,8750,4495,241313580.5,882,9046,8164,6029.684983,2145.102234
WB-S14,8750,4496,241367265.4,1230,9046,7816,6632.481317,1660.805069
WB-S15,8750,4489,240991471.2,1276,8865,7589,6311.023168,1821.192831
WB-S16,8750,4490,241045156.1,222,9560,9338,5808.685523,2326.371767
WB-S17,8750,4483,240669361.9,651,9012,8361,6801.125809,1672.655044
WB-S18,8750,4484,240723046.8,651,9203,8552,6237.012043,2213.462662
WB-S19,8750,4490,241045156.1,1249,9677,8428,6664.506236,1807.000994
WB-S2,8750,4488,240937786.3,-1438,9985,11423,4042.854947,3425.960649
WB-S20,8750,4486,240830416.5,1136,9107,7971,7088.393446,1596.337066
WB-S21,8750,4482,240615677,1684,8411,6727,7236.981928,1012.826737
WB-S22,8750,4492,241152525.9,2474,8949,6475,7317.50935,804.4559215
WB-S23,8750,4482,240615677,290,9826,9536,6524.066711,1947.661843
WB-S24,8750,4480,240508307.2,273,9523,9250,5725.360268,2240.140489
WB-S25,8750,4483,240669361.9,1058,8962,7904,6850.125586,1705.862946
WB-S26,8750,4487,240884101.4,1109,9158,8049,7207.004012,1741.639735
WB-S27,8750,4492,241152525.9,1427,8958,7531,7651.66073,1052.449894
WB-S28,8750,4475,240239882.8,775,9377,8602,7118.153966,1607.473236
WB-S29,8750,4477,240347252.5,775,9712,8937,7072.006701,1539.194571
WB-S3,8750,4478,240400937.4,-1422,9934,11356,5084.984145,2541.85726
WB-S4,8750,4489,240991471.2,209,8990,8781,4191.566496,2378.389044
WB-S5,8750,4495,241313580.5,224,8990,8766,5680.534372,2299.196441
WB-S6,8750,4492,241152525.9,1196,8956,7760,6100.508459,2100.018136
WB-S7,8750,4489,240991471.2,1307,9463,8156,6316.875028,1945.017424
WB-S8,8750,4478,240400937.4,-919,9979,10898,6553.983921,2073.580892
WB-S9,8750,4488,240937786.3,-919,9979,10898,4886.513146,2659.237214
WB-W1,8750,4484,240723046.8,680,9266,8586,6357.789697,1865.069014
WB-W10,8750,4476,240293567.6,-320,9934,10254,5215.542895,2417.877222
WB-W2,8750,4481,240561992.1,802,9958,9156,7266.796028,1462.193019
WB-W3,8750,4483,240669361.9,775,9712,8937,6931.774704,1604.423522
WB-W4,8750,4492,241152525.9,-919,9979,10898,5714.5,2284.741433
WB-W5,8750,4490,241045156.1,1356,9004,7648,7037.856347,1608.972463
WB-W6,8750,4488,240937786.3,1447,8717,7270,7319.942513,1344.928671
WB-W7,8750,4480,240508307.2,-679,9919,10598,5463.088839,2871.044846
WB-W8,8750,4477,240347252.5,890,9012,8122,6972.516864,1557.913832
WB-W9,8750,4484,240723046.8,1136,9919,8783,6380.663247,2004.401021
W01,9000,4737,254305323.9,-410,9911,10321,6969.588136,2031.28923
W02,9000,4742,254573748.4,313,9080,8767,7097.234078,1734.284919
W03,9000,4742,254573748.4,775,9377,8602,7100.873049,1501.611078
W04,9000,4747,254842172.8,775,9008,8233,7093.208131,1672.435087
W05,9000,4736,254251639,319,9958,9639,7189.700591,1593.117102
W06,9000,4743,254627433.3,775,9579,8804,7198.487244,1525.960236
W07,9000,4744,254681118.2,775,9712,8937,6969.032251,1559.775675
W08,9000,4743,254627433.3,1374,9712,8338,6893.082859,1797.51718
W09,9000,4742,254573748.4,1374,9712,8338,7097.008646,1472.501165
W10,9000,4748,254895857.7,1356,8717,7361,6691.348989,1925.875873
W11,9000,4741,254520063.5,273,9572,9299,6340.481333,1919.199134
W12,9000,4746,254788487.9,273,9983,9710,5831.702908,2313.960516
W13,9000,4746,254788487.9,273,9712,9439,6121.420565,2119.233684
W14,9000,4745,254734803,587,9712,9125,6492.841517,2001.010014
W15,9000,4742,254573748.4,587,9390,8803,6609.697596,2004.87841
W16,9000,4738,254359008.8,-240,9987,10227,6387.846349,2374.981059
W17,9000,4743,254627433.3,-11,9874,9885,6450.993042,2297.224545
W18,9000,4741,254520063.5,-867,9979,10846,6379.575195,2155.742209
W19,9000,4744,254681118.2,-919,9979,10898,6333.63027,2289.642676
W20,9000,4747,254842172.8,-919,9979,10898,6180.575732,2162.922455
W21,9000,4746,254788487.9,-867,9507,10374,6425.444374,2048.506558
W22,9000,4747,254842172.8,-919,9979,10898,5010.85296,2754.87626
W23,9000,4745,254734803,-919,9979,10898,5730.710221,2344.800283
W24,9000,4741,254520063.5,222,9983,9761,5969.468467,2262.26189
W25,9000,4743,254627433.3,204,9482,9278,5969.291798,2113.110931
W26,9000,4743,254627433.3,-1058,9979,11037,4872.202614,2646.320477
W27,9000,4743,254627433.3,37,9012,8975,5887.841661,2232.201487
W28,9000,4747,254842172.8,222,9012,8790,6387.52728,1934.446409
W29,9000,4744,254681118.2,262,9012,8750,6428.776138,1999.288483
W30,9000,4745,254734803,651,9012,8361,6793.913383,1692.192855
W31,9000,4746,254788487.9,1427,8958,7531,7788.811209,746.5049737
W32,9000,4745,254734803,1406,9001,7595,7452.807587,1476.243029
W33,9000,4742,254573748.4,1109,9158,8049,7128.895403,1617.63156
W34,9000,4731,253983214.6,651,9203,8552,6230.912492,2212.745394
W35,9000,4747,254842172.8,1383,8958,7575,7094.204761,1598.592972
W36,9000,4736,254251639,1227,9677,8450,6829.840794,1756.510327
W37,9000,4748,254895857.7,1136,9677,8541,6941.622367,1733.719569
W38,9000,4731,253983214.6,1335,9107,7772,7480.870006,1044.057697
W39,9000,4753,255164282.2,1893,8909,7016,7330.224911,964.4460695
W40,9000,4748,254895857.7,882,9919,9037,6394.510531,2049.01227
W41,9000,4746,254788487.9,882,9046,8164,6348.380952,1951.603303
W42,9000,4747,254842172.8,882,9046,8164,7037.968612,1405.888389
W43,9000,4749,254949542.6,2474,8694,6220,7299.304485,869.8701502
W44,9000,4751,255056912.4,1400,8736,7336,6792.289834,1455.581002
W45,9000,4749,254949542.6,1400,8865,7465,6726.951358,1512.945101
W46,9000,4752,255110597.3,1276,8865,7589,6330.114478,1809.337281
W47,9000,4750,255003227.5,1276,8543,7267,6399.061263,1894.603595
W48,9000,4752,255110597.3,1398,8848,7450,7243.44213,1163.054281
W49,9000,4757,255379021.7,1276,8985,7709,6594.913181,1730.535975
W50,9000,4751,255056912.4,-858,9463,10321,6550.550831,1828.254415
W51,9000,4747,254842172.8,1307,9463,8156,6401.005477,1948.843406
W52,9000,4752,255110597.3,1406,8583,7177,6300.457702,1814.336679
W53,9000,4749,254949542.6,1307,8865,7558,6216.729417,1953.925439
W54,9000,4734,254144269.3,1059,8956,7897,5772.421208,2037.962928
W55,9000,4749,254949542.6,1007,9877,8870,6206.781428,2129.944682
W56,9000,4746,254788487.9,1104,9919,8815,5700.886431,2235.978116
W57,9000,4748,254895857.7,209,9919,9710,5287.58551,2372.7921
W58,9000,4755,255271651.9,209,8990,8781,5521.239117,2344.30302
W59,9000,4749,254949542.6,377,9919,9542,5022.002737,2405.804685
W60,9000,4745,254734803,552,9203,8651,6008.658588,2280.023012
W61,9000,4744,254681118.2,651,9203,8552,6680.541526,1835.052941
W62,9000,4746,254788487.9,-1058,8764,9822,5499.580067,2540.350143
W63,9000,4745,254734803,-1058,9934,10992,4650.435406,2593.752719
W64,9000,4731,253983214.6,-320,9706,10026,5080.630945,2466.309477
W65,9000,4747,254842172.8,-35,9000,9035,4680.831262,2363.676731
W66,9000,4744,254681118.2,-1422,9322,10744,4543.408094,2509.345808
WB-E1,9000,4745,254734803,222,9799,9577,5401.934457,2489.634776
WB-E10,9000,4745,254734803,377,9877,9500,4578.62255,2389.943174
WB-E2,9000,4746,254788487.9,-1058,8640,9698,5591.872103,2377.788383
WB-E3,9000,4754,255217967.1,1507,8949,7442,7217.107909,904.4543382
WB-E4,9000,4746,254788487.9,1496,8717,7221,7358.783607,1247.816932
WB-E5,9000,4743,254627433.3,222,9983,9761,5421.922201,2455.616555
WB-E6,9000,4751,255056912.4,2474,8694,6220,7298.780467,886.0724081
WB-E7,9000,4743,254627433.3,-1058,8843,9901,5672.11596,2394.847445
WB-E8,9000,4749,254949542.6,882,9919,9037,5660.012424,2233.631586
WB-E9,9000,4743,254627433.3,-1051,8956,10007,5650.194392,2169.576517
WB-H1,9000,4737,254305323.9,1276,8543,7267,6398.638168,1868.907179
WB-H10,9000,4747,254842172.8,1276,8865,7589,6302.653044,1841.333271
WB-H2,9000,4750,255003227.5,1374,8859,7485,7034.653053,1673.1098
WB-H3,9000,4734,254144269.3,651,9203,8552,6620.120828,2058.226879
WB-H4,9000,4748,254895857.7,1196,8865,7669,6267.572662,1988.758056
WB-H5,9000,4750,255003227.5,882,9919,9037,6043.033053,2167.462905
WB-H6,9000,4744,254681118.2,-410,9958,10368,6536.180438,2420.499429
WB-H7,9000,4745,254734803,-240,9987,10227,6706.851844,2199.642176
WB-H8,9000,4742,254573748.4,224,8990,8766,5632.022986,2301.345739
WB-H9,9000,4743,254627433.3,273,9051,8778,5698.974278,2341.868734
WB-S1,9000,4733,254090584.4,-448,9919,10367,6353.897317,2498.129171
WB-S10,9000,4742,254573748.4,-1058,9508,10566,4059.379587,2710.685056
WB-S11,9000,4746,254788487.9,-35,9000,9035,5267.741677,2402.640107
WB-S12,9000,4752,255110597.3,377,9919,9542,4967.589646,2372.869299
WB-S13,9000,4750,255003227.5,882,9046,8164,6040.510316,2143.038445
WB-S14,9000,4745,254734803,1196,9046,7850,6607.285564,1684.375531
WB-S15,9000,4736,254251639,1276,8865,7589,6337.500845,1811.915498
WB-S16,9000,4746,254788487.9,222,9917,9695,5832.436789,2315.95285
WB-S17,9000,4748,254895857.7,651,9012,8361,6738.631424,1735.271448
WB-S18,9000,4743,254627433.3,651,9203,8552,6210.564832,2217.275256
WB-S19,9000,4747,254842172.8,1249,9677,8428,6660.210238,1817.658734
WB-S2,9000,4750,255003227.5,-1438,9985,11423,4050.101263,3413.510813
WB-S20,9000,4749,254949542.6,1136,9107,7971,7070.749842,1595.295959
WB-S21,9000,4748,254895857.7,1684,8909,7225,7236.284751,1012.794191
WB-S22,9000,4749,254949542.6,2474,8949,6475,7320.768793,802.9036933
WB-S23,9000,4745,254734803,290,9826,9536,6542.700948,1942.943678
WB-S24,9000,4746,254788487.9,273,9606,9333,5784.201011,2244.953115
WB-S25,9000,4742,254573748.4,962,8962,8000,6843.289962,1720.375638
WB-S26,9000,4747,254842172.8,1109,9158,8049,7182.307352,1746.532055
WB-S27,9000,4748,254895857.7,1427,8958,7531,7643.036858,1055.461529
WB-S28,9000,4738,254359008.8,775,9428,8653,7109.967919,1614.533733
WB-S29,9000,4739,254412693.7,775,9712,8937,7022.190336,1603.510844
WB-S3,9000,4742,254573748.4,-1422,9934,11356,5049.106917,2552.538506
WB-S4,9000,4748,254895857.7,209,8990,8781,4213.016428,2380.732802
WB-S5,9000,4751,255056912.4,209,8990,8781,5657.851189,2297.207814
WB-S6,9000,4750,255003227.5,1196,8956,7760,6117.223789,2085.060537
WB-S7,9000,4750,255003227.5,1307,9463,8156,6299.695789,1944.26329
WB-S8,9000,4747,254842172.8,-919,9979,10898,6509.202444,2097.323416
WB-S9,9000,4744,254681118.2,-919,9979,10898,4899.469435,2667.943023
WB-W1,9000,4728,253822159.9,680,9317,8637,6374.424281,1884.928006
WB-W10,9000,4748,254895857.7,-320,9934,10254,5209.870261,2434.2349
WB-W2,9000,4741,254520063.5,688,9958,9270,7266.850875,1480.161793
WB-W3,9000,4742,254573748.4,775,9712,8937,6928.040911,1623.675935
WB-W4,9000,4746,254788487.9,-919,9979,10898,5665.111252,2332.617352
WB-W5,9000,4740,254466378.6,1356,9004,7648,7024.591561,1620.098778
WB-W6,9000,4744,254681118.2,1447,8717,7270,7312.190978,1340.145323
WB-W7,9000,4736,254251639,-796,9919,10715,5430.440245,2882.147426
WB-W8,9000,4744,254681118.2,890,9158,8268,6957.633642,1591.377638
WB-W9,9000,4746,254788487.9,1136,9919,8783,6359.703961,2020.787281
W01,9250,5005,268692874.4,-410,9958,10368,6959.744056,2043.218477
W02,9250,5007,268800244.2,313,9911,9598,7094.698222,1732.335009
W03,9250,5008,268853929.1,775,9377,8602,7095.60004,1501.006249
W04,9250,5014,269176038.5,775,9377,8602,7084.962306,1680.080349
W05,9250,5005,268692874.4,319,9958,9639,7198.946653,1595.136659
W06,9250,5005,268692874.4,775,9579,8804,7208.320679,1517.918421
W07,9250,5004,268639189.6,775,9712,8937,6977.271383,1562.481992
W08,9250,5005,268692874.4,1374,9712,8338,6890.872927,1791.92841
W09,9250,5007,268800244.2,1374,9712,8338,7073.173757,1504.793355
W10,9250,5015,269229723.3,1356,8717,7361,6699.016949,1919.127449
W11,9250,5003,268585504.7,273,9593,9320,6358.602239,1944.215039
W12,9250,5002,268531819.8,273,9983,9710,5862.702519,2305.880971
W13,9250,5014,269176038.5,273,9712,9439,6111.059832,2138.807181
W14,9250,5003,268585504.7,587,9712,9125,6500.974815,1988.405637
W15,9250,5007,268800244.2,587,9390,8803,6588.520471,2013.126054
W16,9250,5006,268746559.3,-240,9987,10227,6402.590092,2352.753357
W17,9250,5007,268800244.2,-11,9874,9885,6455.877971,2276.556899
W18,9250,5010,268961298.9,-919,9979,10898,6373.801796,2167.167095
W19,9250,5016,269283408.2,-919,9979,10898,6342.410088,2286.848681
W20,9250,5016,269283408.2,-919,9979,10898,6167.543262,2176.260604
W21,9250,5000,268424450,-867,9556,10423,6386.4576,2080.337388
W22,9250,5015,269229723.3,-919,9979,10898,5033.326022,2767.617366
W23,9250,5004,268639189.6,-919,9979,10898,5688.034373,2382.075006
W24,9250,5007,268800244.2,222,9983,9761,5999.669463,2260.587607
W25,9250,5017,269337093.1,204,9560,9356,5949.846721,2130.117195
W26,9250,5015,269229723.3,-1058,9979,11037,4886.343569,2669.466238
W27,9250,5006,268746559.3,37,9012,8975,5860.115062,2252.456779
W28,9250,4999,268370765.1,222,9012,8790,6373.429886,1945.929328
W29,9250,5006,268746559.3,262,9012,8750,6416.28326,2019.380083
W30,9250,5006,268746559.3,651,9012,8361,6758.381143,1736.804939
W31,9250,5019,269444462.9,1427,8958,7531,7776.843993,775.8383231
W32,9250,5007,268800244.2,1406,9001,7595,7449.425205,1472.849558
W33,9250,5006,268746559.3,1109,9158,8049,7104.218738,1645.411185
W34,9250,5013,269122353.6,651,9203,8552,6260.734291,2195.372254
W35,9250,5006,268746559.3,1383,8958,7575,7099.785657,1600.693132
W36,9250,5010,268961298.9,1177,9677,8500,6834.633932,1749.482645
W37,9250,5023,269659202.5,1136,9919,8783,6945.208043,1728.299029
W38,9250,5014,269176038.5,1335,9107,7772,7468.199043,1059.176449
W39,9250,5021,269551832.7,1893,8909,7016,7327.992631,966.8936155
W40,9250,5013,269122353.6,882,9919,9037,6426.176142,2028.706429
W41,9250,5016,269283408.2,882,9046,8164,6349.920455,1952.191259
W42,9250,5017,269337093.1,882,9046,8164,7004.893761,1454.570937
W43,9250,5021,269551832.7,2307,8694,6387,7293.415057,875.8188767
W44,9250,5017,269337093.1,1400,8736,7336,6810.647997,1443.807023
W45,9250,5011,269014983.8,1400,8865,7465,6750.873279,1491.541237
W46,9250,5014,269176038.5,1276,8865,7589,6357.380535,1799.664394
W47,9250,5017,269337093.1,1276,8985,7709,6437.386885,1871.217163
W48,9250,5012,269068668.7,1398,9086,7688,7254.349362,1150.158379
W49,9250,5024,269712887.4,1276,8985,7709,6620.706011,1720.793456
W50,9250,5016,269283408.2,-858,9463,10321,6517.625598,1851.588485
W51,9250,5013,269122353.6,1307,9463,8156,6418.946738,1931.447109
W52,9250,5017,269337093.1,1318,8719,7401,6326.09129,1808.454212
W53,9250,5016,269283408.2,1307,8865,7558,6196.634171,1962.620462
W54,9250,5016,269283408.2,1059,8956,7897,5802.960925,2035.255306
W55,9250,5017,269337093.1,1007,9877,8870,6195.789316,2128.955675
W56,9250,5009,268907614,1104,9919,8815,5678.368736,2242.739042
W57,9250,5013,269122353.6,209,9919,9710,5273.66148,2381.15259
W58,9250,5018,269390778,209,8990,8781,5493.190913,2348.531812
W59,9250,5017,269337093.1,377,9919,9542,5026.939207,2401.558553
W60,9250,5016,269283408.2,377,9203,8826,5952.238238,2303.568803
W61,9250,5009,268907614,651,9203,8552,6661.146936,1849.828034
W62,9250,5011,269014983.8,-1058,8764,9822,5521.306925,2530.771152
W63,9250,5007,268800244.2,-1058,9934,10992,4643.867785,2620.965603
W64,9250,5009,268907614,-1058,9934,10992,5077.830904,2466.140863
W65,9250,5017,269337093.1,-35,9000,9035,4726.576839,2364.252276
W66,9250,5010,268961298.9,-1422,9322,10744,4562.150699,2507.675509
WB-E1,9250,5016,269283408.2,222,9917,9695,5474.792065,2474.843655
WB-E10,9250,5012,269068668.7,377,9919,9542,4642.314844,2397.440003
WB-E2,9250,5004,268639189.6,-1058,9000,10058,5558.13709,2386.21293
WB-E3,9250,5022,269605517.6,1507,9044,7537,7208.576663,920.7602148
WB-E4,9250,5004,268639189.6,1496,8717,7221,7348.264788,1259.780255
WB-E5,9250,5016,269283408.2,222,9983,9761,5469.193182,2440.835045
WB-E6,9250,5012,269068668.7,2474,8694,6220,7296.961093,875.2832091
WB-E7,9250,5015,269229723.3,-1058,8843,9901,5662.961914,2404.328751
WB-E8,9250,5021,269551832.7,882,9919,9037,5657.563832,2240.669432
WB-E9,9250,5024,269712887.4,-1051,8956,10007,5668.77926,2160.684134
WB-H1,9250,5017,269337093.1,1276,8543,7267,6403.630456,1865.890136
WB-H10,9250,5015,269229723.3,1276,8865,7589,6334.213759,1820.459854
WB-H2,9250,5014,269176038.5,1374,8859,7485,7039.425209,1657.174188
WB-H3,9250,5007,268800244.2,651,9203,8552,6641.890953,2033.215969
WB-H4,9250,5019,269444462.9,1196,8865,7669,6259.646145,1987.593699
WB-H5,9250,5020,269498147.8,882,9919,9037,6051.310159,2165.86599
WB-H6,9250,5000,268424450,-410,9958,10368,6550.4038,2413.85213
WB-H7,9250,5014,269176038.5,-240,9987,10227,6705.833067,2201.108294
WB-H8,9250,5010,268961298.9,224,8990,8766,5612.606387,2298.426271
WB-H9,9250,5011,269014983.8,273,9051,8778,5726.362403,2328.327347
WB-S1,9250,5005,268692874.4,-448,9919,10367,6348.664935,2525.371976
WB-S10,9250,5008,268853929.1,-1058,9508,10566,4117.250998,2720.152492
WB-S11,9250,5007,268800244.2,-35,9000,9035,5264.638107,2400.224165
WB-S12,9250,5019,269444462.9,377,9919,9542,4978.200438,2373.655645
WB-S13,9250,5020,269498147.8,882,9046,8164,6051.724502,2140.280917
WB-S14,9250,5024,269712887.4,1196,9046,7850,6582.94586,1711.161323
WB-S15,9250,5019,269444462.9,1276,8865,7589,6366.358836,1799.841953
WB-S16,9250,5016,269283408.2,222,9983,9761,5866.196172,2302.482412
WB-S17,9250,5015,269229723.3,651,9012,8361,6679.195015,1788.023061
WB-S18,9250,5016,269283408.2,651,9203,8552,6202.539474,2211.677727
WB-S19,9250,5022,269605517.6,1249,9677,8428,6655.28415,1833.149465
WB-S2,9250,5018,269390778,-1438,9985,11423,4052.538262,3399.913455
WB-S20,9250,5017,269337093.1,1136,9107,7971,7053.409209,1600.328795
WB-S21,9250,5010,268961298.9,1400,8909,7509,7241.49481,1018.691083
WB-S22,9250,5023,269659202.5,2307,8949,6642,7316.083615,817.7327382
WB-S23,9250,5007,268800244.2,290,9826,9536,6556.410226,1941.85304
WB-S24,9250,5010,268961298.9,273,9712,9439,5831.307984,2251.092888
WB-S25,9250,5012,269068668.7,636,8962,8326,6831.606345,1738.645452
WB-S26,9250,5019,269444462.9,1109,9158,8049,7170.388524,1740.5608
WB-S27,9250,5019,269444462.9,1427,8958,7531,7634.813907,1054.01326
WB-S28,9250,5006,268746559.3,775,9428,8653,7117.911706,1607.665743
WB-S29,9250,5008,268853929.1,775,9712,8937,6976.109824,1654.814679
WB-S3,9250,5008,268853929.1,-1422,9934,11356,5016.33726,2559.224122
WB-S4,9250,5019,269444462.9,209,8990,8781,4223.402072,2387.481552
WB-S5,9250,5020,269498147.8,209,8990,8781,5640.759761,2293.858551
WB-S6,9250,5024,269712887.4,1196,8956,7760,6124.251592,2077.063625
WB-S7,9250,5013,269122353.6,1307,9463,8156,6290.284061,1943.558937
WB-S8,9250,5009,268907614,-919,9979,10898,6454.771811,2134.614003
WB-S9,9250,5016,269283408.2,-919,9979,10898,4912.789075,2677.156705
WB-W1,9250,5004,268639189.6,273,9572,9299,6399.308753,1906.091956
WB-W10,9250,5001,268478134.9,-320,9934,10254,5207.066787,2444.571923
WB-W2,9250,5006,268746559.3,688,9958,9270,7263.693168,1500.140852
WB-W3,9250,5006,268746559.3,775,9712,8937,6934.643028,1635.022351
WB-W4,9250,5014,269176038.5,-919,9979,10898,5619.402274,2367.985289
WB-W5,9250,5024,269712887.4,1356,9004,7648,7010.547174,1633.344852
WB-W6,9250,5016,269283408.2,1447,8717,7270,7302.080941,1336.857935
WB-W7,9250,5005,268692874.4,-796,9919,10715,5393.161638,2889.444552
WB-W8,9250,5007,268800244.2,890,9158,8268,6944.511883,1614.319885
WB-W9,9250,5018,269390778,1136,9919,8783,6346.619968,2037.182026
W01,9500,5279,283402534.3,-410,9958,10368,6950.539686,2047.050207
W02,9500,5281,283509904.1,313,9911,9598,7084.316607,1739.793711
W03,9500,5284,283670958.8,775,9428,8653,7096.344058,1502.620206
W04,9500,5288,283885698.3,720,9911,9191,7079.720688,1685.27554
W05,9500,5280,283456219.2,319,9958,9639,7209.142424,1599.05962
W06,9500,5278,283348849.4,775,9586,8811,7225.958318,1510.033924
W07,9500,5282,283563589,775,9712,8937,6987.183643,1570.797682
W08,9500,5280,283456219.2,1374,9712,8338,6892.861742,1784.999364
W09,9500,5281,283509904.1,1374,9712,8338,7028.917061,1554.500113
W10,9500,5287,283832013.4,1356,8717,7361,6711.794591,1909.495244
W11,9500,5279,283402534.3,273,9667,9394,6376.028414,1966.624406
W12,9500,5285,283724643.6,273,9983,9710,5895.372753,2297.635772
W13,9500,5287,283832013.4,273,9712,9439,6104.366938,2150.592771
W14,9500,5284,283670958.8,587,9712,9125,6508.051855,1976.484678
W15,9500,5283,283617273.9,587,9712,9125,6574.101458,2015.627751
W16,9500,5282,283563589,-240,9987,10227,6415.263726,2330.071589
W17,9500,5284,283670958.8,-11,9874,9885,6462.977101,2256.658097
W18,9500,5284,283670958.8,-919,9979,10898,6367.192089,2174.899324
W19,9500,5284,283670958.8,-919,9979,10898,6347.43187,2286.787076
W20,9500,5283,283617273.9,-919,9979,10898,6148.026879,2196.628181
W21,9500,5281,283509904.1,-867,9979,10846,6362.539102,2103.423284
W22,9500,5280,283456219.2,-919,9979,10898,5066.442424,2773.095263
W23,9500,5286,283778328.5,-919,9979,10898,5657.109535,2410.94414
W24,9500,5284,283670958.8,222,9983,9761,6017.619039,2259.83068
W25,9500,5288,283885698.3,-9,9560,9569,5934.15677,2145.458511
W26,9500,5287,283832013.4,-1058,9979,11037,4901.435975,2680.999016
W27,9500,5286,283778328.5,5,9012,9007,5826.298903,2278.223922
W28,9500,5289,283939383.2,222,9012,8790,6349.546984,1968.135581
W29,9500,5285,283724643.6,262,9012,8750,6401.817408,2037.056007
W30,9500,5284,283670958.8,651,9012,8361,6723.407835,1780.860009
W31,9500,5288,283885698.3,1427,8958,7531,7759.076021,819.5100956
W32,9500,5285,283724643.6,1406,9004,7598,7440.537181,1473.316305
W33,9500,5285,283724643.6,1109,9158,8049,7077.183538,1674.05389
W34,9500,5278,283348849.4,651,9203,8552,6300.535241,2173.81385
W35,9500,5288,283885698.3,1383,8958,7575,7112.368192,1598.326329
W36,9500,5284,283670958.8,1177,9677,8500,6844.717638,1740.919436
W37,9500,5291,284046753,1136,9919,8783,6949.339066,1723.330315
W38,9500,5280,283456219.2,1335,9107,7772,7449.224621,1082.048976
W39,9500,5295,284261492.5,1893,8909,7016,7328.009821,966.9969414
W40,9500,5287,283832013.4,882,9919,9037,6460.162474,2010.932439
W41,9500,5293,284154122.8,882,9046,8164,6359.755148,1951.975907
W42,9500,5292,284100437.9,882,9046,8164,6970.888322,1505.5995
W43,9500,5293,284154122.8,2307,8694,6387,7288.455318,879.4119257
W44,9500,5291,284046753,1400,8736,7336,6824.381969,1435.946656
W45,9500,5293,284154122.8,1400,8865,7465,6762.755715,1480.378169
W46,9500,5290,283993068.1,1276,8865,7589,6391.997732,1786.703788
W47,9500,5291,284046753,1276,8985,7709,6471.327915,1850.614464
W48,9500,5294,284207807.7,1398,9213,7815,7260.262939,1141.68017
W49,9500,5296,284315177.4,1276,8994,7718,6647.735838,1707.891468
W50,9500,5294,284207807.7,-858,9463,10321,6500.188326,1855.862081
W51,9500,5292,284100437.9,1307,9463,8156,6438.153439,1913.405198
W52,9500,5294,284207807.7,1318,9137,7819,6349.436154,1802.646994
W53,9500,5291,284046753,1307,8865,7558,6177.818371,1972.972762
W54,9500,5281,283509904.1,1059,8956,7897,5823.894717,2035.413844
W55,9500,5290,283993068.1,1007,9877,8870,6180.238941,2133.433424
W56,9500,5285,283724643.6,765,9919,9154,5661.271334,2251.77392
W57,9500,5288,283885698.3,209,9919,9710,5263.984493,2387.153427
W58,9500,5292,284100437.9,209,8990,8781,5475.787793,2347.996104
W59,9500,5290,283993068.1,377,9919,9542,5019.813043,2400.574903
W60,9500,5289,283939383.2,377,9203,8826,5898.928342,2328.374387
W61,9500,5284,283670958.8,651,9203,8552,6625.072483,1875.958929
W62,9500,5287,283832013.4,-1058,8764,9822,5533.472669,2521.922979
W63,9500,5286,283778328.5,-1058,9934,10992,4627.32955,2651.695258
W64,9500,5277,283295164.5,-1058,9934,10992,5095.446655,2458.492228
W65,9500,5291,284046753,-35,9000,9035,4764.06615,2364.149503
W66,9500,5288,283885698.3,-1422,9322,10744,4576.688729,2506.073473
WB-E1,9500,5285,283724643.6,222,9983,9761,5546.995459,2460.295202
WB-E10,9500,5287,283832013.4,377,9919,9542,4703.381691,2409.978709
WB-E2,9500,5287,283832013.4,-1058,9000,10058,5517.347834,2402.413571
WB-E3,9500,5293,284154122.8,1507,9044,7537,7203.587191,931.2611573
WB-E4,9500,5284,283670958.8,1496,8717,7221,7334.79296,1282.221956
WB-E5,9500,5288,283885698.3,222,9983,9761,5517.178139,2420.801246
WB-E6,9500,5297,284368862.3,2474,8694,6220,7298.915801,866.7135452
WB-E7,9500,5287,283832013.4,-1058,8843,9901,5644.151315,2418.399229
WB-E8,9500,5291,284046753,882,9919,9037,5642.794179,2247.942469
WB-E9,9500,5294,284207807.7,-1051,8956,10007,5670.129203,2160.515547
WB-H1,9500,5286,283778328.5,1276,8543,7267,6416.723231,1856.504676
WB-H10,9500,5292,284100437.9,1276,8865,7589,6354.683862,1804.806041
WB-H2,9500,5286,283778328.5,1374,8859,7485,7041.050511,1645.401584
WB-H3,9500,5282,283563589,651,9203,8552,6656.80159,2010.918599
WB-H4,9500,5291,284046753,1196,8865,7669,6254.133623,1982.990792
WB-H5,9500,5289,283939383.2,882,9919,9037,6070.212895,2157.739057
WB-H6,9500,5284,283670958.8,-410,9958,10368,6565.611469,2403.281099
WB-H7,9500,5284,283670958.8,-240,9987,10227,6691.129826,2217.518554
WB-H8,9500,5286,283778328.5,224,8990,8766,5589.577185,2289.727634
WB-H9,9500,5286,283778328.5,273,9359,9086,5764.350927,2318.751436
WB-S1,9500,5279,283402534.3,-448,9919,10367,6345.565637,2541.766354
WB-S10,9500,5282,283563589,-1058,9508,10566,4166.499432,2730.183674
WB-S11,9500,5288,283885698.3,-35,9000,9035,5260.757186,2398.275
WB-S12,9500,5287,283832013.4,377,9919,9542,4986.087006,2374.66335
WB-S13,9500,5294,284207807.7,882,9046,8164,6059.727238,2137.487453
WB-S14,9500,5296,284315177.4,1196,9046,7850,6554.77568,1736.923824
WB-S15,9500,5283,283617273.9,1276,8865,7589,6394.083097,1788.953784
WB-S16,9500,5285,283724643.6,222,9983,9761,5903.757616,2290.357936
WB-S17,9500,5285,283724643.6,651,9012,8361,6637.171618,1822.117979
WB-S18,9500,5287,283832013.4,651,9203,8552,6194.54076,2204.100943
WB-S19,9500,5292,284100437.9,1175,9677,8502,6653.116402,1849.010873
WB-S2,9500,5287,283832013.4,-1438,9985,11423,4060.110081,3384.337309
WB-S20,9500,5290,283993068.1,1136,9107,7971,7039.134972,1608.321263
WB-S21,9500,5293,284154122.8,1400,8909,7509,7249.259777,1019.043045
WB-S22,9500,5292,284100437.9,1748,8949,7201,7309.829743,841.4542708
WB-S23,9500,5281,283509904.1,290,9983,9693,6574.015717,1948.519602
WB-S24,9500,5286,283778328.5,273,9712,9439,5880.103103,2250.657065
WB-S25,9500,5285,283724643.6,636,8962,8326,6819.495743,1753.592431
WB-S26,9500,5289,283939383.2,1109,9158,8049,7157.046512,1743.184504
WB-S27,9500,5286,283778328.5,1427,8958,7531,7631.875142,1047.209258
WB-S28,9500,5277,283295164.5,775,9428,8653,7117.438696,1605.176575
WB-S29,9500,5283,283617273.9,775,9712,8937,6943.664963,1684.241507
WB-S3,9500,5285,283724643.6,-1422,9934,11356,5001.519016,2558.263105
WB-S4,9500,5287,283832013.4,18,8990,8972,4228.326839,2390.743154
WB-S5,9500,5291,284046753,209,8990,8781,5639.829333,2288.969689
WB-S6,9500,5292,284100437.9,1059,8956,7897,6123.497354,2074.055181
WB-S7,9500,5292,284100437.9,1307,9463,8156,6287.996977,1939.475512
WB-S8,9500,5285,283724643.6,-919,9979,10898,6403.654683,2175.850254
WB-S9,9500,5287,283832013.4,-919,9979,10898,4924.031209,2686.663562
WB-W1,9500,5276,283241479.6,273,9593,9320,6409.489575,1935.549475
WB-W10,9500,5289,283939383.2,-320,9934,10254,5214.337871,2446.956148
WB-W2,9500,5281,283509904.1,688,9958,9270,7261.718993,1515.958123
WB-W3,9500,5285,283724643.6,587,9712,9125,6936.909177,1654.473147
WB-W4,9500,5285,283724643.6,-919,9979,10898,5583.405298,2394.945361
WB-W5,9500,5290,283993068.1,1180,9004,7824,6987.567108,1657.853897
WB-W6,9500,5285,283724643.6,1447,8717,7270,7286.917313,1343.520238
WB-W7,9500,5281,283509904.1,-919,9919,10838,5368.457489,2894.081483
WB-W8,9500,5287,283832013.4,890,9158,8268,6922.340458,1640.898777
WB-W9,9500,5289,283939383.2,1136,9919,8783,6339.860654,2048.494882
W01,9750,5558,298380618.6,-410,9958,10368,6943.88701,2051.231085
W02,9750,5561,298541673.3,313,9911,9598,7067.677037,1749.098792
W03,9750,5564,298702728,775,9491,8716,7100.209022,1501.838426
W04,9750,5568,298917467.5,714,9911,9197,7081.314476,1690.808415
W05,9750,5564,298702728,319,9958,9639,7217.814702,1602.69276
W06,9750,5568,298917467.5,775,9586,8811,7243.623922,1503.517427
W07,9750,5563,298649043.1,775,9712,8937,6996.20133,1577.198152
W08,9750,5570,299024837.3,1374,9712,8338,6890.018312,1788.774099
W09,9750,5565,298756412.9,587,9712,9125,6985.883558,1607.413363
W10,9750,5566,298810097.7,1356,8717,7361,6718.716134,1896.59339
W11,9750,5567,298863782.6,273,9743,9470,6389.324232,1987.82767
W12,9750,5564,298702728,273,9983,9710,5941.453091,2288.498889
W13,9750,5570,299024837.3,273,9712,9439,6113.739856,2153.272502
W14,9750,5565,298756412.9,587,9712,9125,6508.971788,1973.36068
W15,9750,5564,298702728,587,9712,9125,6560.562365,2015.428228
W16,9750,5560,298487988.4,-240,9987,10227,6430.54946,2309.525217
W17,9750,5561,298541673.3,-11,9874,9885,6465.232332,2239.1593
W18,9750,5563,298649043.1,-919,9979,10898,6366.584756,2175.382772
W19,9750,5568,298917467.5,-919,9979,10898,6349.952945,2287.004977
W20,9750,5568,298917467.5,-919,9979,10898,6132.233836,2213.247716
W21,9750,5562,298595358.2,-867,9979,10846,6353.345559,2117.9042
W22,9750,5570,299024837.3,-919,9979,10898,5103.639138,2782.791629
W23,9750,5565,298756412.9,-919,9979,10898,5627.718778,2434.11003
W24,9750,5563,298649043.1,222,9983,9761,6036.599497,2259.475431
W25,9750,5569,298971152.4,-867,9560,10427,5914.595978,2165.34984
W26,9750,5568,298917467.5,-1058,9979,11037,4924.11153,2684.564078
W27,9750,5568,298917467.5,-159,9012,9171,5812.718211,2287.281914
W28,9750,5565,298756412.8,222,9012,8790,6322.363881,1985.708169
W29,9750,5563,298649043.1,262,9012,8750,6393.717778,2046.281928
W30,9750,5568,298917467.5,651,9012,8361,6687.908585,1824.998594
W31,9750,5573,299185892,1427,8958,7531,7746.45218,840.4524768
W32,9750,5569,298971152.4,1406,9158,7752,7428.556832,1480.839892
W33,9750,5565,298756412.9,1109,9158,8049,7055.773765,1697.827223
W34,9750,5570,299024837.3,651,9203,8552,6342.224596,2157.568895
W35,9750,5572,299132207.1,1383,8958,7575,7130.131371,1592.820595
W36,9750,5568,298917467.5,1177,9677,8500,6847.391523,1742.082354
W37,9750,5568,298917467.5,1136,9919,8783,6949.012213,1728.424075
W38,9750,5572,299132207.1,1249,9107,7858,7422.302225,1115.823426
W39,9750,5573,299185892,1684,8909,7225,7326.519648,971.7949194
W40,9750,5571,299078522.2,882,9919,9037,6494.765931,1990.304782
W41,9750,5572,299132207.1,882,9046,8164,6364.883166,1953.284674
W42,9750,5573,299185892,882,9046,8164,6935.193791,1553.585711
W43,9750,5574,299239576.9,2307,8694,6387,7284.648726,879.4481785
W44,9750,5573,299185892,1400,8865,7465,6840.794186,1425.933085
W45,9750,5575,299293261.8,1400,8865,7465,6777.485561,1467.633673
W46,9750,5568,298917467.5,1276,8865,7589,6424.367996,1771.21896
W47,9750,5573,299185892,1276,8985,7709,6495.081464,1832.887616
W48,9750,5574,299239576.9,1398,9213,7815,7266.25601,1138.409148
W49,9750,5573,299185892,-134,8994,9128,6665.385071,1707.786171
W50,9750,5572,299132207.1,-858,9463,10321,6498.744257,1850.984214
W51,9750,5570,299024837.3,1307,9463,8156,6446.152065,1898.702174
W52,9750,5570,299024837.3,1318,9463,8145,6364.770736,1796.164096
W53,9750,5574,299239576.9,1307,8865,7558,6169.925906,1976.113868
W54,9750,5579,299508001.3,1059,8956,7897,5840.890303,2032.209343
W55,9750,5575,299293261.7,765,9877,9112,6168.356054,2141.557349
W56,9750,5565,298756412.9,765,9919,9154,5645.802336,2266.170611
W57,9750,5570,299024837.3,209,9919,9710,5255.247576,2384.327275
W58,9750,5574,299239576.9,209,8990,8781,5466.44277,2341.9672
W59,9750,5573,299185892,377,9919,9542,5012.132065,2398.384962
W60,9750,5569,298971152.4,377,9203,8826,5849.659903,2356.430416
W61,9750,5565,298756412.9,204,9203,8999,6600.816352,1893.667877
W62,9750,5567,298863782.6,-1058,8764,9822,5543.006107,2515.429632
W63,9750,5570,299024837.3,-1438,9934,11372,4610.036984,2683.03053
W64,9750,5568,298917467.5,-1058,9934,10992,5124.775682,2448.250795
W65,9750,5571,299078522.2,-35,9000,9035,4803.053132,2360.125218
W66,9750,5568,298917467.5,-1422,9906,11328,4588.663075,2508.391144
WB-E1,9750,5570,299024837.3,222,9983,9761,5623.583124,2449.918673
WB-E10,9750,5567,298863782.6,377,9919,9542,4763.447279,2425.048039
WB-E2,9750,5570,299024837.3,-1058,9000,10058,5472.617235,2421.748731
WB-E3,9750,5574,299239576.9,1507,9044,7537,7199.315034,945.881938
WB-E4,9750,5564,298702728,1447,8717,7270,7319.307513,1307.079501
WB-E5,9750,5568,298917467.5,222,9983,9761,5571.056932,2400.893681
WB-E6,9750,5573,299185892,2474,8694,6220,7300.483582,860.2559307
WB-E7,9750,5563,298649043.1,-1058,8843,9901,5619.297322,2435.635966
WB-E8,9750,5571,299078522.2,882,9919,9037,5631.481781,2253.740109
WB-E9,9750,5578,299454316.4,-1051,8956,10007,5657.727501,2169.158689
WB-H1,9750,5581,299615371.1,1276,8543,7267,6435.546855,1840.244036
WB-H10,9750,5573,299185892,1276,8865,7589,6380.378791,1788.924679
WB-H2,9750,5570,299024837.3,1374,8859,7485,7037.478636,1643.386105
WB-H3,9750,5566,298810097.7,651,9203,8552,6679.099713,1981.322487
WB-H4,9750,5573,299185892,1196,8865,7669,6231.210479,1994.680377
WB-H5,9750,5571,299078522.2,882,9919,9037,6091.065518,2150.00241
WB-H6,9750,5562,298595358.2,-410,9958,10368,6574.393384,2398.442135
WB-H7,9750,5564,298702728,-240,9987,10227,6673.560568,2231.523876
WB-H8,9750,5568,298917467.5,224,8990,8766,5574.759698,2280.488113
WB-H9,9750,5565,298756412.9,273,9523,9250,5810.237916,2306.316737
WB-S1,9750,5567,298863782.6,-448,9919,10367,6345.463625,2553.745636
WB-S10,9750,5562,298595358.2,-1058,9508,10566,4220.096009,2735.221475
WB-S11,9750,5570,299024837.3,-35,9000,9035,5256.474865,2397.833917
WB-S12,9750,5569,298971152.4,377,9919,9542,4989.331119,2377.459186
WB-S13,9750,5572,299132207.1,882,9046,8164,6063.107861,2133.419819
WB-S14,9750,5578,299454316.4,1196,9046,7850,6525.651847,1761.991198
WB-S15,9750,5578,299454316.4,1276,8865,7589,6423.484224,1776.416052
WB-S16,9750,5570,299024837.3,222,9983,9761,5947.316697,2270.569786
WB-S17,9750,5564,298702728,651,9021,8370,6606.781812,1851.977186
WB-S18,9750,5567,298863782.6,651,9203,8552,6192.277528,2197.674986
WB-S19,9750,5569,298971152.4,1175,9677,8502,6652.847728,1861.13188
WB-S2,9750,5569,298971152.4,-1438,9985,11423,4077.186389,3362.612942
WB-S20,9750,5572,299132207.1,1136,9677,8541,7020.456927,1627.673869
WB-S21,9750,5574,299239576.9,1400,8909,7509,7261.419089,1012.603464
WB-S22,9750,5575,299293261.8,1748,9044,7296,7305.229417,858.1077267
WB-S23,9750,5562,298595358.2,290,9983,9693,6592.520496,1950.010215
WB-S24,9750,5565,298756412.8,273,9712,9439,5930.624618,2252.920185
WB-S25,9750,5566,298810097.7,636,8962,8326,6805.477183,1771.143257
WB-S26,9750,5570,299024837.3,1109,9158,8049,7143.48079,1745.967426
WB-S27,9750,5569,298971152.4,1427,8994,7567,7633.034656,1039.733194
WB-S28,9750,5562,298595358.2,775,9428,8653,7121.755843,1595.689698
WB-S29,9750,5561,298541673.3,775,9712,8937,6917.197626,1709.28772
WB-S3,9750,5566,298810097.7,-1422,9934,11356,4999.708049,2558.842441
WB-S4,9750,5570,299024837.3,18,8990,8972,4229.135907,2387.767599
WB-S5,9750,5573,299185892,209,8990,8781,5633.431545,2284.708333
WB-S6,9750,5575,299293261.7,1059,8956,7897,6120.769148,2072.830394
WB-S7,9750,5574,299239576.9,1307,9463,8156,6275.652494,1940.647802
WB-S8,9750,5564,298702728,-919,9979,10898,6366.590582,2210.718061
WB-S9,9750,5568,298917467.5,-919,9979,10898,4934.261494,2695.404176
WB-W1,9750,5563,298649043.1,273,9673,9400,6425.932051,1956.370517
WB-W10,9750,5570,299024837.3,-320,9934,10254,5231.21526,2439.073873
WB-W2,9750,5562,298595358.2,688,9958,9270,7254.831895,1532.626894
WB-W3,9750,5560,298487988.4,587,9712,9125,6943.278237,1671.269769
WB-W4,9750,5568,298917467.5,-919,9979,10898,5551.898168,2418.937205
WB-W5,9750,5573,299185892,1180,9004,7824,6956.000897,1685.202527
WB-W6,9750,5565,298756412.9,1447,8717,7270,7273.7177,1353.740635
WB-W7,9750,5568,298917467.5,-919,9979,10898,5362.838721,2894.656848
WB-W8,9750,5566,298810097.7,651,9158,8507,6898.221524,1673.654097
WB-W9,9750,5569,298971152.4,1136,9919,8783,6343.049021,2053.956135
W01,10000,5848,313949236.7,-410,9958,10368,6940.244015,2051.184808
W02,10000,5851,314110291.4,313,9911,9598,7039.600239,1767.913291
W03,10000,5855,314325031,775,9491,8716,7105.332536,1501.478703
W04,10000,5852,314163976.3,313,9958,9645,7085.222317,1693.60839
W05,10000,5849,314002921.6,319,9958,9639,7215.447769,1619.978614
W06,10000,5852,314163976.3,775,9678,8903,7252.201299,1501.668071
W07,10000,5855,314325031,736,9712,8976,6990.691546,1599.815458
W08,10000,5855,314325031,1374,9712,8338,6890.365329,1786.094236
W09,10000,5851,314110291.4,587,9712,9125,6933.859682,1661.450371
W10,10000,5853,314217661.2,1356,8793,7437,6730.140612,1879.56176
W11,10000,5852,314163976.3,273,9743,9470,6402.350478,2003.722846
W12,10000,5858,314486085.6,273,9983,9710,5984.980539,2275.710688
W13,10000,5849,314002921.6,273,9712,9439,6132.832621,2148.10721
W14,10000,5858,314486085.6,273,9712,9439,6510.367019,1967.565674
W15,10000,5852,314163976.3,587,9712,9125,6557.163705,2006.176045
W16,10000,5845,313788182.1,-240,9987,10227,6450.623781,2285.651211
W17,10000,5852,314163976.3,-11,9874,9885,6467.30417,2224.243588
W18,10000,5856,314378715.8,-919,9979,10898,6356.985656,2180.536044
W19,10000,5855,314325030.9,-919,9979,10898,6343.314432,2298.372695
W20,10000,5850,314056606.5,-919,9979,10898,6113.14906,2229.433018
W21,10000,5858,314486085.6,-867,9979,10846,6353.750768,2124.972191
W22,10000,5853,314217661.2,-919,9979,10898,5142.946865,2787.764939
W23,10000,5855,314325031,-919,9979,10898,5604.102647,2455.848044
W24,10000,5852,314163976.3,222,9983,9761,6052.799556,2258.304874
W25,10000,5852,314163976.3,-867,9560,10427,5899.154306,2184.870153
W26,10000,5858,314486085.6,-1058,9979,11037,4956.333561,2688.850148
W27,10000,5851,314110291.4,-159,9012,9171,5799.370022,2286.891143
W28,10000,5856,314378715.8,222,9012,8790,6289.657787,2012.267055
W29,10000,5859,314539770.5,262,9012,8750,6385.641065,2058.842566
W30,10000,5854,314271346.1,651,9012,8361,6658.381107,1857.759353
W31,10000,5861,314647140.3,1427,8958,7531,7730.717284,863.8363298
W32,10000,5860,314593455.4,1406,9158,7752,7405.389932,1500.64353
W33,10000,5855,314325031,1109,9158,8049,7031.991631,1720.649007
W34,10000,5860,314593455.4,651,9203,8552,6368.834983,2146.939578
W35,10000,5858,314486085.6,1383,9134,7751,7148.901332,1586.878991
W36,10000,5861,314647140.3,1136,9677,8541,6855.811977,1738.333623
W37,10000,5858,314486085.6,1136,9919,8783,6943.524752,1737.325285
W38,10000,5865,314861879.9,1249,9107,7858,7400.147826,1134.391447
W39,10000,5859,314539770.5,1684,8909,7225,7328.145588,974.6496285
W40,10000,5857,314432400.7,882,9919,9037,6519.227079,1972.623071
W41,10000,5863,314754510.1,882,9046,8164,6375.463244,1950.350598
W42,10000,5858,314486085.6,882,9046,8164,6911.226357,1582.484899
W43,10000,5859,314539770.5,1748,8694,6946,7280.769756,882.1015236
W44,10000,5862,314700825.2,1400,8865,7465,6853.879052,1413.200449
W45,10000,5860,314593455.4,1400,8865,7465,6792.667406,1454.109906
W46,10000,5861,314647140.3,1276,8865,7589,6455.825115,1756.9957
W47,10000,5863,314754510.1,1276,8985,7709,6524.074706,1815.843938
W48,10000,5867,314969249.6,1398,9280,7882,7271.855292,1137.285405
W49,10000,5863,314754510.1,-858,8994,9852,6681.070612,1714.300177
W50,10000,5869,315076619.4,-858,9463,10321,6508.202079,1845.39263
W51,10000,5866,314915564.7,1307,9463,8156,6462.383737,1881.460264
W52,10000,5867,314969249.6,1318,9463,8145,6380.258394,1791.864876
W53,10000,5865,314861879.9,1283,8865,7582,6158.916283,1982.419644
W54,10000,5865,314861879.9,1059,8956,7897,5849.198295,2028.507441
W55,10000,5855,314325030.9,765,9877,9112,6155.069513,2148.771078
W56,10000,5858,314486085.6,765,9919,9154,5635.059406,2277.158392
W57,10000,5855,314325031,209,9919,9710,5247.191802,2382.41832
W58,10000,5855,314325030.9,209,8990,8781,5460.646627,2337.157496
W59,10000,5857,314432400.7,377,9919,9542,4997.734506,2400.933681
W60,10000,5856,314378715.8,377,9203,8826,5814.357582,2377.240674
W61,10000,5852,314163976.3,204,9203,8999,6564.331852,1922.761289
W62,10000,5857,314432400.7,-1058,8764,9822,5546.451938,2508.044645
W63,10000,5852,314163976.3,-1438,9934,11372,4585.365516,2714.004995
W64,10000,5862,314700825.2,-1058,9934,10992,5154.837086,2436.639147
W65,10000,5855,314325030.9,-35,9000,9035,4832.832792,2356.716554
W66,10000,5857,314432400.7,-1422,9906,11328,4605.019122,2514.035116
WB-E1,10000,5854,314271346.1,222,9983,9761,5694.782029,2434.593542
WB-E10,10000,5856,314378715.8,377,9919,9542,4809.576332,2437.565723
WB-E2,10000,5858,314486085.6,-1058,9000,10058,5429.651246,2438.813124
WB-E3,10000,5862,314700825.2,1507,9044,7537,7196.32378,960.1027825
WB-E4,10000,5859,314539770.5,1447,8717,7270,7299.421915,1332.65686
WB-E5,10000,5851,314110291.4,222,9983,9761,5616.600923,2382.801617
WB-E6,10000,5864,314808195,2474,8694,6220,7302.9294,853.7406433
WB-E7,10000,5858,314486085.6,-1058,8843,9901,5592.861898,2444.848138
WB-E8,10000,5859,314539770.5,882,9919,9037,5611.552995,2261.63733
WB-E9,10000,5863,314754510.1,-1051,8990,10041,5639.849736,2174.563423
WB-H1,10000,5870,315130304.3,1276,8543,7267,6453.109199,1826.305929
WB-H10,10000,5865,314861879.9,1276,8865,7589,6405.63734,1778.26872
WB-H2,10000,5851,314110291.4,1374,9132,7758,7037.282174,1638.213473
WB-H3,10000,5858,314486085.6,651,9203,8552,6710.104643,1949.931065
WB-H4,10000,5864,314808195,1196,8865,7669,6213.813608,2003.213202
WB-H5,10000,5862,314700825.2,882,9919,9037,6125.808086,2138.641948
WB-H6,10000,5856,314378715.8,-410,9958,10368,6587.218921,2389.074869
WB-H7,10000,5851,314110291.4,-240,9987,10227,6647.328662,2244.41512
WB-H8,10000,5860,314593455.4,224,8990,8766,5555.433447,2272.607845
WB-H9,10000,5857,314432400.7,273,9560,9287,5870.445621,2293.483723
WB-S1,10000,5857,314432400.7,-448,9953,10401,6339.048148,2558.494823
WB-S10,10000,5853,314217661.2,-1058,9508,10566,4266.422177,2744.806645
WB-S11,10000,5859,314539770.5,-35,9000,9035,5240.677249,2403.802421
WB-S12,10000,5856,314378715.8,377,9919,9542,4990.140198,2382.359132
WB-S13,10000,5858,314486085.6,882,9919,9037,6068.255207,2131.214418
WB-S14,10000,5868,315022934.5,1196,9046,7850,6497.359237,1783.002129
WB-S15,10000,5866,314915564.7,1276,8865,7589,6452.800375,1760.835886
WB-S16,10000,5852,314163976.3,222,9983,9761,5990.984279,2251.401517
WB-S17,10000,5852,314163976.3,651,9021,8370,6571.228811,1891.045063
WB-S18,10000,5859,314539770.5,651,9203,8552,6191.512886,2188.6773
WB-S19,10000,5858,314486085.6,1175,9677,8502,6657.656367,1870.270251
WB-S2,10000,5851,314110291.4,-1438,9985,11423,4101.687233,3347.95818
WB-S20,10000,5861,314647140.3,1136,9677,8541,7002.921174,1645.13061
WB-S21,10000,5865,314861879.9,1400,8909,7509,7272.158568,1010.269398
WB-S22,10000,5861,314647140.3,1522,9044,7522,7303.757891,868.6623671
WB-S23,10000,5852,314163976.3,290,9983,9693,6608.599795,1947.195439
WB-S24,10000,5854,314271346.1,273,9712,9439,5965.964298,2260.015064
WB-S25,10000,5860,314593455.4,636,8962,8326,6793.507338,1786.591089
WB-S26,10000,5858,314486085.6,1109,9158,8049,7126.955104,1754.945414
WB-S27,10000,5859,314539770.5,1427,8994,7567,7629.663082,1041.846977
WB-S28,10000,5849,314002921.6,775,9428,8653,7122.394939,1585.331579
WB-S29,10000,5852,314163976.3,587,9712,9125,6894.225393,1734.484889
WB-S3,10000,5857,314432400.7,-1422,9934,11356,5009.479768,2555.095553
WB-S4,10000,5860,314593455.4,-35,8990,9025,4237.017406,2381.716157
WB-S5,10000,5860,314593455.4,209,8990,8781,5627.99727,2276.871943
WB-S6,10000,5859,314539770.5,1059,8956,7897,6116.093702,2073.670872
WB-S7,10000,5866,314915564.7,1276,9463,8187,6276.99625,1934.660803
WB-S8,10000,5854,314271346.1,-919,9979,10898,6334.295866,2233.717726
WB-S9,10000,5852,314163976.3,-919,9979,10898,4946.06203,2704.577879
WB-W1,10000,5858,314486085.6,273,9743,9470,6435.365142,1972.230102
WB-W10,10000,5856,314378715.8,-320,9934,10254,5239.189549,2433.136597
WB-W2,10000,5851,314110291.4,657,9958,9301,7251.4671,1544.091192
WB-W3,10000,5859,314539770.5,587,9712,9125,6938.601297,1689.386899
WB-W4,10000,5857,314432400.7,-919,9979,10898,5525.927949,2436.620837
WB-W5,10000,5854,314271346.1,1058,9004,7946,6924.96054,1709.058771
WB-W6,10000,5858,314486085.6,1447,8717,7270,7258.430693,1371.657294
WB-W7,10000,5853,314217661.2,-919,9979,10898,5368.953186,2891.8998
WB-W8,10000,5858,314486085.6,651,9158,8507,6870.715944,1710.824075
WB-W9,10000,5858,314486085.6,1007,9919,8912,6340.769034,2063.52244
