CAMERA_DISTANCE,CAMERA,RADIUS,NCELLS,AREA,MIN,MAX,RANGE,MEAN,STD
W01 250,W01,250,3,161054.67,7352,8315,963,7875.333333,397.5695607
W02 250,W02,250,4,214739.56,7702,8037,335,7875,119.0735067
W03 250,W03,250,4,214739.56,8421,8584,163,8503,81.00308636
W04 250,W04,250,4,214739.56,8498,8707,209,8602.5,104.5
W05 250,W05,250,3,161054.67,7679,8051,372,7927,175.3624817
W06 250,W06,250,4,214739.56,7625,8027,402,7926.5,174.0711062
W07 250,W07,250,3,161054.67,6863,7948,1085,7447.333333,446.8827835
W08 250,W08,250,4,214739.56,7464,8614,1150,7751.5,497.9646072
W09 250,W09,250,3,161054.67,7960,8162,202,8094.666667,95.2237132
W10 250,W10,250,4,214739.56,8255,8622,367,8435.25,155.4579927
W11 250,W11,250,4,214739.56,6234,7932,1698,6996.25,612.329313
W12 250,W12,250,4,214739.56,5000,5512,512,5283.5,222.5865
W13 250,W13,250,4,214739.56,5366,6439,1073,6169.75,464.0459972
W14 250,W14,250,3,161054.67,6289,7760,1471,7069.333333,603.8710311
W15 250,W15,250,3,161054.67,5547,7809,2262,6846.666667,953.7666847
W16 250,W16,250,3,161054.67,8242,8351,109,8287.333333,46.34891824
W17 250,W17,250,3,161054.67,8251,8301,50,8281.333333,21.76133166
W18 250,W18,250,4,214739.56,8118,8453,335,8282.5,164.5547022
W19 250,W19,250,4,214739.56,7395,7484,89,7417.25,38.53813047
W20 250,W20,250,4,214739.56,6512,7684,1172,7110,414.6926573
W21 250,W21,250,4,214739.56,7028,8036,1008,7770.25,429.1260741
W22 250,W22,250,4,214739.56,6280,7940,1660,7173,591.4587898
W23 250,W23,250,3,161054.67,4547,4792,245,4710.333333,115.4941076
W24 250,W24,250,3,161054.67,8280,8338,58,8304,24.71167066
W25 250,W25,250,4,214739.56,7644,8629,985,8306.25,388.0788419
W26 250,W26,250,4,214739.56,4364,7764,3400,6167.5,1206.529009
W27 250,W27,250,4,214739.56,7704,7788,84,7765,35.25620513
W28 250,W28,250,3,161054.67,7006,8325,1319,7445.666667,621.7825629
W29 250,W29,250,3,161054.67,6930,7939,1009,7338.333333,433.7928333
W30 250,W30,250,4,214739.56,5483,7295,1812,6569.5,669.4017852
W31 250,W31,250,4,214739.56,8535,8690,155,8607.25,66.20186931
W32 250,W32,250,4,214739.56,7958,8369,411,8241,166.1851377
W33 250,W33,250,3,161054.67,7821,7854,33,7843,15.55634919
W34 250,W34,250,4,214739.56,8836,8886,50,8873.5,21.65063509
W35 250,W35,250,4,214739.56,7227,8362,1135,7795.5,532.2539338
W36 250,W36,250,3,161054.67,8209,8385,176,8326.333333,82.96719566
W37 250,W37,250,4,214739.56,8621,8827,206,8775.5,89.20061659
W38 250,W38,250,4,214739.56,8492,8565,73,8527.75,29.10648553
W39 250,W39,250,4,214739.56,5440,7028,1588,6555.5,646.9777817
W40 250,W40,250,4,214739.56,8632,8751,119,8674.5,48.8287825
W41 250,W41,250,4,214739.56,8618,8645,27,8632.25,12.79404158
W42 250,W42,250,4,214739.56,8307,8456,149,8418.75,64.51889258
W43 250,W43,250,4,214739.56,7529,7801,272,7665,136
W44 250,W44,250,3,161054.67,7092,7201,109,7164.666667,51.38309277
W45 250,W45,250,4,214739.56,6222,8398,2176,7572,812.7213545
W46 250,W46,250,3,161054.67,5706,8049,2343,7187.333333,1052.109732
W47 250,W47,250,3,161054.67,8671,8671,0,8671,0
W48 250,W48,250,3,161054.67,7813,7913,100,7846.333333,47.14045208
W49 250,W49,250,4,214739.56,8559,8627,68,8593,34
W50 250,W50,250,4,214739.56,7636,7668,32,7645.75,12.96871235
W51 250,W51,250,3,161054.67,8078,8334,256,8184,109.0443335
W52 250,W52,250,4,214739.56,6514,6514,0,6514,0
W53 250,W53,250,4,214739.56,7634,7701,67,7672.25,29.52435435
W54 250,W54,250,4,214739.56,7497,8363,866,7915.25,418.7698503
W55 250,W55,250,4,214739.56,8544,8652,108,8600.5,51.1492913
W56 250,W56,250,3,161054.67,7905,8428,523,8102.666667,231.8136225
W57 250,W57,250,3,161054.67,5174,7001,1827,6392,861.2560595
W58 250,W58,250,4,214739.56,7625,7630,5,7628.75,2.165063509
W59 250,W59,250,4,214739.56,5622,7813,2191,7265.25,948.7308298
W60 250,W60,250,4,214739.56,7939,7967,28,7949.75,11.69134295
W61 250,W61,250,3,161054.67,3077,6022,2945,4685.666667,1217.615247
W62 250,W62,250,4,214739.56,5641,6769,1128,6487,488.4383277
W63 250,W63,250,3,161054.67,8145,8707,562,8332.333333,264.9293407
W64 250,W64,250,3,161054.67,7324,7575,251,7424,108.6308735
W65 250,W65,250,4,214739.56,7156,7234,78,7186.25,32.36027657
W66 250,W66,250,3,161054.67,6404,6532,128,6472,52.56107559
WB_ E1 250,WB_ E1,250,4,214739.56,2006,4412,2406,3226.25,987.3642628
WB_ E10 250,WB_ E10,250,3,161054.67,2670,3705,1035,3355.666667,484.8685962
WB_ E2 250,WB_ E2,250,4,214739.56,8071,8078,7,8076.25,3.031088913
WB_ E3 250,WB_ E3,250,4,214739.56,7633,7753,120,7682.75,43.64845358
WB_ E4 250,WB_ E4,250,3,161054.67,8637,8666,29,8646.666667,13.6707311
WB_ E5 250,WB_ E5,250,4,214739.56,3983,8503,4520,6939,1743.047905
WB_ E6 250,WB_ E6,250,4,214739.56,7908,7926,18,7917,9
WB_ E7 250,WB_ E7,250,4,214739.56,7461,8407,946,7915.5,377.4450291
WB_ E8 250,WB_ E8,250,4,214739.56,8088,8523,435,8306,217.0011521
WB_ E9 250,WB_ E9,250,4,214739.56,7780,7822,42,7797.75,15.2048512
WB_ H1 250,WB_ H1,250,4,214739.56,6448,7341,893,6862.5,336.3156999
WB_ H10 250,WB_ H10,250,3,161054.67,6127,6372,245,6290.333333,115.4941076
WB_ H2 250,WB_ H2,250,4,214739.56,6988,8844,1856,7875,709.7288215
WB_ H3 250,WB_ H3,250,3,161054.67,6024,7559,1535,6634.333333,664.9111887
WB_ H4 250,WB_ H4,250,4,214739.56,7272,8264,992,7796.5,469.2342166
WB_ H5 250,WB_ H5,250,4,214739.56,3163,5549,2386,4592.5,1013.290062
WB_ H6 250,WB_ H6,250,4,214739.56,7483,9313,1830,8231.25,668.3181783
WB_ H7 250,WB_ H7,250,4,214739.56,3805,7705,3900,5755,1950
WB_ H8 250,WB_ H8,250,3,161054.67,5371,7267,1896,6003,893.7829714
WB_ H9 250,WB_ H9,250,4,214739.56,5323,5458,135,5398.5,48.55151903
WB_ S1 250,WB_ S1,250,4,214739.56,5155,7849,2694,7089.5,1119.08925
WB_ S10 250,WB_ S10,250,3,161054.67,7110,8547,1437,7676.333333,624.8766989
WB_ S11 250,WB_ S11,250,3,161054.67,7466,8054,588,7696.333333,256.3803598
WB_ S12 250,WB_ S12,250,4,214739.56,5834,6178,344,6019.25,124.353076
WB_ S13 250,WB_ S13,250,4,214739.56,5977,7131,1154,6692.5,431.201519
WB_ S14 250,WB_ S14,250,4,214739.56,7399,7616,217,7504,98.18095538
WB_ S15 250,WB_ S15,250,4,214739.56,6885,8049,1164,7637,445.2662125
WB_ S16 250,WB_ S16,250,4,214739.56,6273,6723,450,6595.5,186.5978296
WB_ S17 250,WB_ S17,250,4,214739.56,6953,7962,1009,7492.75,385.1015288
WB_ S18 250,WB_ S18,250,4,214739.56,6703,8089,1386,7510,503.1108228
WB_ S19 250,WB_ S19,250,4,214739.56,7506,8238,732,7865,359.1364643
WB_ S2 250,WB_ S2,250,4,214739.56,6059,6059,0,6059,0
WB_ S20 250,WB_ S20,250,4,214739.56,8645,8679,34,8659.25,13.71814492
WB_ S21 250,WB_ S21,250,4,214739.56,7599,7842,243,7746,101.8700152
WB_ S22 250,WB_ S22,250,4,214739.56,7581,7712,131,7646.5,65.5
WB_ S23 250,WB_ S23,250,4,214739.56,7067,7614,547,7403,203.2941219
WB_ S24 250,WB_ S24,250,4,214739.56,2498,6482,3984,5334.75,1656.317508
WB_ S25 250,WB_ S25,250,4,214739.56,7611,7672,61,7655,25.56364606
WB_ S26 250,WB_ S26,250,4,214739.56,8866,8866,0,8866,0
WB_ S27 250,WB_ S27,250,4,214739.56,8403,8609,206,8503.25,73.26109131
WB_ S28 250,WB_ S28,250,3,161054.67,8767,8780,13,8775.666667,6.128258771
WB_ S29 250,WB_ S29,250,3,161054.67,4761,4913,152,4811.666667,71.65348716
WB_ S3 250,WB_ S3,250,3,161054.67,6706,6965,259,6878.666667,122.0937709
WB_ S4 250,WB_ S4,250,4,214739.56,2742,4321,1579,3595.25,587.5744102
WB_ S5 250,WB_ S5,250,4,214739.56,2136,6733,4597,4389.75,2210.546468
WB_ S6 250,WB_ S6,250,4,214739.56,6943,7014,71,6996.25,30.74390183
WB_ S7 250,WB_ S7,250,3,161054.67,7980,8110,130,8066.666667,61.2825877
WB_ S8 250,WB_ S8,250,4,214739.56,8311,8418,107,8364.5,53.5
WB_ S9 250,WB_ S9,250,4,214739.56,2163,4771,2608,3963.5,1060.015212
WB_ W1 250,WB_ W1,250,4,214739.56,6791,8110,1319,7630.5,507.1994184
WB_ W10 250,WB_ W10,250,3,161054.67,5622,6598,976,6081,400.5554477
WB_ W2 250,WB_ W2,250,4,214739.56,7960,8447,487,8235,197.5436661
WB_ W3 250,WB_ W3,250,3,161054.67,5772,7194,1422,6324.333333,622.385911
WB_ W4 250,WB_ W4,250,4,214739.56,4253,4427,174,4296.5,75.34421013
WB_ W5 250,WB_ W5,250,4,214739.56,7748,7944,196,7875.5,79.96405442
WB_ W6 250,WB_ W6,250,4,214739.56,8382,8699,317,8522.5,113.7552197
WB_ W7 250,WB_ W7,250,3,161054.67,7967,8247,280,8060.333333,131.9932658
WB_ W8 250,WB_ W8,250,3,161054.67,4831,6239,1408,5593,580.6364324
WB_ W9 250,WB_ W9,250,4,214739.56,8048,8253,205,8144.25,96.65499211
W01 500,W01,500,15,805273.35,7300,8315,1015,7738.933333,371.0352125
W02 500,W02,500,14,751588.46,7316,8076,760,7777.214286,195.4449789
W03 500,W03,500,14,751588.46,8231,8584,353,8436.5,96.20198246
W04 500,W04,500,15,805273.35,8377,8780,403,8595.533333,138.1621592
W05 500,W05,500,14,751588.46,7570,8102,532,7880.857143,183.2421728
W06 500,W06,500,16,858958.24,7140,8210,1070,7855.875,265.0876919
W07 500,W07,500,16,858958.24,6839,7949,1110,7502.125,407.2993179
W08 500,W08,500,16,858958.24,4445,8614,4169,7359.5625,1224.679855
W09 500,W09,500,15,805273.35,7960,8351,391,8142.533333,146.1341241
W10 500,W10,500,14,751588.46,8225,8673,448,8477.714286,130.9200566
W11 500,W11,500,15,805273.35,5802,8074,2272,6991.133333,745.6774876
W12 500,W12,500,16,858958.24,4821,5844,1023,5311.25,289.4273441
W13 500,W13,500,14,751588.46,4892,6553,1661,5912.357143,558.537837
W14 500,W14,500,16,858958.24,6289,8176,1887,7325.9375,685.3535099
W15 500,W15,500,15,805273.35,5505,8005,2500,6791.266667,892.70917
W16 500,W16,500,15,805273.35,7705,8401,696,8040.333333,247.1360399
W17 500,W17,500,14,751588.46,8230,8380,150,8322.285714,52.54851985
W18 500,W18,500,14,751588.46,7918,8470,552,8189.214286,222.7895158
W19 500,W19,500,14,751588.46,7395,8000,605,7630.5,252.5158411
W20 500,W20,500,14,751588.46,6438,8040,1602,7304.357143,492.3790072
W21 500,W21,500,16,858958.24,7028,8271,1243,7745.6875,447.9384331
W22 500,W22,500,15,805273.35,3784,7940,4156,6853,981.4514422
W23 500,W23,500,16,858958.24,4547,5922,1375,5023.625,438.5682494
W24 500,W24,500,15,805273.35,8218,8742,524,8451.266667,201.8225183
W25 500,W25,500,14,751588.46,7644,8642,998,8346.428571,303.0425982
W26 500,W26,500,14,751588.46,1450,8763,7313,6190.928571,2056.439276
W27 500,W27,500,15,805273.35,7055,7990,935,7727.333333,207.8334804
W28 500,W28,500,16,858958.24,5667,8656,2989,7277.25,858.6077757
W29 500,W29,500,15,805273.35,6930,8170,1240,7718.866667,396.1714892
W30 500,W30,500,16,858958.24,5483,7782,2299,6639.1875,725.8285971
W31 500,W31,500,15,805273.35,8506,8729,223,8616.733333,77.9491002
W32 500,W32,500,15,805273.35,7895,8767,872,8337.866667,250.4174825
W33 500,W33,500,15,805273.35,7698,8881,1183,8147.8,459.3025437
W34 500,W34,500,15,805273.35,8593,8905,312,8826.333333,86.47517306
W35 500,W35,500,15,805273.35,6625,8598,1973,7721.2,532.551744
W36 500,W36,500,15,805273.35,7943,8559,616,8325.866667,168.8229316
W37 500,W37,500,14,751588.46,7043,8827,1784,8347.071429,583.8548577
W38 500,W38,500,15,805273.35,8438,8630,192,8528.8,61.46240043
W39 500,W39,500,14,751588.46,5285,7697,2412,6493.857143,806.7414931
W40 500,W40,500,14,751588.46,8525,8751,226,8667,58.45266705
W41 500,W41,500,14,751588.46,7705,8645,940,8419.857143,338.6886175
W42 500,W42,500,14,751588.46,7445,8683,1238,8227.785714,413.2948063
W43 500,W43,500,14,751588.46,7529,7870,341,7724.357143,147.7636178
W44 500,W44,500,15,805273.35,6678,8135,1457,7251.866667,419.9255278
W45 500,W45,500,16,858958.24,3309,8398,5089,7133.125,1570.238711
W46 500,W46,500,14,751588.46,4921,8049,3128,7172.428571,1074.464831
W47 500,W47,500,15,805273.35,5845,8687,2842,8099.733333,849.4695966
W48 500,W48,500,16,858958.24,7673,8528,855,7900.875,173.9730134
W49 500,W49,500,14,751588.46,8559,8717,158,8617.142857,54.45424966
W50 500,W50,500,15,805273.35,7482,8386,904,7668,198.7890004
W51 500,W51,500,15,805273.35,7169,8506,1337,8137,403.5036555
W52 500,W52,500,14,751588.46,4175,6514,2339,5494.571429,997.9671992
W53 500,W53,500,14,751588.46,7601,8249,648,7722.214286,163.1866497
W54 500,W54,500,15,805273.35,7183,8367,1184,7967.533333,446.3599245
W55 500,W55,500,15,805273.35,8448,8683,235,8584.8,78.74956085
W56 500,W56,500,15,805273.35,7746,8600,854,7989.933333,270.7809611
W57 500,W57,500,14,751588.46,4805,7183,2378,6407.285714,875.3057775
W58 500,W58,500,15,805273.35,7366,7668,302,7573.2,87.31261841
W59 500,W59,500,14,751588.46,4674,8239,3565,6626.5,1224.5084
W60 500,W60,500,14,751588.46,7925,8270,345,8082.357143,115.2237619
W61 500,W61,500,14,751588.46,2548,8093,5545,5668.714286,1820.573435
W62 500,W62,500,14,751588.46,4785,6769,1984,6206.357143,631.9566675
W63 500,W63,500,15,805273.35,6128,8707,2579,7902.666667,924.2301782
W64 500,W64,500,15,805273.35,7066,7708,642,7406,187.0336868
W65 500,W65,500,14,751588.46,7156,7423,267,7214,70.77025202
W66 500,W66,500,14,751588.46,6158,6863,705,6493.5,182.0968149
WB_ E1 500,WB_ E1,500,15,805273.35,1222,5734,4512,3268.333333,1445.229148
WB_ E10 500,WB_ E10,500,15,805273.35,2521,4723,2202,3678.866667,641.482228
WB_ E2 500,WB_ E2,500,16,858958.24,7543,8113,570,8012.375,138.4873076
WB_ E3 500,WB_ E3,500,14,751588.46,7448,8644,1196,7757.071429,264.3405445
WB_ E4 500,WB_ E4,500,16,858958.24,8252,8791,539,8531.875,165.026087
WB_ E5 500,WB_ E5,500,14,751588.46,1086,9116,8030,5993,2881.549806
WB_ E6 500,WB_ E6,500,16,858958.24,7682,7926,244,7829.0625,101.439926
WB_ E7 500,WB_ E7,500,14,751588.46,5717,8426,2709,7539.642857,842.3113275
WB_ E8 500,WB_ E8,500,14,751588.46,7592,8523,931,8234.428571,270.6077061
WB_ E9 500,WB_ E9,500,16,858958.24,7298,7899,601,7782.1875,129.9361472
WB_ H1 500,WB_ H1,500,15,805273.35,6101,7919,1818,6982.666667,470.3701616
WB_ H10 500,WB_ H10,500,15,805273.35,5055,8687,3632,6389.933333,941.5011748
WB_ H2 500,WB_ H2,500,15,805273.35,5883,9009,3126,7599.866667,973.2999446
WB_ H3 500,WB_ H3,500,16,858958.24,4533,7559,3026,6244.4375,971.4878389
WB_ H4 500,WB_ H4,500,14,751588.46,6934,8751,1817,7718.214286,585.5399436
WB_ H5 500,WB_ H5,500,14,751588.46,1676,6739,5063,4605.428571,1573.551157
WB_ H6 500,WB_ H6,500,16,858958.24,2393,9313,6920,7318.5625,1663.703323
WB_ H7 500,WB_ H7,500,14,751588.46,3805,8125,4320,6069.714286,1762.098685
WB_ H8 500,WB_ H8,500,15,805273.35,2779,7888,5109,5724.866667,1458.232486
WB_ H9 500,WB_ H9,500,14,751588.46,1336,5970,4634,4740.142857,1140.24633
WB_ S1 500,WB_ S1,500,16,858958.24,2321,8471,6150,6346.25,2163.641274
WB_ S10 500,WB_ S10,500,14,751588.46,7110,8547,1437,7789.571429,547.2435752
WB_ S11 500,WB_ S11,500,15,805273.35,6239,8279,2040,7530.466667,600.6235501
WB_ S12 500,WB_ S12,500,14,751588.46,5834,6994,1160,6276,409.927694
WB_ S13 500,WB_ S13,500,14,751588.46,3873,7131,3258,6488.285714,831.6806932
WB_ S14 500,WB_ S14,500,15,805273.35,7385,8453,1068,7625.266667,249.9683891
WB_ S15 500,WB_ S15,500,15,805273.35,5359,8469,3110,7392.066667,775.7931397
WB_ S16 500,WB_ S16,500,15,805273.35,4748,7261,2513,6482.733333,604.1163758
WB_ S17 500,WB_ S17,500,14,751588.46,6263,7962,1699,7349.285714,527.2267645
WB_ S18 500,WB_ S18,500,14,751588.46,5724,8089,2365,7080,709.2498049
WB_ S19 500,WB_ S19,500,14,751588.46,6369,8238,1869,7835.214286,484.7834831
WB_ S2 500,WB_ S2,500,14,751588.46,3981,7892,3911,5915.642857,1232.082477
WB_ S20 500,WB_ S20,500,14,751588.46,8643,8716,73,8671,23.7997599
WB_ S21 500,WB_ S21,500,15,805273.35,7598,8442,844,7857.6,255.1435674
WB_ S22 500,WB_ S22,500,14,751588.46,7524,7752,228,7637.428571,82.88952569
WB_ S23 500,WB_ S23,500,14,751588.46,7067,7654,587,7445.928571,191.8695481
WB_ S24 500,WB_ S24,500,14,751588.46,856,6482,5626,3462.714286,1924.034542
WB_ S25 500,WB_ S25,500,14,751588.46,7611,8001,390,7814.214286,124.1014439
WB_ S26 500,WB_ S26,500,14,751588.46,4551,9083,4532,7950.071429,1425.920578
WB_ S27 500,WB_ S27,500,14,751588.46,8041,8609,568,8428,164.9220595
WB_ S28 500,WB_ S28,500,15,805273.35,8413,8780,367,8701.266667,107.7134883
WB_ S29 500,WB_ S29,500,14,751588.46,4761,7406,2645,6108.428571,921.0134724
WB_ S3 500,WB_ S3,500,15,805273.35,6098,7798,1700,7006.466667,509.7818967
WB_ S4 500,WB_ S4,500,14,751588.46,2354,4419,2065,3375.857143,749.0608269
WB_ S5 500,WB_ S5,500,14,751588.46,2136,7156,5020,4276.642857,2099.951177
WB_ S6 500,WB_ S6,500,14,751588.46,4142,7014,2872,6126.785714,1016.513662
WB_ S7 500,WB_ S7,500,15,805273.35,7270,8305,1035,7945.6,339.642518
WB_ S8 500,WB_ S8,500,14,751588.46,8071,8605,534,8412.214286,162.59862
WB_ S9 500,WB_ S9,500,14,751588.46,2163,5152,2989,3805.571429,1083.674089
WB_ W1 500,WB_ W1,500,15,805273.35,6234,8195,1961,7480.8,604.12683
WB_ W10 500,WB_ W10,500,16,858958.24,5622,6875,1253,6128.0625,497.9239988
WB_ W2 500,WB_ W2,500,15,805273.35,7960,8575,615,8299.6,186.8231963
WB_ W3 500,WB_ W3,500,15,805273.35,5494,7654,2160,6531.6,796.2001256
WB_ W4 500,WB_ W4,500,14,751588.46,4253,5048,795,4463.142857,252.8271169
WB_ W5 500,WB_ W5,500,16,858958.24,7748,8078,330,7889.4375,79.50547839
WB_ W6 500,WB_ W6,500,14,751588.46,8338,8846,508,8557.142857,178.3995744
WB_ W7 500,WB_ W7,500,15,805273.35,7891,8247,356,8040.8,129.7023259
WB_ W8 500,WB_ W8,500,15,805273.35,3740,7574,3834,6109.2,1115.615537
WB_ W9 500,WB_ W9,500,14,751588.46,7614,8634,1020,8110.285714,283.6439994
W01 750,W01,750,34,1825286.26,7150,8315,1165,7588.794118,376.1768811
W02 750,W02,750,32,1717916.48,7316,8701,1385,7867.59375,259.1384595
W03 750,W03,750,33,1771601.37,6347,8584,2237,8167.939394,605.5880658
W04 750,W04,750,32,1717916.48,7989,8780,791,8529.90625,199.5368637
W05 750,W05,750,32,1717916.48,7494,8315,821,7924.90625,201.6276518
W06 750,W06,750,32,1717916.48,7140,8341,1201,7911.03125,281.8923204
W07 750,W07,750,32,1717916.48,5758,7996,2238,7394.78125,526.8543284
W08 750,W08,750,32,1717916.48,4445,8740,4295,7193.65625,1306.763837
W09 750,W09,750,34,1825286.26,7960,8650,690,8259.029412,202.2423539
W10 750,W10,750,32,1717916.48,8008,8711,703,8476.71875,152.9303833
W11 750,W11,750,34,1825286.26,5233,8195,2962,6986.205882,893.3594488
W12 750,W12,750,32,1717916.48,3823,6216,2393,5234.5625,547.434182
W13 750,W13,750,32,1717916.48,3502,6553,3051,5561.6875,727.4920291
W14 750,W14,750,33,1771601.37,4807,8187,3380,7466.212121,781.6046337
W15 750,W15,750,34,1825286.26,5505,8005,2500,7085.705882,795.6287757
W16 750,W16,750,33,1771601.37,7364,8523,1159,8078.757576,274.8489426
W17 750,W17,750,33,1771601.37,7461,8523,1062,8301.939394,184.6101444
W18 750,W18,750,33,1771601.37,7703,8482,779,8153.242424,265.0399661
W19 750,W19,750,32,1717916.48,7395,8364,969,7871.375,314.9503681
W20 750,W20,750,32,1717916.48,6000,8159,2159,7302.5625,647.1838001
W21 750,W21,750,32,1717916.48,5727,8640,2913,7773.03125,576.2196025
W22 750,W22,750,32,1717916.48,3497,7940,4443,6384.65625,1532.056739
W23 750,W23,750,32,1717916.48,4224,5922,1698,5025.03125,493.567212
W24 750,W24,750,34,1825286.26,7007,8742,1735,8300.823529,368.7633125
W25 750,W25,750,32,1717916.48,7644,8642,998,8305.4375,241.4334714
W26 750,W26,750,33,1771601.37,1450,9305,7855,6148.30303,2269.574029
W27 750,W27,750,34,1825286.26,6599,8379,1780,7758.911765,378.7264547
W28 750,W28,750,33,1771601.37,5667,8656,2989,7487.545455,802.0786288
W29 750,W29,750,33,1771601.37,6930,8170,1240,7783.484848,353.6585514
W30 750,W30,750,32,1717916.48,4409,8035,3626,6726.8125,802.5586987
W31 750,W31,750,32,1717916.48,8433,8729,296,8595.46875,99.91871208
W32 750,W32,750,35,1878971.15,7694,8885,1191,8421.2,314.5709822
W33 750,W33,750,33,1771601.37,6897,8973,2076,8213.363636,564.950511
W34 750,W34,750,35,1878971.15,8544,8905,361,8797.771429,102.3065661
W35 750,W35,750,34,1825286.26,5909,8671,2762,7613.058824,823.3811904
W36 750,W36,750,34,1825286.26,7377,8678,1301,8278.029412,293.5436119
W37 750,W37,750,32,1717916.48,6024,8827,2803,8083.25,824.0760356
W38 750,W38,750,34,1825286.26,8269,8711,442,8488.147059,110.7273101
W39 750,W39,750,32,1717916.48,5215,7819,2604,6603.09375,812.9500046
W40 750,W40,750,32,1717916.48,7288,8806,1518,8452.84375,501.503434
W41 750,W41,750,34,1825286.26,7626,8645,1019,8251.970588,400.7572601
W42 750,W42,750,33,1771601.37,6553,8815,2262,8122.575758,634.301765
W43 750,W43,750,32,1717916.48,6971,7870,899,7674.6875,251.5721116
W44 750,W44,750,33,1771601.37,6379,8135,1756,7334.484848,463.8249488
W45 750,W45,750,32,1717916.48,2867,8398,5531,6607.25,1879.478269
W46 750,W46,750,33,1771601.37,3460,8049,4589,6710.878788,1204.736605
W47 750,W47,750,33,1771601.37,4790,8687,3897,7635.606061,1111.286885
W48 750,W48,750,32,1717916.48,7673,8553,880,7923.1875,206.5613464
W49 750,W49,750,32,1717916.48,7323,8717,1394,8555.59375,305.8020049
W50 750,W50,750,34,1825286.26,7243,8581,1338,7725.617647,329.8378403
W51 750,W51,750,33,1771601.37,7169,8519,1350,8027.272727,466.1091869
W52 750,W52,750,33,1771601.37,2966,7120,4154,5106.757576,1099.679486
W53 750,W53,750,34,1825286.26,6782,8530,1748,7693.470588,320.7010918
W54 750,W54,750,35,1878971.15,7183,8514,1331,7805.971429,442.3183395
W55 750,W55,750,32,1717916.48,8400,8746,346,8554.71875,98.63386664
W56 750,W56,750,34,1825286.26,7507,8600,1093,8123.911765,350.5753563
W57 750,W57,750,32,1717916.48,3474,8827,5353,6654.71875,1312.764765
W58 750,W58,750,32,1717916.48,7363,8693,1330,7709.15625,378.2280322
W59 750,W59,750,32,1717916.48,4674,8239,3565,6637.75,1174.50721
W60 750,W60,750,33,1771601.37,7925,8373,448,8151.878788,123.1657562
W61 750,W61,750,32,1717916.48,1976,8093,6117,6421.375,1766.764234
W62 750,W62,750,33,1771601.37,3009,7124,4115,6006.757576,908.3661333
W63 750,W63,750,34,1825286.26,2781,8707,5926,6870.588235,1603.836964
W64 750,W64,750,35,1878971.15,6137,8036,1899,7240.571429,439.5803379
W65 750,W65,750,32,1717916.48,6384,7535,1151,7207.375,211.8072163
W66 750,W66,750,32,1717916.48,4908,6868,1960,6515.1875,362.4009725
WB_ E1 750,WB_ E1,750,32,1717916.48,894,5734,4840,2846.28125,1550.240168
WB_ E10 750,WB_ E10,750,33,1771601.37,2045,5236,3191,3696.454545,917.9438185
WB_ E2 750,WB_ E2,750,32,1717916.48,7172,8113,941,7905.09375,242.0915838
WB_ E3 750,WB_ E3,750,32,1717916.48,7266,8644,1378,7738.71875,230.1962796
WB_ E4 750,WB_ E4,750,32,1717916.48,8240,8794,554,8536.875,169.8397682
WB_ E5 750,WB_ E5,750,32,1717916.48,1086,9272,8186,5862.1875,2802.425048
WB_ E6 750,WB_ E6,750,32,1717916.48,7585,7934,349,7790.84375,102.9390321
WB_ E7 750,WB_ E7,750,33,1771601.37,3596,8561,4965,7121.30303,1305.524984
WB_ E8 750,WB_ E8,750,32,1717916.48,6802,8523,1721,8142.65625,410.4608393
WB_ E9 750,WB_ E9,750,32,1717916.48,7298,8349,1051,7830.9375,220.9257423
WB_ H1 750,WB_ H1,750,35,1878971.15,6101,8571,2470,7189.628571,644.7151347
WB_ H10 750,WB_ H10,750,33,1771601.37,2549,8687,6138,6425.30303,1618.149832
WB_ H2 750,WB_ H2,750,32,1717916.48,4268,9009,4741,7102.6875,1452.396606
WB_ H3 750,WB_ H3,750,34,1825286.26,3244,7559,4315,5720.323529,1239.591482
WB_ H4 750,WB_ H4,750,33,1771601.37,6247,8751,2504,7629.969697,807.5666962
WB_ H5 750,WB_ H5,750,34,1825286.26,1510,8077,6567,4561.176471,2035.719218
WB_ H6 750,WB_ H6,750,33,1771601.37,934,9313,8379,6637.484848,2232.795274
WB_ H7 750,WB_ H7,750,33,1771601.37,265,8125,7860,5734.909091,2002.183102
WB_ H8 750,WB_ H8,750,34,1825286.26,1419,8023,6604,5565.294118,1789.10769
WB_ H9 750,WB_ H9,750,33,1771601.37,971,7027,6056,3749.757576,1754.902122
WB_ S1 750,WB_ S1,750,34,1825286.26,2321,8471,6150,5978.647059,2171.742617
WB_ S10 750,WB_ S10,750,33,1771601.37,3596,8547,4951,7119.727273,1199.876869
WB_ S11 750,WB_ S11,750,33,1771601.37,4915,8279,3364,7296.909091,793.6295741
WB_ S12 750,WB_ S12,750,32,1717916.48,4169,7513,3344,6283.9375,725.0691319
WB_ S13 750,WB_ S13,750,32,1717916.48,2233,7131,4898,5912.34375,1331.473916
WB_ S14 750,WB_ S14,750,32,1717916.48,7288,8453,1165,7616.75,227.6344383
WB_ S15 750,WB_ S15,750,34,1825286.26,3460,8500,5040,7175,1195.679379
WB_ S16 750,WB_ S16,750,32,1717916.48,3350,7717,4367,5815,1292.187003
WB_ S17 750,WB_ S17,750,32,1717916.48,3105,8087,4982,7049.90625,1182.907788
WB_ S18 750,WB_ S18,750,34,1825286.26,4415,8523,4108,7131.088235,1002.486654
WB_ S19 750,WB_ S19,750,32,1717916.48,6369,8248,1879,7825.71875,543.4890888
WB_ S2 750,WB_ S2,750,32,1717916.48,1371,9054,7683,5510.375,2042.388136
WB_ S20 750,WB_ S20,750,34,1825286.26,8598,8820,222,8671.882353,49.11736527
WB_ S21 750,WB_ S21,750,34,1825286.26,6888,8442,1554,7840.117647,246.677065
WB_ S22 750,WB_ S22,750,33,1771601.37,7524,7755,231,7654.333333,89.90960668
WB_ S23 750,WB_ S23,750,32,1717916.48,6964,8646,1682,7513.6875,345.2185393
WB_ S24 750,WB_ S24,750,32,1717916.48,846,6482,5636,2356.5625,1750.051445
WB_ S25 750,WB_ S25,750,33,1771601.37,7611,8215,604,7871.727273,138.2532311
WB_ S26 750,WB_ S26,750,32,1717916.48,4524,9097,4573,7792.21875,1525.624252
WB_ S27 750,WB_ S27,750,32,1717916.48,7975,8709,734,8445,211.9733179
WB_ S28 750,WB_ S28,750,34,1825286.26,8413,8780,367,8642.058824,118.8357594
WB_ S29 750,WB_ S29,750,33,1771601.37,4761,8047,3286,6520.69697,913.9849307
WB_ S3 750,WB_ S3,750,34,1825286.26,5842,7971,2129,6951.176471,546.9912609
WB_ S4 750,WB_ S4,750,34,1825286.26,1657,5823,4166,3335.941176,998.7144661
WB_ S5 750,WB_ S5,750,32,1717916.48,2101,8682,6581,4359.78125,2214.404403
WB_ S6 750,WB_ S6,750,32,1717916.48,2156,7037,4881,5072.6875,1617.015121
WB_ S7 750,WB_ S7,750,33,1771601.37,7185,8542,1357,7783.333333,418.1759574
WB_ S8 750,WB_ S8,750,32,1717916.48,7315,8790,1475,8366.25,318.7898014
WB_ S9 750,WB_ S9,750,32,1717916.48,349,6614,6265,3294.4375,1719.822919
WB_ W1 750,WB_ W1,750,34,1825286.26,5802,8248,2446,7342.382353,734.08182
WB_ W10 750,WB_ W10,750,33,1771601.37,5459,7113,1654,6286.575758,537.0570214
WB_ W2 750,WB_ W2,750,31,1664231.59,7844,8575,731,8268.967742,195.3432849
WB_ W3 750,WB_ W3,750,33,1771601.37,4222,7704,3482,6063.787879,1056.978735
WB_ W4 750,WB_ W4,750,32,1717916.48,4253,6106,1853,4774.46875,539.890613
WB_ W5 750,WB_ W5,750,32,1717916.48,7684,8083,399,7905.3125,98.51219388
WB_ W6 750,WB_ W6,750,32,1717916.48,8297,8846,549,8560.375,193.5246674
WB_ W7 750,WB_ W7,750,34,1825286.26,7786,8377,591,8044.058824,167.0704221
WB_ W8 750,WB_ W8,750,33,1771601.37,3740,8317,4577,6669.666667,1046.347664
WB_ W9 750,WB_ W9,750,33,1771601.37,7103,8715,1612,8110.090909,410.0714914
W01 1000,W01,1000,61,3274778.29,7150,8479,1329,7630.295082,371.7872803
W02 1000,W02,1000,59,3167408.51,7316,8756,1440,7963.355932,290.9178207
W03 1000,W03,1000,58,3113723.62,5239,8751,3512,8042.982759,712.5011674
W04 1000,W04,1000,57,3060038.73,7455,8780,1325,8475.157895,281.395195
W05 1000,W05,1000,59,3167408.51,7472,8364,892,7935.474576,227.9663487
W06 1000,W06,1000,59,3167408.51,7140,8515,1375,7986,296.5798261
W07 1000,W07,1000,59,3167408.51,4241,7996,3755,7162.457627,760.9596823
W08 1000,W08,1000,59,3167408.51,2459,8740,6281,7009.372881,1505.003484
W09 1000,W09,1000,61,3274778.29,7960,8698,738,8330,210.4430923
W10 1000,W10,1000,58,3113723.62,7978,8743,765,8451.206897,181.0009296
W11 1000,W11,1000,59,3167408.51,4461,8248,3787,6974.305085,1004.866772
W12 1000,W12,1000,58,3113723.62,3823,6935,3112,5353.913793,687.3093788
W13 1000,W13,1000,56,3006353.84,3075,6553,3478,5137.857143,904.5242323
W14 1000,W14,1000,59,3167408.51,4807,8207,3400,7568.59322,660.3645659
W15 1000,W15,1000,61,3274778.29,5505,8005,2500,7233.672131,725.4924325
W16 1000,W16,1000,61,3274778.29,7155,8589,1434,8049.311475,308.0331332
W17 1000,W17,1000,59,3167408.51,7461,8663,1202,8300.084746,243.2059383
W18 1000,W18,1000,58,3113723.62,7703,8548,845,8161.982759,253.1631266
W19 1000,W19,1000,56,3006353.84,7332,8524,1192,7986.375,327.6714144
W20 1000,W20,1000,56,3006353.84,5586,8242,2656,7310.607143,768.601552
W21 1000,W21,1000,59,3167408.51,5030,8640,3610,7619.627119,793.0382447
W22 1000,W22,1000,56,3006353.84,1308,7992,6684,6193.267857,1884.544654
W23 1000,W23,1000,59,3167408.51,4044,6596,2552,5163.491525,656.2747557
W24 1000,W24,1000,60,3221093.4,6191,8742,2551,8196.083333,490.2283921
W25 1000,W25,1000,56,3006353.84,6998,8642,1644,8241.982143,300.545248
W26 1000,W26,1000,58,3113723.62,1180,9422,8242,5819.741379,2621.724686
W27 1000,W27,1000,59,3167408.51,6599,8379,1780,7834.271186,431.7909425
W28 1000,W28,1000,59,3167408.51,5667,8656,2989,7530.847458,762.9022821
W29 1000,W29,1000,58,3113723.62,6309,8380,2071,7669.931034,450.9278122
W30 1000,W30,1000,59,3167408.51,3380,8035,4655,6663.542373,967.2455794
W31 1000,W31,1000,56,3006353.84,8395,8821,426,8588.821429,116.8662403
W32 1000,W32,1000,61,3274778.29,7527,9175,1648,8478.508197,369.6950282
W33 1000,W33,1000,60,3221093.4,6294,9026,2732,8202.5,700.5636183
W34 1000,W34,1000,60,3221093.4,7053,8905,1852,8707.916667,267.6171576
W35 1000,W35,1000,59,3167408.51,5909,8671,2762,7675.610169,853.0940302
W36 1000,W36,1000,62,3328463.18,6549,8678,2129,8186.709677,451.8405866
W37 1000,W37,1000,58,3113723.62,3258,8827,5569,7269.068966,1719.049235
W38 1000,W38,1000,60,3221093.4,8221,8747,526,8493.266667,133.7684401
W39 1000,W39,1000,56,3006353.84,4280,8626,4346,6635.107143,950.1815368
W40 1000,W40,1000,59,3167408.51,6966,8996,2030,8254.254237,613.9547157
W41 1000,W41,1000,58,3113723.62,7580,8670,1090,8206.448276,393.3085203
W42 1000,W42,1000,58,3113723.62,6553,8818,2265,7996.87931,693.9002979
W43 1000,W43,1000,58,3113723.62,6675,7934,1259,7623.086207,325.5344828
W44 1000,W44,1000,58,3113723.62,6379,8551,2172,7386.741379,536.632622
W45 1000,W45,1000,58,3113723.62,2867,8398,5531,6431.793103,1886.203748
W46 1000,W46,1000,60,3221093.4,3303,8469,5166,6747.3,1250.959915
W47 1000,W47,1000,58,3113723.62,4790,8687,3897,7503.517241,1104.770381
W48 1000,W48,1000,59,3167408.51,7673,8553,880,7918.186441,200.7260951
W49 1000,W49,1000,56,3006353.84,7323,8717,1394,8363.178571,496.1438842
W50 1000,W50,1000,58,3113723.62,6328,8627,2299,7756.551724,464.6207639
W51 1000,W51,1000,60,3221093.4,7169,8548,1379,8027.933333,469.4023813
W52 1000,W52,1000,58,3113723.62,2238,7461,5223,4893.103448,1218.861335
W53 1000,W53,1000,58,3113723.62,6512,8530,2018,7649.206897,383.3494291
W54 1000,W54,1000,61,3274778.29,2461,8514,6053,7487.344262,1064.389456
W55 1000,W55,1000,56,3006353.84,8327,8813,486,8540.714286,128.1474756
W56 1000,W56,1000,61,3274778.29,7507,8683,1176,8233.57377,334.6189151
W57 1000,W57,1000,59,3167408.51,2650,9349,6699,6650.169492,1520.798532
W58 1000,W58,1000,56,3006353.84,7363,8693,1330,7815.375,446.023044
W59 1000,W59,1000,58,3113723.62,2456,8325,5869,6398.672414,1504.257571
W60 1000,W60,1000,58,3113723.62,7925,8432,507,8198.017241,130.3058063
W61 1000,W61,1000,59,3167408.51,1976,8141,6165,6871.338983,1529.607567
W62 1000,W62,1000,58,3113723.62,2063,8424,6361,5785.431034,1487.443376
W63 1000,W63,1000,59,3167408.51,1749,8707,6958,6095.525424,1858.748708
W64 1000,W64,1000,60,3221093.4,6137,8218,2081,7214.8,542.5696207
W65 1000,W65,1000,57,3060038.73,3355,7908,4553,7065.368421,591.9233483
W66 1000,W66,1000,59,3167408.51,4437,8009,3572,6507.423729,670.1554893
WB_ E1 1000,WB_ E1,1000,56,3006353.84,894,8338,7444,2974.107143,1926.147012
WB_ E10 1000,WB_ E10,1000,59,3167408.51,1849,6591,4742,3807.322034,1117.048873
WB_ E2 1000,WB_ E2,1000,59,3167408.51,7172,8113,941,7839.779661,262.2961884
WB_ E3 1000,WB_ E3,1000,58,3113723.62,7266,8644,1378,7802.689655,228.1923876
WB_ E4 1000,WB_ E4,1000,59,3167408.51,8150,8871,721,8554.067797,187.6528407
WB_ E5 1000,WB_ E5,1000,56,3006353.84,888,9272,8384,5603.785714,2847.868625
WB_ E6 1000,WB_ E6,1000,58,3113723.62,7585,7934,349,7780.982759,103.9785275
WB_ E7 1000,WB_ E7,1000,58,3113723.62,2922,8601,5679,6854.603448,1534.124472
WB_ E8 1000,WB_ E8,1000,58,3113723.62,5805,8795,2990,8001.586207,680.348441
WB_ E9 1000,WB_ E9,1000,57,3060038.73,5789,8349,2560,7800.947368,364.2544619
WB_ H1 1000,WB_ H1,1000,60,3221093.4,6101,8571,2470,7381.066667,662.6293802
WB_ H10 1000,WB_ H10,1000,60,3221093.4,2549,8687,6138,6223.683333,1876.666402
WB_ H2 1000,WB_ H2,1000,57,3060038.73,3782,9009,5227,6895.192982,1606.345022
WB_ H3 1000,WB_ H3,1000,61,3274778.29,2916,9063,6147,5570.163934,1430.244129
WB_ H4 1000,WB_ H4,1000,58,3113723.62,4791,8751,3960,7413.37931,1021.44225
WB_ H5 1000,WB_ H5,1000,58,3113723.62,1510,8102,6592,4682.413793,2270.455173
WB_ H6 1000,WB_ H6,1000,58,3113723.62,934,9313,8379,5869.396552,2563.688789
WB_ H7 1000,WB_ H7,1000,59,3167408.51,265,8125,7860,5601.694915,2305.694426
WB_ H8 1000,WB_ H8,1000,62,3328463.18,1150,8023,6873,5256.596774,2119.226354
WB_ H9 1000,WB_ H9,1000,58,3113723.62,681,7027,6346,3007.586207,1829.470095
WB_ S1 1000,WB_ S1,1000,61,3274778.29,1874,8471,6597,5394.868852,2161.379557
WB_ S10 1000,WB_ S10,1000,61,3274778.29,2895,8547,5652,6705.295082,1454.665387
WB_ S11 1000,WB_ S11,1000,60,3221093.4,1853,8426,6573,6979.9,1130.451867
WB_ S12 1000,WB_ S12,1000,56,3006353.84,3267,7946,4679,6222.285714,1097.939836
WB_ S13 1000,WB_ S13,1000,57,3060038.73,2180,7131,4951,5441,1525.965809
WB_ S14 1000,WB_ S14,1000,58,3113723.62,5704,8453,2749,7629.034483,382.5982392
WB_ S15 1000,WB_ S15,1000,60,3221093.4,2827,8500,5673,6853.633333,1536.126481
WB_ S16 1000,WB_ S16,1000,56,3006353.84,2182,8328,6146,5471.875,1697.95968
WB_ S17 1000,WB_ S17,1000,59,3167408.51,3105,8143,5038,6909.169492,1240.261689
WB_ S18 1000,WB_ S18,1000,58,3113723.62,3784,8873,5089,7067.827586,1191.20277
WB_ S19 1000,WB_ S19,1000,58,3113723.62,4490,8617,4127,7495.844828,933.1258518
WB_ S2 1000,WB_ S2,1000,56,3006353.84,-152,9095,9247,5552.339286,2657.376057
WB_ S20 1000,WB_ S20,1000,58,3113723.62,8598,8902,304,8684.482759,69.80570113
WB_ S21 1000,WB_ S21,1000,59,3167408.51,6489,8543,2054,7794.508475,359.647161
WB_ S22 1000,WB_ S22,1000,58,3113723.62,7524,8945,1421,7786.913793,343.7268505
WB_ S23 1000,WB_ S23,1000,59,3167408.51,5413,8646,3233,7477.542373,616.0307697
WB_ S24 1000,WB_ S24,1000,58,3113723.62,381,6482,6101,2091.568966,1557.429991
WB_ S25 1000,WB_ S25,1000,58,3113723.62,7455,8215,760,7892.448276,146.245091
WB_ S26 1000,WB_ S26,1000,58,3113723.62,4524,9110,4586,7867.5,1395.255745
WB_ S27 1000,WB_ S27,1000,58,3113723.62,7821,8802,981,8383.396552,269.5308145
WB_ S28 1000,WB_ S28,1000,61,3274778.29,8246,8780,534,8609.52459,133.3016555
WB_ S29 1000,WB_ S29,1000,60,3221093.4,4385,8047,3662,6534.166667,939.9466326
WB_ S3 1000,WB_ S3,1000,62,3328463.18,4375,8476,4101,6810.935484,817.5115836
WB_ S4 1000,WB_ S4,1000,58,3113723.62,1368,6761,5393,3375.344828,1375.304124
WB_ S5 1000,WB_ S5,1000,56,3006353.84,1150,8682,7532,4769.339286,2497.108945
WB_ S6 1000,WB_ S6,1000,58,3113723.62,1906,7493,5587,4561.655172,1825.480764
WB_ S7 1000,WB_ S7,1000,60,3221093.4,7185,8578,1393,7853.15,417.7841877
WB_ S8 1000,WB_ S8,1000,58,3113723.62,7242,8794,1552,8309.413793,401.4967271
WB_ S9 1000,WB_ S9,1000,57,3060038.73,349,8560,8211,3386.245614,2048.441301
WB_ W1 1000,WB_ W1,1000,60,3221093.4,5233,8248,3015,7288.816667,826.4868721
WB_ W10 1000,WB_ W10,1000,59,3167408.51,5459,7239,1780,6345,514.1597391
WB_ W2 1000,WB_ W2,1000,58,3113723.62,7578,8575,997,8220.948276,223.4215455
WB_ W3 1000,WB_ W3,1000,58,3113723.62,4186,7704,3518,6045.827586,1008.372077
WB_ W4 1000,WB_ W4,1000,58,3113723.62,4253,7920,3667,4998.482759,730.7231949
WB_ W5 1000,WB_ W5,1000,58,3113723.62,7617,8225,608,7909.034483,128.8019016
WB_ W6 1000,WB_ W6,1000,58,3113723.62,8158,8874,716,8583.689655,199.8783429
WB_ W7 1000,WB_ W7,1000,60,3221093.4,6586,8596,2010,7983.983333,307.9217158
WB_ W8 1000,WB_ W8,1000,60,3221093.4,3740,8817,5077,6878.05,962.1801707
WB_ W9 1000,WB_ W9,1000,58,3113723.62,6711,8758,2047,8036.603448,513.760542
W01 1250,W01,1250,93,4992694.77,7049,8591,1542,7698.774194,390.3248476
W02 1250,W02,1250,93,4992694.77,7316,8909,1593,8057.634409,332.9412679
W03 1250,W03,1250,91,4885324.99,3218,8751,5533,7845.78022,1055.855247
W04 1250,W04,1250,88,4724270.32,7455,8906,1451,8469.034091,299.3675701
W05 1250,W05,1250,94,5046379.66,7472,8422,950,7947.574468,246.3985048
W06 1250,W06,1250,93,4992694.77,7140,8515,1375,8002.419355,290.6305833
W07 1250,W07,1250,92,4939009.88,4038,7996,3958,6992.130435,885.3681526
W08 1250,W08,1250,93,4992694.77,1724,8740,7016,6684.623656,1769.556708
W09 1250,W09,1250,93,4992694.77,7960,8742,782,8368.892473,207.3736673
W10 1250,W10,1250,90,4831640.1,7978,8750,772,8454.5,194.7982575
W11 1250,W11,1250,93,4992694.77,3321,8290,4969,6936.290323,1129.579507
W12 1250,W12,1250,91,4885324.99,3124,7082,3958,5368.285714,836.3316063
W13 1250,W13,1250,88,4724270.32,2180,6553,4373,4814.988636,1035.191325
W14 1250,W14,1250,91,4885324.99,4502,8207,3705,7564.208791,689.2756592
W15 1250,W15,1250,93,4992694.77,5505,8005,2500,7292.741935,658.6927083
W16 1250,W16,1250,93,4992694.77,7155,8795,1640,8057.182796,339.1804464
W17 1250,W17,1250,93,4992694.77,7461,8795,1334,8299.236559,292.0079686
W18 1250,W18,1250,91,4885324.99,7668,8548,880,8146.549451,243.3834881
W19 1250,W19,1250,91,4885324.99,5001,8753,3752,7962.21978,529.8545893
W20 1250,W20,1250,90,4831640.1,5093,8251,3158,7239.155556,896.3157047
W21 1250,W21,1250,91,4885324.99,2878,8983,6105,7444.175824,1042.867387
W22 1250,W22,1250,88,4724270.32,839,8919,8080,5999.488636,2226.901496
W23 1250,W23,1250,91,4885324.99,4044,6596,2552,5100.142857,676.6307216
W24 1250,W24,1250,93,4992694.77,3653,8742,5089,7858.774194,970.0574767
W25 1250,W25,1250,91,4885324.99,5530,8642,3112,8122.824176,475.25
W26 1250,W26,1250,91,4885324.99,1077,9447,8370,5581.076923,2702.978891
W27 1250,W27,1250,93,4992694.77,6191,8398,2207,7856.956989,471.0658451
W28 1250,W28,1250,91,4885324.99,5667,8656,2989,7539.340659,745.813535
W29 1250,W29,1250,92,4939009.88,6309,8380,2071,7613.902174,472.6574976
W30 1250,W30,1250,93,4992694.77,3380,8035,4655,6852.784946,887.748461
W31 1250,W31,1250,91,4885324.99,8213,8821,608,8576.692308,152.9745143
W32 1250,W32,1250,93,4992694.77,7527,9175,1648,8528.892473,385.2070652
W33 1250,W33,1250,94,5046379.66,6294,9026,2732,8275.606383,699.2439111
W34 1250,W34,1250,93,4992694.77,5857,8909,3052,8581.784946,502.2101443
W35 1250,W35,1250,93,4992694.77,5054,8743,3689,7686.322581,922.348617
W36 1250,W36,1250,93,4992694.77,4517,8678,4161,8088.698925,661.950698
W37 1250,W37,1250,89,4777955.21,2978,8928,5950,7068.022472,1902.59178
W38 1250,W38,1250,93,4992694.77,8192,8777,585,8497.139785,143.1991313
W39 1250,W39,1250,90,4831640.1,4270,8626,4356,6726.033333,967.478756
W40 1250,W40,1250,93,4992694.77,5700,8996,3296,8107.16129,703.791518
W41 1250,W41,1250,91,4885324.99,6184,8725,2541,8161.263736,443.1184406
W42 1250,W42,1250,91,4885324.99,6321,8828,2507,8007.186813,707.2911941
W43 1250,W43,1250,90,4831640.1,5730,7934,2204,7510.355556,515.9661555
W44 1250,W44,1250,92,4939009.88,5291,8551,3260,7424.086957,601.356811
W45 1250,W45,1250,91,4885324.99,1883,8398,6515,6364.098901,1873.873271
W46 1250,W46,1250,94,5046379.66,2753,8542,5789,6777.819149,1455.372417
W47 1250,W47,1250,93,4992694.77,4790,8687,3897,7324.569892,1139.2576
W48 1250,W48,1250,92,4939009.88,7670,8709,1039,7928.097826,229.6479849
W49 1250,W49,1250,90,4831640.1,6188,8717,2529,8152.255556,656.8844235
W50 1250,W50,1250,90,4831640.1,5575,8736,3161,7800.811111,584.1393269
W51 1250,W51,1250,93,4992694.77,7125,8548,1423,7982.634409,443.9821217
W52 1250,W52,1250,91,4885324.99,2139,7815,5676,4753.142857,1424.934728
W53 1250,W53,1250,92,4939009.88,5778,8530,2752,7649.423913,477.3955892
W54 1250,W54,1250,93,4992694.77,2145,8514,6369,7082.892473,1633.152591
W55 1250,W55,1250,88,4724270.32,8143,8820,677,8516.681818,154.2111558
W56 1250,W56,1250,93,4992694.77,7336,8687,1351,8258.817204,357.9122241
W57 1250,W57,1250,93,4992694.77,2515,9349,6834,6409.946237,1713.519916
W58 1250,W58,1250,88,4724270.32,7363,8693,1330,7940.943182,463.572598
W59 1250,W59,1250,90,4831640.1,1893,8325,6432,6402.077778,1605.061731
W60 1250,W60,1250,91,4885324.99,7920,8451,531,8210.824176,139.2779333
W61 1250,W61,1250,93,4992694.77,1976,8318,6342,7124.344086,1398.722524
W62 1250,W62,1250,91,4885324.99,1726,8424,6698,5496.406593,1756.823232
W63 1250,W63,1250,93,4992694.77,1103,8707,7604,5566.172043,2174.011057
W64 1250,W64,1250,93,4992694.77,6096,8218,2122,7214.290323,588.1012381
W65 1250,W65,1250,91,4885324.99,3355,8679,5324,6687.10989,1182.469594
W66 1250,W66,1250,94,5046379.66,1576,8267,6691,6324.212766,1244.015093
WB_ E1 1250,WB_ E1,1250,91,4885324.99,894,8338,7444,3382.483516,2198.129776
WB_ E10 1250,WB_ E10,1250,94,5046379.66,1849,7879,6030,3984.489362,1471.535489
WB_ E2 1250,WB_ E2,1250,91,4885324.99,6757,8229,1472,7794.769231,319.2563501
WB_ E3 1250,WB_ E3,1250,90,4831640.1,7226,8691,1465,7849.177778,288.7820238
WB_ E4 1250,WB_ E4,1250,92,4939009.88,8150,8881,731,8572.902174,182.4490435
WB_ E5 1250,WB_ E5,1250,90,4831640.1,595,9272,8677,5421.644444,2872.62491
WB_ E6 1250,WB_ E6,1250,92,4939009.88,7469,7934,465,7761.597826,102.3537196
WB_ E7 1250,WB_ E7,1250,91,4885324.99,2136,8601,6465,6722.725275,1736.778944
WB_ E8 1250,WB_ E8,1250,90,4831640.1,3945,9008,5063,7978.166667,994.0944539
WB_ E9 1250,WB_ E9,1250,88,4724270.32,5380,8585,3205,7647.056818,620.5062881
WB_ H1 1250,WB_ H1,1250,93,4992694.77,6101,8597,2496,7449.483871,627.2381279
WB_ H10 1250,WB_ H10,1250,93,4992694.77,1722,8687,6965,6011.795699,2046.763822
WB_ H2 1250,WB_ H2,1250,88,4724270.32,3578,9009,5431,6785.397727,1594.479856
WB_ H3 1250,WB_ H3,1250,93,4992694.77,2298,9063,6765,5475.462366,1589.79341
WB_ H4 1250,WB_ H4,1250,91,4885324.99,2296,8751,6455,7102.626374,1415.37857
WB_ H5 1250,WB_ H5,1250,89,4777955.21,1510,8358,6848,4761.932584,2402.871895
WB_ H6 1250,WB_ H6,1250,90,4831640.1,934,9313,8379,5477.5,2519.2675
WB_ H7 1250,WB_ H7,1250,91,4885324.99,265,9200,8935,5387.263736,2610.185059
WB_ H8 1250,WB_ H8,1250,93,4992694.77,1150,8192,7042,5090.268817,2197.821581
WB_ H9 1250,WB_ H9,1250,90,4831640.1,527,7460,6933,2713.277778,1841.411663
WB_ S1 1250,WB_ S1,1250,94,5046379.66,1874,8471,6597,5217.457447,2056.382874
WB_ S10 1250,WB_ S10,1250,93,4992694.77,2085,8547,6462,6287.473118,1679.302157
WB_ S11 1250,WB_ S11,1250,93,4992694.77,1853,8426,6573,6555.913978,1556.994165
WB_ S12 1250,WB_ S12,1250,90,4831640.1,2541,8058,5517,5940.166667,1365.742088
WB_ S13 1250,WB_ S13,1250,90,4831640.1,2180,7131,4951,5061.966667,1635.923127
WB_ S14 1250,WB_ S14,1250,88,4724270.32,5694,8535,2841,7568.227273,533.2058431
WB_ S15 1250,WB_ S15,1250,93,4992694.77,2720,8500,5780,6809.494624,1612.905284
WB_ S16 1250,WB_ S16,1250,91,4885324.99,1678,8760,7082,5137.747253,2027.645409
WB_ S17 1250,WB_ S17,1250,92,4939009.88,3105,8169,5064,7051.98913,1164.627852
WB_ S18 1250,WB_ S18,1250,89,4777955.21,2676,8873,6197,6888.292135,1548.046193
WB_ S19 1250,WB_ S19,1250,89,4777955.21,3327,8719,5392,7382.775281,1175.624967
WB_ S2 1250,WB_ S2,1250,89,4777955.21,-152,9095,9247,5142.88764,3111.81808
WB_ S20 1250,WB_ S20,1250,90,4831640.1,8584,8902,318,8687.711111,76.17643912
WB_ S21 1250,WB_ S21,1250,93,4992694.77,5902,8633,2731,7773.860215,416.7730511
WB_ S22 1250,WB_ S22,1250,90,4831640.1,7524,8945,1421,7855.2,393.776451
WB_ S23 1250,WB_ S23,1250,93,4992694.77,3478,8646,5168,7431.290323,880.7513725
WB_ S24 1250,WB_ S24,1250,91,4885324.99,381,6482,6101,2099.593407,1533.525587
WB_ S25 1250,WB_ S25,1250,91,4885324.99,7455,8215,760,7890.131868,136.8306251
WB_ S26 1250,WB_ S26,1250,90,4831640.1,4524,9206,4682,7986.122222,1291.234791
WB_ S27 1250,WB_ S27,1250,90,4831640.1,7513,8825,1312,8379.644444,310.9113239
WB_ S28 1250,WB_ S28,1250,93,4992694.77,8246,8780,534,8578.849462,147.0847862
WB_ S29 1250,WB_ S29,1250,93,4992694.77,4385,8285,3900,6610.258065,955.2560531
WB_ S3 1250,WB_ S3,1250,93,4992694.77,3896,8476,4580,6740.784946,982.7909113
WB_ S4 1250,WB_ S4,1250,89,4777955.21,1368,7791,6423,3504.629213,1603.427196
WB_ S5 1250,WB_ S5,1250,90,4831640.1,1150,8682,7532,4954.333333,2621.69263
WB_ S6 1250,WB_ S6,1250,89,4777955.21,1678,8420,6742,4450.505618,1870.424624
WB_ S7 1250,WB_ S7,1250,93,4992694.77,7185,8578,1393,7916.064516,389.7583427
WB_ S8 1250,WB_ S8,1250,91,4885324.99,7242,8794,1552,8276.175824,442.3738063
WB_ S9 1250,WB_ S9,1250,91,4885324.99,349,8560,8211,3350.252747,2232.144795
WB_ W1 1250,WB_ W1,1250,94,5046379.66,4461,8593,4132,7246.925532,981.9477847
WB_ W10 1250,WB_ W10,1250,92,4939009.88,4890,7239,2349,6327.782609,492.8856651
WB_ W2 1250,WB_ W2,1250,92,4939009.88,7578,8767,1189,8208.891304,245.795667
WB_ W3 1250,WB_ W3,1250,92,4939009.88,4038,7704,3666,6015.086957,971.6687534
WB_ W4 1250,WB_ W4,1250,90,4831640.1,4253,8093,3840,5290.588889,1012.359619
WB_ W5 1250,WB_ W5,1250,88,4724270.32,7530,8238,708,7920.181818,143.6393484
WB_ W6 1250,WB_ W6,1250,89,4777955.21,8150,8874,724,8596.876404,203.0482768
WB_ W7 1250,WB_ W7,1250,94,5046379.66,6586,8596,2010,7902.989362,427.6664413
WB_ W8 1250,WB_ W8,1250,93,4992694.77,3740,8817,5077,7021.817204,928.5101368
WB_ W9 1250,WB_ W9,1250,91,4885324.99,6137,8849,2712,8027.043956,570.6868796
W01 1500,W01,1500,132,7086405.48,3041,8591,5550,7551.856061,726.332549
W02 1500,W02,1500,133,7140090.37,7316,8954,1638,8107.300752,355.5211781
W03 1500,W03,1500,131,7032720.59,3218,9063,5845,7757.656489,1144.878471
W04 1500,W04,1500,128,6871665.92,7455,8906,1451,8468.023438,311.0610738
W05 1500,W05,1500,133,7140090.37,7472,8541,1069,7965.488722,253.0755071
W06 1500,W06,1500,133,7140090.37,5972,8541,2569,7943.037594,418.5021879
W07 1500,W07,1500,132,7086405.48,3743,8059,4316,6887.113636,948.0215894
W08 1500,W08,1500,132,7086405.48,1724,8740,7016,6515.363636,1898.963103
W09 1500,W09,1500,132,7086405.48,7960,8742,782,8418.295455,205.1980839
W10 1500,W10,1500,133,7140090.37,7813,8873,1060,8453.646617,194.5212823
W11 1500,W11,1500,131,7032720.59,3321,8593,5272,6938.992366,1186.82592
W12 1500,W12,1500,133,7140090.37,3124,7485,4361,5422.676692,984.8816619
W13 1500,W13,1500,129,6925350.81,1653,6783,5130,4740.992248,1150.46353
W14 1500,W14,1500,131,7032720.59,3206,8207,5001,7497.519084,783.5638231
W15 1500,W15,1500,131,7032720.59,4795,8082,3287,7292.236641,654.2821348
W16 1500,W16,1500,132,7086405.48,6807,8795,1988,8053.242424,372.9142627
W17 1500,W17,1500,133,7140090.37,7461,8848,1387,8278.827068,329.6180864
W18 1500,W18,1500,131,7032720.59,7418,8773,1355,8141,276.7142269
W19 1500,W19,1500,131,7032720.59,3962,8753,4791,7846.374046,721.6678238
W20 1500,W20,1500,130,6979035.7,5093,8351,3258,7227.9,954.8842528
W21 1500,W21,1500,133,7140090.37,2720,8983,6263,7173.390977,1326.818983
W22 1500,W22,1500,129,6925350.81,714,8919,8205,5659.883721,2382.818257
W23 1500,W23,1500,133,7140090.37,3724,6596,2872,5001.601504,706.7094025
W24 1500,W24,1500,132,7086405.48,2841,8742,5901,7538.651515,1387.475416
W25 1500,W25,1500,131,7032720.59,4440,8642,4202,7922.946565,810.528367
W26 1500,W26,1500,131,7032720.59,1077,9787,8710,5406.381679,2734.34283
W27 1500,W27,1500,131,7032720.59,6191,8590,2399,7926.847328,484.5506374
W28 1500,W28,1500,130,6979035.7,4338,8656,4318,7554.484615,777.1811118
W29 1500,W29,1500,133,7140090.37,5400,8380,2980,7555.699248,530.0340886
W30 1500,W30,1500,133,7140090.37,3380,8080,4700,6881.390977,912.5007103
W31 1500,W31,1500,130,6979035.7,8019,8838,819,8539.615385,200.2556975
W32 1500,W32,1500,131,7032720.59,7527,9175,1648,8555.51145,398.7854723
W33 1500,W33,1500,132,7086405.48,6294,9026,2732,8279.151515,690.2950454
W34 1500,W34,1500,134,7193775.26,4310,8909,4599,8171.432836,1176.189423
W35 1500,W35,1500,131,7032720.59,5054,8830,3776,7751.51145,938.2340678
W36 1500,W36,1500,133,7140090.37,3441,8737,5296,7942.383459,1007.394471
W37 1500,W37,1500,131,7032720.59,2267,8931,6664,6748.816794,2050.726733
W38 1500,W38,1500,135,7247460.15,8161,8777,616,8502.807407,151.9679545
W39 1500,W39,1500,130,6979035.7,4270,8626,4356,6793.030769,1020.054214
W40 1500,W40,1500,133,7140090.37,4229,8996,4767,7970.518797,837.7717277
W41 1500,W41,1500,132,7086405.48,6184,8804,2620,8081.068182,510.0688633
W42 1500,W42,1500,132,7086405.48,5411,8876,3465,7981.212121,728.6804079
W43 1500,W43,1500,131,7032720.59,4304,8023,3719,7412.198473,639.5181442
W44 1500,W44,1500,133,7140090.37,4515,8594,4079,7381.105263,724.9110318
W45 1500,W45,1500,133,7140090.37,1883,8694,6811,6293.345865,1934.30832
W46 1500,W46,1500,135,7247460.15,2720,8548,5828,6818.385185,1588.069678
W47 1500,W47,1500,132,7086405.48,4172,8687,4515,7251.318182,1110.445934
W48 1500,W48,1500,132,7086405.48,7564,8709,1145,7902.537879,217.0484308
W49 1500,W49,1500,130,6979035.7,5909,8717,2808,7949.215385,746.2106733
W50 1500,W50,1500,132,7086405.48,4779,8736,3957,7757.727273,674.6487087
W51 1500,W51,1500,131,7032720.59,7125,8605,1480,7960.923664,432.5482212
W52 1500,W52,1500,131,7032720.59,1668,8528,6860,4876.923664,1605.586738
W53 1500,W53,1500,133,7140090.37,5778,8530,2752,7605.586466,510.7540515
W54 1500,W54,1500,136,7301145.04,1854,8514,6660,6840.860294,1806.499866
W55 1500,W55,1500,129,6925350.81,7023,8820,1797,8476.751938,230.9115751
W56 1500,W56,1500,132,7086405.48,5598,8687,3089,8234.628788,457.8844866
W57 1500,W57,1500,133,7140090.37,2501,9349,6848,6092.744361,1780.835508
W58 1500,W58,1500,129,6925350.81,4032,8888,4856,7956.953488,655.5688797
W59 1500,W59,1500,132,7086405.48,1893,8335,6442,6365.492424,1595.605511
W60 1500,W60,1500,132,7086405.48,7516,8454,938,8204.015152,163.1591055
W61 1500,W61,1500,133,7140090.37,1976,8683,6707,7266.112782,1349.412351
W62 1500,W62,1500,131,7032720.59,1279,8424,7145,5313.625954,1919.122547
W63 1500,W63,1500,131,7032720.59,1103,8707,7604,5281.328244,2313.653366
W64 1500,W64,1500,135,7247460.15,6096,8218,2122,7273.614815,589.3134233
W65 1500,W65,1500,130,6979035.7,2567,8679,6112,6308.792308,1508.056312
W66 1500,W66,1500,134,7193775.26,1576,8267,6691,6120.835821,1521.495514
WB_ E1 1500,WB_ E1,1500,130,6979035.7,512,8442,7930,3851.984615,2338.486634
WB_ E10 1500,WB_ E10,1500,132,7086405.48,1262,7880,6618,4108,1621.997693
WB_ E2 1500,WB_ E2,1500,133,7140090.37,6757,8295,1538,7762.225564,343.1426108
WB_ E3 1500,WB_ E3,1500,132,7086405.48,7105,8691,1586,7819.742424,320.2207719
WB_ E4 1500,WB_ E4,1500,132,7086405.48,8150,8891,741,8599.621212,175.5731105
WB_ E5 1500,WB_ E5,1500,131,7032720.59,595,9272,8677,5329.70229,2847.284579
WB_ E6 1500,WB_ E6,1500,130,6979035.7,7469,7934,465,7744.1,101.2729632
WB_ E7 1500,WB_ E7,1500,131,7032720.59,2136,8601,6465,6651.625954,1815.976789
WB_ E8 1500,WB_ E8,1500,131,7032720.59,2187,9008,6821,7809.21374,1392.955116
WB_ E9 1500,WB_ E9,1500,124,6656926.36,4370,8585,4215,7502.217742,793.1102368
WB_ H1 1500,WB_ H1,1500,135,7247460.15,3741,8614,4873,7465.385185,739.3100987
WB_ H10 1500,WB_ H10,1500,131,7032720.59,1525,8687,7162,5805.961832,2219.670753
WB_ H2 1500,WB_ H2,1500,130,6979035.7,2752,9009,6257,6573.323077,1683.069445
WB_ H3 1500,WB_ H3,1500,134,7193775.26,2264,9187,6923,5469.544776,1818.51092
WB_ H4 1500,WB_ H4,1500,132,7086405.48,1523,8751,7228,6840.090909,1705.390311
WB_ H5 1500,WB_ H5,1500,131,7032720.59,1510,8366,6856,4746.839695,2460.754352
WB_ H6 1500,WB_ H6,1500,131,7032720.59,928,9313,8385,5179.030534,2592.329654
WB_ H7 1500,WB_ H7,1500,133,7140090.37,-503,9480,9983,5317.067669,2878.85594
WB_ H8 1500,WB_ H8,1500,133,7140090.37,1150,8192,7042,4914.37594,2222.228904
WB_ H9 1500,WB_ H9,1500,130,6979035.7,497,7460,6963,2518.461538,1764.025253
WB_ S1 1500,WB_ S1,1500,133,7140090.37,972,8713,7741,5194.180451,2112.280138
WB_ S10 1500,WB_ S10,1500,134,7193775.26,1658,8547,6889,5921.164179,1822.487603
WB_ S11 1500,WB_ S11,1500,132,7086405.48,1168,8426,7258,6026.962121,2040.482323
WB_ S12 1500,WB_ S12,1500,129,6925350.81,2456,8058,5602,5793.193798,1433.737448
WB_ S13 1500,WB_ S13,1500,130,6979035.7,1762,7131,5369,4765.307692,1725.0397
WB_ S14 1500,WB_ S14,1500,124,6656926.36,5496,8535,3039,7544.870968,612.328119
WB_ S15 1500,WB_ S15,1500,135,7247460.15,2720,8500,5780,6728.02963,1680.701524
WB_ S16 1500,WB_ S16,1500,130,6979035.7,1655,8760,7105,5121.407692,2124.109959
WB_ S17 1500,WB_ S17,1500,133,7140090.37,3105,8183,5078,7129.12782,1206.134735
WB_ S18 1500,WB_ S18,1500,132,7086405.48,2031,9161,7130,6642.439394,1879.195537
WB_ S19 1500,WB_ S19,1500,131,7032720.59,2759,8747,5988,7146.076336,1487.743717
WB_ S2 1500,WB_ S2,1500,130,6979035.7,-698,9095,9793,5100.846154,3322.317214
WB_ S20 1500,WB_ S20,1500,130,6979035.7,8523,8902,379,8692.023077,82.23207922
WB_ S21 1500,WB_ S21,1500,131,7032720.59,4905,8846,3941,7700.70229,592.9496934
WB_ S22 1500,WB_ S22,1500,132,7086405.48,7513,8945,1432,7926.893939,423.9686641
WB_ S23 1500,WB_ S23,1500,133,7140090.37,3127,8763,5636,7399.766917,1116.43521
WB_ S24 1500,WB_ S24,1500,130,6979035.7,381,7527,7146,2238.192308,1635.327627
WB_ S25 1500,WB_ S25,1500,131,7032720.59,7455,8342,887,7887.358779,145.8300312
WB_ S26 1500,WB_ S26,1500,131,7032720.59,4524,9206,4682,8108.473282,1174.177219
WB_ S27 1500,WB_ S27,1500,130,6979035.7,7513,8825,1312,8362.207692,327.0951566
WB_ S28 1500,WB_ S28,1500,133,7140090.37,8008,8780,772,8553.947368,163.3820798
WB_ S29 1500,WB_ S29,1500,132,7086405.48,4177,8323,4146,6640.659091,1007.521846
WB_ S3 1500,WB_ S3,1500,133,7140090.37,3160,8476,5316,6657.488722,1121.37396
WB_ S4 1500,WB_ S4,1500,131,7032720.59,1330,7791,6461,3865.984733,1899.990024
WB_ S5 1500,WB_ S5,1500,132,7086405.48,1150,8689,7539,5163.704545,2670.710097
WB_ S6 1500,WB_ S6,1500,131,7032720.59,1511,8420,6909,4369.229008,1967.58953
WB_ S7 1500,WB_ S7,1500,131,7032720.59,7185,8578,1393,7919.167939,378.8994338
WB_ S8 1500,WB_ S8,1500,130,6979035.7,7242,8794,1552,8255.9,436.8622886
WB_ S9 1500,WB_ S9,1500,130,6979035.7,349,8964,8615,3452.476923,2314.412862
WB_ W1 1500,WB_ W1,1500,135,7247460.15,3321,8662,5341,7171.814815,1086.236201
WB_ W10 1500,WB_ W10,1500,130,6979035.7,2681,8116,5435,6235.523077,684.6175374
WB_ W2 1500,WB_ W2,1500,133,7140090.37,7578,8767,1189,8160.518797,267.7594758
WB_ W3 1500,WB_ W3,1500,133,7140090.37,4038,7704,3666,6041.413534,917.3421573
WB_ W4 1500,WB_ W4,1500,131,7032720.59,4052,8173,4121,5406.396947,1111.986639
WB_ W5 1500,WB_ W5,1500,124,6656926.36,6220,8360,2140,7897.145161,270.7292033
WB_ W6 1500,WB_ W6,1500,131,7032720.59,8069,8948,879,8609.885496,217.3678994
WB_ W7 1500,WB_ W7,1500,133,7140090.37,4076,8596,4520,7742.24812,715.9679436
WB_ W8 1500,WB_ W8,1500,131,7032720.59,3740,8817,5077,6986.030534,967.927809
WB_ W9 1500,WB_ W9,1500,132,7086405.48,6137,8894,2757,7996.068182,604.3936003
W01 1750,W01,1750,180,9663280.2,1738,8591,6853,7325.244444,1263.962142
W02 1750,W02,1750,180,9663280.2,7316,8954,1638,8132.794444,372.6082199
W03 1750,W03,1750,179,9609595.31,3160,9063,5903,7602.888268,1328.717359
W04 1750,W04,1750,177,9502225.53,7455,8906,1451,8471.734463,304.8454505
W05 1750,W05,1750,182,9770649.98,7471,8560,1089,7973.159341,255.8576439
W06 1750,W06,1750,181,9716965.09,5972,8607,2635,7907.458564,495.3768415
W07 1750,W07,1750,180,9663280.2,3743,8059,4316,6841.538889,940.2993576
W08 1750,W08,1750,181,9716965.09,1724,8740,7016,6299.690608,1996.837337
W09 1750,W09,1750,180,9663280.2,7960,8753,793,8445.772222,199.1390589
W10 1750,W10,1750,179,9609595.31,7703,8873,1170,8450.324022,208.229021
W11 1750,W11,1750,181,9716965.09,3051,8662,5611,6887.966851,1286.636207
W12 1750,W12,1750,181,9716965.09,3124,7779,4655,5505.414365,1064.00285
W13 1750,W13,1750,178,9555910.42,1245,7377,6132,4590.185393,1325.340441
W14 1750,W14,1750,181,9716965.09,3206,8294,5088,7467.867403,764.2964584
W15 1750,W15,1750,180,9663280.2,1973,8087,6114,7186.966667,938.22907
W16 1750,W16,1750,180,9663280.2,6807,8795,1988,8049.238889,403.8447359
W17 1750,W17,1750,181,9716965.09,7041,8848,1807,8237.950276,365.9241729
W18 1750,W18,1750,178,9555910.42,4542,8775,4233,8088.011236,484.8534238
W19 1750,W19,1750,179,9609595.31,2602,9222,6620,7694.893855,1079.591287
W20 1750,W20,1750,179,9609595.31,5093,8455,3362,7228.648045,968.0679394
W21 1750,W21,1750,181,9716965.09,366,8983,8617,6864.662983,1753.310574
W22 1750,W22,1750,178,9555910.42,531,8919,8388,5377.050562,2535.401356
W23 1750,W23,1750,180,9663280.2,3702,6596,2894,4945.522222,716.8064473
W24 1750,W24,1750,181,9716965.09,2127,8742,6615,7135.414365,1716.998634
W25 1750,W25,1750,178,9555910.42,2068,8642,6574,7691.483146,1187.856639
W26 1750,W26,1750,177,9502225.53,905,9787,8882,5188.175141,2628.371941
W27 1750,W27,1750,180,9663280.2,6191,8593,2402,7958.333333,486.3261366
W28 1750,W28,1750,182,9770649.98,3656,8656,5000,7501.983516,886.1992091
W29 1750,W29,1750,179,9609595.31,4829,8386,3557,7503.916201,606.9865752
W30 1750,W30,1750,180,9663280.2,3380,8080,4700,6843.211111,935.7624401
W31 1750,W31,1750,178,9555910.42,7810,8838,1028,8519.382022,228.1885435
W32 1750,W32,1750,181,9716965.09,6614,9175,2561,8567.127072,450.7702559
W33 1750,W33,1750,182,9770649.98,4004,9026,5022,8240.445055,839.2236828
W34 1750,W34,1750,179,9609595.31,3002,8919,5917,7811.748603,1554.536116
W35 1750,W35,1750,181,9716965.09,4863,8830,3967,7769.635359,979.898089
W36 1750,W36,1750,180,9663280.2,3378,8737,5359,7842.1,1133.218588
W37 1750,W37,1750,177,9502225.53,2267,9134,6867,6680.090395,2149.766841
W38 1750,W38,1750,180,9663280.2,8161,8777,616,8510.122222,151.4641746
W39 1750,W39,1750,179,9609595.31,4009,8626,4617,7001.620112,1022.573832
W40 1750,W40,1750,180,9663280.2,3222,8996,5774,7846.016667,1031.845151
W41 1750,W41,1750,179,9609595.31,5677,8804,3127,8059.692737,557.2176896
W42 1750,W42,1750,177,9502225.53,5411,8876,3465,7996.949153,737.1872124
W43 1750,W43,1750,178,9555910.42,4304,8023,3719,7296.151685,793.5941102
W44 1750,W44,1750,179,9609595.31,4515,8637,4122,7443.558659,742.935985
W45 1750,W45,1750,180,9663280.2,1883,8742,6859,6406.533333,1932.818668
W46 1750,W46,1750,183,9824334.87,2720,8631,5911,6858.42623,1617.348881
W47 1750,W47,1750,181,9716965.09,4172,8756,4584,7233.618785,1162.477172
W48 1750,W48,1750,182,9770649.98,7425,8709,1284,7893.730769,225.6428887
W49 1750,W49,1750,178,9555910.42,4203,8717,4514,7628.713483,1045.139979
W50 1750,W50,1750,179,9609595.31,4632,8736,4104,7750.715084,744.620628
W51 1750,W51,1750,181,9716965.09,6767,8605,1838,7942.922652,435.7050863
W52 1750,W52,1750,180,9663280.2,1608,8758,7150,4978.65,1780.147099
W53 1750,W53,1750,179,9609595.31,5778,8530,2752,7598.480447,533.7929457
W54 1750,W54,1750,179,9609595.31,1854,8514,6660,6621.787709,1892.590138
W55 1750,W55,1750,178,9555910.42,5739,8821,3082,8356.685393,544.456684
W56 1750,W56,1750,181,9716965.09,3998,8694,4696,8123.734807,772.5732681
W57 1750,W57,1750,181,9716965.09,2187,9349,7162,5826.60221,1811.383689
W58 1750,W58,1750,178,9555910.42,4032,9352,5320,7919.955056,906.6594992
W59 1750,W59,1750,178,9555910.42,1893,8335,6442,6409.331461,1592.565698
W60 1750,W60,1750,177,9502225.53,7369,8461,1092,8177.39548,201.9360574
W61 1750,W61,1750,181,9716965.09,1976,8723,6747,7412.403315,1257.387266
W62 1750,W62,1750,179,9609595.31,1255,8424,7169,5230.932961,1994.887814
W63 1750,W63,1750,180,9663280.2,1103,8707,7604,4864.672222,2349.956798
W64 1750,W64,1750,179,9609595.31,5739,8218,2479,7281.156425,612.1094656
W65 1750,W65,1750,177,9502225.53,1699,8679,6980,5790.050847,1927.44816
W66 1750,W66,1750,182,9770649.98,1576,8267,6691,5859.214286,1798.550522
WB_ E1 1750,WB_ E1,1750,178,9555910.42,512,8560,8048,4346.41573,2407.106645
WB_ E10 1750,WB_ E10,1750,181,9716965.09,1098,8114,7016,4181.497238,1788.03304
WB_ E2 1750,WB_ E2,1750,180,9663280.2,6757,8295,1538,7762.166667,347.1587773
WB_ E3 1750,WB_ E3,1750,179,9609595.31,7105,8691,1586,7832.223464,312.4399657
WB_ E4 1750,WB_ E4,1750,181,9716965.09,8150,8923,773,8623.585635,174.0962445
WB_ E5 1750,WB_ E5,1750,177,9502225.53,595,9272,8677,5262.333333,2792.626859
WB_ E6 1750,WB_ E6,1750,180,9663280.2,6675,8712,2037,7720.894444,180.8688444
WB_ E7 1750,WB_ E7,1750,178,9555910.42,1553,8601,7048,6596.910112,1891.326398
WB_ E8 1750,WB_ E8,1750,177,9502225.53,2187,9008,6821,7779,1468.418404
WB_ E9 1750,WB_ E9,1750,180,9663280.2,1792,8769,6977,7169.711111,1457.986262
WB_ H1 1750,WB_ H1,1750,179,9609595.31,2165,8614,6449,7394.865922,1118.675456
WB_ H10 1750,WB_ H10,1750,180,9663280.2,1525,8687,7162,5808.683333,2309.771084
WB_ H2 1750,WB_ H2,1750,179,9609595.31,2400,9009,6609,6480.011173,1660.279471
WB_ H3 1750,WB_ H3,1750,180,9663280.2,2173,9261,7088,5771.977778,2065.754519
WB_ H4 1750,WB_ H4,1750,177,9502225.53,1511,8751,7240,6630.118644,1926.97129
WB_ H5 1750,WB_ H5,1750,177,9502225.53,1510,8443,6933,4669.875706,2500.281199
WB_ H6 1750,WB_ H6,1750,181,9716965.09,792,9313,8521,5082.187845,2707.793093
WB_ H7 1750,WB_ H7,1750,179,9609595.31,-503,9480,9983,5067.832402,3027.140852
WB_ H8 1750,WB_ H8,1750,180,9663280.2,1150,8244,7094,4826.627778,2320.69198
WB_ H9 1750,WB_ H9,1750,179,9609595.31,497,8051,7554,2700.122905,1964.485682
WB_ S1 1750,WB_ S1,1750,180,9663280.2,-255,9150,9405,5127.811111,2288.723989
WB_ S10 1750,WB_ S10,1750,181,9716965.09,1658,8547,6889,5674.071823,1924.08128
WB_ S11 1750,WB_ S11,1750,180,9663280.2,1168,8679,7511,5598.622222,2346.459672
WB_ S12 1750,WB_ S12,1750,180,9663280.2,1893,8237,6344,5732.111111,1497.132804
WB_ S13 1750,WB_ S13,1750,178,9555910.42,1708,8400,6692,4511.938202,1796.892818
WB_ S14 1750,WB_ S14,1750,180,9663280.2,5496,8535,3039,7543.527778,588.0524205
WB_ S15 1750,WB_ S15,1750,180,9663280.2,2720,8542,5822,6794.338889,1666.20533
WB_ S16 1750,WB_ S16,1750,178,9555910.42,1122,8760,7638,5090.044944,2249.417247
WB_ S17 1750,WB_ S17,1750,179,9609595.31,3073,8226,5153,7179.044693,1228.426185
WB_ S18 1750,WB_ S18,1750,178,9555910.42,1873,9161,7288,6415.58427,2060.943797
WB_ S19 1750,WB_ S19,1750,177,9502225.53,2759,8850,6091,7093.073446,1568.083176
WB_ S2 1750,WB_ S2,1750,180,9663280.2,-698,9095,9793,4888.555556,3532.751731
WB_ S20 1750,WB_ S20,1750,179,9609595.31,8371,8902,531,8687.26257,90.12662288
WB_ S21 1750,WB_ S21,1750,181,9716965.09,4519,8846,4327,7641.469613,737.7384101
WB_ S22 1750,WB_ S22,1750,177,9502225.53,7485,8963,1478,7946.954802,434.3145105
WB_ S23 1750,WB_ S23,1750,179,9609595.31,2083,9040,6957,7353.318436,1289.784649
WB_ S24 1750,WB_ S24,1750,180,9663280.2,381,7527,7146,2355.144444,1722.684314
WB_ S25 1750,WB_ S25,1750,178,9555910.42,7455,8342,887,7883.342697,143.7655726
WB_ S26 1750,WB_ S26,1750,179,9609595.31,4524,9206,4682,8185.145251,1081.975966
WB_ S27 1750,WB_ S27,1750,178,9555910.42,7513,8838,1325,8386.41573,326.3808112
WB_ S28 1750,WB_ S28,1750,180,9663280.2,7313,8906,1593,8520.5,223.0393712
WB_ S29 1750,WB_ S29,1750,181,9716965.09,4177,8323,4146,6613.640884,1027.309197
WB_ S3 1750,WB_ S3,1750,180,9663280.2,3101,8538,5437,6594.138889,1177.688479
WB_ S4 1750,WB_ S4,1750,178,9555910.42,1239,8217,6978,4204.08427,2084.265084
WB_ S5 1750,WB_ S5,1750,178,9555910.42,1150,8771,7621,5292.05618,2706.687635
WB_ S6 1750,WB_ S6,1750,177,9502225.53,1511,8420,6909,4268.180791,1887.843849
WB_ S7 1750,WB_ S7,1750,180,9663280.2,7185,8578,1393,7913.383333,391.7851916
WB_ S8 1750,WB_ S8,1750,179,9609595.31,6650,9062,2412,8203.944134,468.1169304
WB_ S9 1750,WB_ S9,1750,177,9502225.53,349,8964,8615,3499.152542,2330.206148
WB_ W1 1750,WB_ W1,1750,180,9663280.2,3321,8688,5367,7074.816667,1203.50854
WB_ W10 1750,WB_ W10,1750,181,9716965.09,2681,8116,5435,6119.209945,940.2535805
WB_ W2 1750,WB_ W2,1750,179,9609595.31,7025,8767,1742,8115.541899,295.0234574
WB_ W3 1750,WB_ W3,1750,179,9609595.31,3743,7991,4248,6037.513966,954.5381483
WB_ W4 1750,WB_ W4,1750,177,9502225.53,3931,8214,4283,5543.813559,1209.881968
WB_ W5 1750,WB_ W5,1750,180,9663280.2,4476,8360,3884,7818.761111,520.4521684
WB_ W6 1750,WB_ W6,1750,177,9502225.53,8069,8948,879,8618.079096,215.5899132
WB_ W7 1750,WB_ W7,1750,180,9663280.2,4076,8647,4571,7632.677778,904.6808808
WB_ W8 1750,WB_ W8,1750,180,9663280.2,3740,8817,5077,6949.005556,1027.701148
WB_ W9 1750,WB_ W9,1750,177,9502225.53,4086,8894,4808,8001.824859,708.9273172
W01 2000,W01,2000,234,12562264.26,1707,8591,6884,7128.457265,1466.636859
W02 2000,W02,2000,235,12615949.15,7316,8954,1638,8170.53617,370.5947517
W03 2000,W03,2000,236,12669634.04,3089,9063,5974,7539.775424,1398.879263
W04 2000,W04,2000,236,12669634.04,7455,8906,1451,8468.169492,300.2570595
W05 2000,W05,2000,233,12508579.37,7208,8575,1367,7974.270386,272.8509471
W06 2000,W06,2000,232,12454894.48,5972,8671,2699,7878.133621,516.9090448
W07 2000,W07,2000,232,12454894.48,3743,8059,4316,6763.030172,929.7502603
W08 2000,W08,2000,232,12454894.48,1724,8868,7144,6309.12931,2064.815501
W09 2000,W09,2000,234,12562264.26,7895,8920,1025,8463.696581,201.8831796
W10 2000,W10,2000,234,12562264.26,6869,8966,2097,8417.722222,298.0363867
W11 2000,W11,2000,233,12508579.37,2513,8688,6175,6827.055794,1353.520119
W12 2000,W12,2000,233,12508579.37,3124,7861,4737,5529.480687,1080.583637
W13 2000,W13,2000,236,12669634.04,965,7632,6667,4435.783898,1378.562605
W14 2000,W14,2000,234,12562264.26,3206,8294,5088,7437.358974,729.55969
W15 2000,W15,2000,234,12562264.26,1973,8267,6294,7088.111111,1168.704153
W16 2000,W16,2000,234,12562264.26,5765,8870,3105,8044.153846,492.0121101
W17 2000,W17,2000,234,12562264.26,7041,8848,1807,8188.384615,394.8198301
W18 2000,W18,2000,234,12562264.26,4542,8775,4233,8110.081197,518.6325769
W19 2000,W19,2000,232,12454894.48,2142,9222,7080,7531.685345,1366.70766
W20 2000,W20,2000,233,12508579.37,5093,8455,3362,7254.587983,956.5127435
W21 2000,W21,2000,233,12508579.37,357,8983,8626,6664.95279,2025.277075
W22 2000,W22,2000,236,12669634.04,531,8919,8388,5141.474576,2622.982449
W23 2000,W23,2000,232,12454894.48,3702,7300,3598,4969.478448,739.4452659
W24 2000,W24,2000,234,12562264.26,2127,8742,6615,6913.491453,1843.045821
W25 2000,W25,2000,233,12508579.37,1249,8642,7393,7399.493562,1650.878279
W26 2000,W26,2000,235,12615949.15,751,9787,9036,4923.004255,2519.006659
W27 2000,W27,2000,233,12508579.37,5965,8601,2636,7957.090129,519.4904366
W28 2000,W28,2000,234,12562264.26,1803,8775,6972,7384.042735,1136.370944
W29 2000,W29,2000,234,12562264.26,3064,8386,5322,7401.444444,850.1354788
W30 2000,W30,2000,232,12454894.48,3293,8226,4933,6795.814655,1017.044236
W31 2000,W31,2000,232,12454894.48,7512,8962,1450,8492.922414,272.488331
W32 2000,W32,2000,235,12615949.15,6614,9175,2561,8605.404255,449.8337783
W33 2000,W33,2000,233,12508579.37,4004,9026,5022,8248.669528,847.3353425
W34 2000,W34,2000,235,12615949.15,2684,9021,6337,7406.906383,1891.762411
W35 2000,W35,2000,233,12508579.37,3904,8846,4942,7778.811159,1055.597672
W36 2000,W36,2000,234,12562264.26,2739,8737,5998,7742.042735,1273.442426
W37 2000,W37,2000,235,12615949.15,1892,9134,7242,6580.493617,2216.822419
W38 2000,W38,2000,236,12669634.04,8042,8777,735,8518.927966,156.1112947
W39 2000,W39,2000,234,12562264.26,4009,8707,4698,7137.025641,991.6950607
W40 2000,W40,2000,235,12615949.15,3222,8996,5774,7727.795745,1146.64231
W41 2000,W41,2000,233,12508579.37,5275,8804,3529,7995.7897,608.6345327
W42 2000,W42,2000,234,12562264.26,5146,8876,3730,7942.504274,778.0066478
W43 2000,W43,2000,235,12615949.15,4304,8023,3719,7276.948936,829.3233832
W44 2000,W44,2000,233,12508579.37,3177,8722,5545,7474.248927,817.8527722
W45 2000,W45,2000,231,12401209.59,1883,8755,6872,6504.251082,1905.535538
W46 2000,W46,2000,234,12562264.26,2675,8668,5993,6871.961538,1605.000201
W47 2000,W47,2000,234,12562264.26,4172,8756,4584,7221.893162,1099.3909
W48 2000,W48,2000,234,12562264.26,7425,8709,1284,7886.350427,240.6029043
W49 2000,W49,2000,234,12562264.26,2451,8717,6266,7313.401709,1361.462892
W50 2000,W50,2000,235,12615949.15,4632,8736,4104,7745.885106,761.5279375
W51 2000,W51,2000,234,12562264.26,6767,8605,1838,7955.435897,441.8598297
W52 2000,W52,2000,236,12669634.04,1608,8758,7150,5094.275424,1920.46361
W53 2000,W53,2000,234,12562264.26,5778,8530,2752,7577.760684,552.668432
W54 2000,W54,2000,237,12723318.93,1817,8514,6697,6376.185654,2028.681143
W55 2000,W55,2000,236,12669634.04,4312,8972,4660,8269.076271,765.7922026
W56 2000,W56,2000,234,12562264.26,2279,8939,6660,8012.760684,1063.665539
W57 2000,W57,2000,235,12615949.15,2187,9349,7162,5566.638298,1921.82891
W58 2000,W58,2000,236,12669634.04,3201,9352,6151,7878.720339,1050.719389
W59 2000,W59,2000,235,12615949.15,1893,8450,6557,6342.544681,1566.018255
W60 2000,W60,2000,235,12615949.15,5646,8559,2913,8148.340426,283.3111271
W61 2000,W61,2000,235,12615949.15,1976,8746,6770,7510.038298,1245.189543
W62 2000,W62,2000,236,12669634.04,1255,9302,8047,5226.076271,2030.60977
W63 2000,W63,2000,233,12508579.37,720,8707,7987,4447.592275,2352.130995
W64 2000,W64,2000,236,12669634.04,4923,8218,3295,7295.610169,657.7931458
W65 2000,W65,2000,233,12508579.37,1359,8679,7320,5405.025751,2135.105875
W66 2000,W66,2000,234,12562264.26,1251,8267,7016,5634.615385,1894.300044
WB_ E1 2000,WB_ E1,2000,232,12454894.48,171,8560,8389,4565.232759,2462.48426
WB_ E10 2000,WB_ E10,2000,233,12508579.37,1093,8178,7085,4150.090129,1863.81118
WB_ E2 2000,WB_ E2,2000,232,12454894.48,6737,8405,1668,7780.659483,348.4873229
WB_ E3 2000,WB_ E3,2000,234,12562264.26,7105,8691,1586,7834.747863,298.5766385
WB_ E4 2000,WB_ E4,2000,234,12562264.26,7141,8934,1793,8622.504274,219.6705624
WB_ E5 2000,WB_ E5,2000,233,12508579.37,595,9272,8677,5051.545064,2695.232021
WB_ E6 2000,WB_ E6,2000,234,12562264.26,6675,8715,2040,7715.277778,242.0856222
WB_ E7 2000,WB_ E7,2000,235,12615949.15,1553,8601,7048,6477.029787,1948.735545
WB_ E8 2000,WB_ E8,2000,235,12615949.15,2059,9008,6949,7570.87234,1735.353466
WB_ E9 2000,WB_ E9,2000,237,12723318.93,1183,8769,7586,6869.544304,1771.363827
WB_ H1 2000,WB_ H1,2000,235,12615949.15,2013,8614,6601,7309.523404,1400.953479
WB_ H10 2000,WB_ H10,2000,233,12508579.37,1525,8687,7162,5832.862661,2368.76765
WB_ H2 2000,WB_ H2,2000,235,12615949.15,2286,9009,6723,6409.093617,1718.572255
WB_ H3 2000,WB_ H3,2000,234,12562264.26,1929,9261,7332,5967.525641,2216.619846
WB_ H4 2000,WB_ H4,2000,235,12615949.15,1511,8751,7240,6468.970213,2137.285933
WB_ H5 2000,WB_ H5,2000,235,12615949.15,1510,8443,6933,4701.421277,2489.458158
WB_ H6 2000,WB_ H6,2000,234,12562264.26,425,9313,8888,5029.679487,2702.775564
WB_ H7 2000,WB_ H7,2000,235,12615949.15,-503,9480,9983,4826.868085,3065.557056
WB_ H8 2000,WB_ H8,2000,234,12562264.26,1150,8497,7347,4780.32906,2415.596141
WB_ H9 2000,WB_ H9,2000,236,12669634.04,497,8162,7665,2943.478814,2197.416417
WB_ S1 2000,WB_ S1,2000,234,12562264.26,-255,9150,9405,5038.222222,2575.314121
WB_ S10 2000,WB_ S10,2000,234,12562264.26,1658,8547,6889,5444.17094,2026.102204
WB_ S11 2000,WB_ S11,2000,232,12454894.48,911,8679,7768,5310.762931,2409.419944
WB_ S12 2000,WB_ S12,2000,233,12508579.37,1893,8280,6387,5689.733906,1568.274727
WB_ S13 2000,WB_ S13,2000,234,12562264.26,1708,8662,6954,4478.320513,1890.375575
WB_ S14 2000,WB_ S14,2000,236,12669634.04,5367,8694,3327,7566.957627,609.2412187
WB_ S15 2000,WB_ S15,2000,236,12669634.04,2675,8631,5956,6891.402542,1632.687883
WB_ S16 2000,WB_ S16,2000,232,12454894.48,1122,8760,7638,5194.25431,2269.48805
WB_ S17 2000,WB_ S17,2000,235,12615949.15,3073,8245,5172,7222.085106,1171.110359
WB_ S18 2000,WB_ S18,2000,234,12562264.26,1873,9161,7288,6300.004274,2147.057739
WB_ S19 2000,WB_ S19,2000,235,12615949.15,2188,8850,6662,6962.502128,1688.168627
WB_ S2 2000,WB_ S2,2000,235,12615949.15,-698,9095,9793,4743.161702,3656.407941
WB_ S20 2000,WB_ S20,2000,236,12669634.04,7653,8902,1249,8663.877119,162.3923038
WB_ S21 2000,WB_ S21,2000,233,12508579.37,3406,8846,5440,7523.23176,957.3287529
WB_ S22 2000,WB_ S22,2000,235,12615949.15,7273,8963,1690,7930.344681,431.1802757
WB_ S23 2000,WB_ S23,2000,235,12615949.15,1639,9040,7401,7334.106383,1384.065953
WB_ S24 2000,WB_ S24,2000,235,12615949.15,381,8121,7740,2508.012766,1861.131839
WB_ S25 2000,WB_ S25,2000,235,12615949.15,6444,8358,1914,7868.429787,192.9739657
WB_ S26 2000,WB_ S26,2000,233,12508579.37,4524,9206,4682,8259.841202,1002.677448
WB_ S27 2000,WB_ S27,2000,236,12669634.04,7513,8870,1357,8409.779661,312.969204
WB_ S28 2000,WB_ S28,2000,234,12562264.26,7313,8906,1593,8486.102564,278.8656168
WB_ S29 2000,WB_ S29,2000,234,12562264.26,4087,8323,4236,6643.606838,1043.73091
WB_ S3 2000,WB_ S3,2000,234,12562264.26,2049,8538,6489,6466.179487,1323.519209
WB_ S4 2000,WB_ S4,2000,236,12669634.04,1051,8217,7166,4475.995763,2152.316898
WB_ S5 2000,WB_ S5,2000,235,12615949.15,1150,8771,7621,5401.13617,2685.696789
WB_ S6 2000,WB_ S6,2000,235,12615949.15,1511,8420,6909,4283.642553,1788.228366
WB_ S7 2000,WB_ S7,2000,232,12454894.48,6165,8578,2413,7891.836207,426.8187543
WB_ S8 2000,WB_ S8,2000,235,12615949.15,4818,9316,4498,8169.642553,517.7491629
WB_ S9 2000,WB_ S9,2000,233,12508579.37,349,8964,8615,3758.060086,2374.891962
WB_ W1 2000,WB_ W1,2000,237,12723318.93,3051,8688,5637,6967.898734,1329.382258
WB_ W10 2000,WB_ W10,2000,234,12562264.26,1941,8116,6175,6051.059829,1103.831035
WB_ W2 2000,WB_ W2,2000,234,12562264.26,5867,8767,2900,8048.153846,383.0992734
WB_ W3 2000,WB_ W3,2000,233,12508579.37,3743,8081,4338,6158.32618,974.7344509
WB_ W4 2000,WB_ W4,2000,235,12615949.15,3931,8269,4338,5642.548936,1293.812493
WB_ W5 2000,WB_ W5,2000,236,12669634.04,4476,8393,3917,7794.283898,524.4139989
WB_ W6 2000,WB_ W6,2000,235,12615949.15,8069,8948,879,8617.434043,208.1190712
WB_ W7 2000,WB_ W7,2000,233,12508579.37,1415,8760,7345,7489.841202,1235.905408
WB_ W8 2000,WB_ W8,2000,233,12508579.37,3740,8817,5077,6955.545064,1003.240556
WB_ W9 2000,WB_ W9,2000,234,12562264.26,4086,8894,4808,7955.42735,866.0815068
W01 2250,W01,2250,296,15890727.44,1707,8591,6884,7092.486486,1448.196448
W02 2250,W02,2250,295,15837042.55,6825,8954,2129,8162.911864,380.0369996
W03 2250,W03,2250,297,15944412.33,3089,9063,5974,7510.515152,1441.003667
W04 2250,W04,2250,300,16105467,7455,8906,1451,8448.246667,294.3746465
W05 2250,W05,2250,295,15837042.55,6476,8575,2099,7966.976271,319.3476658
W06 2250,W06,2250,294,15783357.66,5779,8731,2952,7881.319728,549.6510827
W07 2250,W07,2250,298,15998097.22,3743,8295,4552,6665.620805,959.6497791
W08 2250,W08,2250,294,15783357.66,1724,8920,7196,6252.568027,2143.697957
W09 2250,W09,2250,296,15890727.44,7536,8920,1384,8447.307432,228.9596552
W10 2250,W10,2250,296,15890727.44,5203,8966,3763,8383.405405,416.6159249
W11 2250,W11,2250,294,15783357.66,2513,9012,6499,6739.108844,1447.958773
W12 2250,W12,2250,299,16051782.11,1732,7861,6129,5493.913043,1157.492449
W13 2250,W13,2250,300,16105467,965,7632,6667,4387.61,1442.713734
W14 2250,W14,2250,298,15998097.22,3206,8294,5088,7364.516779,778.5372932
W15 2250,W15,2250,297,15944412.33,1973,8267,6294,7020.996633,1323.797922
W16 2250,W16,2250,295,15837042.55,5078,8870,3792,7981.122034,639.0476962
W17 2250,W17,2250,295,15837042.55,5416,8901,3485,8140.020339,501.7945892
W18 2250,W18,2250,297,15944412.33,3536,9316,5780,8062.026936,651.0753751
W19 2250,W19,2250,298,15998097.22,1907,9222,7315,7400.456376,1594.40155
W20 2250,W20,2250,297,15944412.33,5093,8455,3362,7277.212121,939.7517575
W21 2250,W21,2250,298,15998097.22,357,8983,8626,6537.342282,2149.304686
W22 2250,W22,2250,297,15944412.33,531,8919,8388,5003.289562,2636.483585
W23 2250,W23,2250,296,15890727.44,3702,8239,4537,5064.652027,827.611912
W24 2250,W24,2250,296,15890727.44,2127,8742,6615,6649.668919,1978.485858
W25 2250,W25,2250,298,15998097.22,1122,8642,7520,7164.238255,1899.762795
W26 2250,W26,2250,296,15890727.44,751,9787,9036,4772.192568,2393.560577
W27 2250,W27,2250,296,15890727.44,4968,8601,3633,7920.253378,616.2841405
W28 2250,W28,2250,300,16105467,1208,8775,7567,7228.966667,1413.978545
W29 2250,W29,2250,297,15944412.33,3064,8508,5444,7319.414141,1042.240035
W30 2250,W30,2250,296,15890727.44,3293,8740,5447,6838.35473,1028.080946
W31 2250,W31,2250,298,15998097.22,7123,9020,1897,8481.651007,310.3792749
W32 2250,W32,2250,295,15837042.55,5745,9175,3430,8626.223729,484.9637667
W33 2250,W33,2250,296,15890727.44,3464,9043,5579,8243.209459,868.6887894
W34 2250,W34,2250,293,15729672.77,1873,9073,7200,7109.952218,2080.659973
W35 2250,W35,2250,295,15837042.55,3333,8894,5561,7687.579661,1232.390044
W36 2250,W36,2250,296,15890727.44,2739,8737,5998,7713.881757,1297.631638
W37 2250,W37,2250,297,15944412.33,1892,9134,7242,6639.013468,2181.279565
W38 2250,W38,2250,293,15729672.77,8042,8882,840,8530.020478,158.7584281
W39 2250,W39,2250,298,15998097.22,4009,8846,4837,7282.748322,964.8180413
W40 2250,W40,2250,296,15890727.44,3222,8996,5774,7634.72973,1229.006952
W41 2250,W41,2250,297,15944412.33,5034,8804,3770,7944.205387,674.5752086
W42 2250,W42,2250,297,15944412.33,5146,8876,3730,7916.639731,771.3480274
W43 2250,W43,2250,297,15944412.33,3375,8119,4744,7232.121212,935.3790885
W44 2250,W44,2250,298,15998097.22,3177,8722,5545,7525.654362,844.8409632
W45 2250,W45,2250,297,15944412.33,1883,8825,6942,6673.727273,1834.654203
W46 2250,W46,2250,295,15837042.55,2501,8668,6167,6880.925424,1569.320782
W47 2250,W47,2250,298,15998097.22,2599,8756,6157,7124.409396,1238.376698
W48 2250,W48,2250,298,15998097.22,7425,8860,1435,7885.966443,254.8398607
W49 2250,W49,2250,297,15944412.33,1944,8717,6773,6974.912458,1628.046422
W50 2250,W50,2250,297,15944412.33,4632,8736,4104,7732.996633,755.8435451
W51 2250,W51,2250,296,15890727.44,6767,8677,1910,7952.486486,450.5151929
W52 2250,W52,2250,299,16051782.11,1608,8758,7150,5154.535117,1984.923889
W53 2250,W53,2250,297,15944412.33,5778,8530,2752,7576.686869,545.4666426
W54 2250,W54,2250,293,15729672.77,1699,8514,6815,6192.764505,2122.85379
W55 2250,W55,2250,300,16105467,2375,8972,6597,8124.023333,1051.504061
W56 2250,W56,2250,296,15890727.44,1578,8939,7361,7896.875,1355.486599
W57 2250,W57,2250,295,15837042.55,2042,9349,7307,5323.033898,1996.285749
W58 2250,W58,2250,298,15998097.22,3201,9352,6151,7853.234899,1145.7077
W59 2250,W59,2250,296,15890727.44,1887,8450,6563,6216.266892,1607.954862
W60 2250,W60,2250,297,15944412.33,5646,8636,2990,8094.400673,403.9830785
W61 2250,W61,2250,295,15837042.55,1976,8764,6788,7614.589831,1197.127238
W62 2250,W62,2250,299,16051782.11,1255,9338,8083,5228.989967,2113.01251
W63 2250,W63,2250,297,15944412.33,720,8707,7987,4131.383838,2342.396229
W64 2250,W64,2250,293,15729672.77,4923,8666,3743,7297.832765,691.2549225
W65 2250,W65,2250,298,15998097.22,1238,8679,7441,4983.265101,2322.268111
W66 2250,W66,2250,295,15837042.55,1182,8267,7085,5321.79661,2032.430206
WB_ E1 2250,WB_ E1,2250,296,15890727.44,171,8560,8389,4804.635135,2531.506251
WB_ E10 2250,WB_ E10,2250,296,15890727.44,1093,8335,7242,4100.766892,1972.189592
WB_ E2 2250,WB_ E2,2250,296,15890727.44,6737,8485,1748,7793.537162,377.9628431
WB_ E3 2250,WB_ E3,2250,297,15944412.33,7105,8691,1586,7826.373737,285.0772801
WB_ E4 2250,WB_ E4,2250,299,16051782.11,6229,8934,2705,8572.849498,356.7685432
WB_ E5 2250,WB_ E5,2250,297,15944412.33,329,9272,8943,4663.417508,2674.982669
WB_ E6 2250,WB_ E6,2250,298,15998097.22,5730,8963,3233,7705.036913,312.7102063
WB_ E7 2250,WB_ E7,2250,296,15890727.44,1553,8601,7048,6454.898649,1932.032153
WB_ E8 2250,WB_ E8,2250,296,15890727.44,2022,9008,6986,7396.702703,1893.325069
WB_ E9 2250,WB_ E9,2250,300,16105467,1142,8769,7627,6479.486667,2095.155966
WB_ H1 2250,WB_ H1,2250,293,15729672.77,1611,8735,7124,7241.795222,1578.069644
WB_ H10 2250,WB_ H10,2250,296,15890727.44,1525,8687,7162,5965.793919,2346.277014
WB_ H2 2250,WB_ H2,2250,297,15944412.33,2286,9009,6723,6438.414141,1755.495007
WB_ H3 2250,WB_ H3,2250,295,15837042.55,1929,9261,7332,6191.352542,2266.075014
WB_ H4 2250,WB_ H4,2250,297,15944412.33,1511,8751,7240,6358.538721,2237.256769
WB_ H5 2250,WB_ H5,2250,297,15944412.33,1510,8448,6938,4749.26936,2450.080132
WB_ H6 2250,WB_ H6,2250,298,15998097.22,425,9313,8888,5106.033557,2627.692683
WB_ H7 2250,WB_ H7,2250,296,15890727.44,-503,9480,9983,4606.726351,3036.510574
WB_ H8 2250,WB_ H8,2250,296,15890727.44,1150,8561,7411,4924.364865,2464.089653
WB_ H9 2250,WB_ H9,2250,298,15998097.22,497,8442,7945,3271.345638,2417.624799
WB_ S1 2250,WB_ S1,2250,294,15783357.66,-283,9150,9433,4931.826531,2760.443507
WB_ S10 2250,WB_ S10,2250,296,15890727.44,1252,8547,7295,5225.047297,2112.616241
WB_ S11 2250,WB_ S11,2250,295,15837042.55,911,8679,7768,5127.423729,2471.015994
WB_ S12 2250,WB_ S12,2250,298,15998097.22,1887,8363,6476,5599.573826,1639.432269
WB_ S13 2250,WB_ S13,2250,298,15998097.22,1662,8662,7000,4466.208054,1908.916938
WB_ S14 2250,WB_ S14,2250,300,16105467,4339,8694,4355,7578.946667,645.0797138
WB_ S15 2250,WB_ S15,2250,293,15729672.77,2378,8631,6253,6955.358362,1620.249605
WB_ S16 2250,WB_ S16,2250,296,15890727.44,1048,8760,7712,5199.10473,2319.192677
WB_ S17 2250,WB_ S17,2250,296,15890727.44,3073,8245,5172,7207.523649,1175.598686
WB_ S18 2250,WB_ S18,2250,297,15944412.33,1873,9161,7288,6240.410774,2123.291326
WB_ S19 2250,WB_ S19,2250,297,15944412.33,2026,8850,6824,6846.478114,1786.330566
WB_ S2 2250,WB_ S2,2250,298,15998097.22,-698,9095,9793,4696.432886,3723.645717
WB_ S20 2250,WB_ S20,2250,298,15998097.22,6493,8902,2409,8619.755034,269.4117449
WB_ S21 2250,WB_ S21,2250,295,15837042.55,2961,8856,5895,7425.901695,1123.046251
WB_ S22 2250,WB_ S22,2250,297,15944412.33,7264,8963,1699,7897.424242,426.6443434
WB_ S23 2250,WB_ S23,2250,295,15837042.55,755,9040,8285,7272.101695,1531.020571
WB_ S24 2250,WB_ S24,2250,299,16051782.11,381,8121,7740,2791.133779,2132.555021
WB_ S25 2250,WB_ S25,2250,297,15944412.33,6227,8358,2131,7836.814815,261.985663
WB_ S26 2250,WB_ S26,2250,296,15890727.44,4524,9206,4682,8328.942568,922.1508422
WB_ S27 2250,WB_ S27,2250,294,15783357.66,7513,8870,1357,8421.540816,304.4863915
WB_ S28 2250,WB_ S28,2250,296,15890727.44,6677,8906,2229,8428.692568,365.8296154
WB_ S29 2250,WB_ S29,2250,295,15837042.55,4087,8323,4236,6689.037288,1018.169831
WB_ S3 2250,WB_ S3,2250,296,15890727.44,2001,8538,6537,6340.456081,1462.830539
WB_ S4 2250,WB_ S4,2250,298,15998097.22,1011,8683,7672,4634.775168,2188.969358
WB_ S5 2250,WB_ S5,2250,298,15998097.22,1150,8771,7621,5481.288591,2638.369205
WB_ S6 2250,WB_ S6,2250,297,15944412.33,1511,8420,6909,4371.646465,1768.577497
WB_ S7 2250,WB_ S7,2250,296,15890727.44,5667,8610,2943,7864.682432,469.9712116
WB_ S8 2250,WB_ S8,2250,298,15998097.22,4818,9316,4498,8091.848993,608.4349607
WB_ S9 2250,WB_ S9,2250,298,15998097.22,349,8964,8615,4006.872483,2387.615889
WB_ W1 2250,WB_ W1,2250,293,15729672.77,1983,9012,7029,6816.74744,1462.970844
WB_ W10 2250,WB_ W10,2250,301,16159151.89,1941,8851,6910,6050.524917,1197.76665
WB_ W2 2250,WB_ W2,2250,294,15783357.66,2371,8775,6404,7987.557823,566.6135365
WB_ W3 2250,WB_ W3,2250,299,16051782.11,3743,8466,4723,6317.167224,1013.343239
WB_ W4 2250,WB_ W4,2250,295,15837042.55,3702,8354,4652,5751.501695,1343.417675
WB_ W5 2250,WB_ W5,2250,300,16105467,4476,8545,4069,7782.95,515.9470847
WB_ W6 2250,WB_ W6,2250,297,15944412.33,7196,8948,1752,8583.993266,252.535626
WB_ W7 2250,WB_ W7,2250,295,15837042.55,49,8760,8711,7271.861017,1698.890255
WB_ W8 2250,WB_ W8,2250,295,15837042.55,3740,8817,5077,6991.532203,977.4002311
WB_ W9 2250,WB_ W9,2250,297,15944412.33,4086,8894,4808,7973.430976,891.5844196
W01 2500,W01,2500,362,19433930.18,1707,8591,6884,7058.928177,1441.259281
W02 2500,W02,2500,365,19594984.85,5052,8954,3902,8135.761644,494.8882765
W03 2500,W03,2500,365,19594984.85,3089,9063,5974,7563.112329,1407.260354
W04 2500,W04,2500,372,19970779.08,5698,8906,3208,8411.962366,352.2326771
W05 2500,W05,2500,364,19541299.96,3858,8575,4717,7934.692308,466.2809355
W06 2500,W06,2500,364,19541299.96,5779,8835,3056,7897.148352,560.3882926
W07 2500,W07,2500,364,19541299.96,3743,8295,4552,6605.398352,956.6944166
W08 2500,W08,2500,364,19541299.96,1724,8920,7196,6326.423077,2144.764093
W09 2500,W09,2500,362,19433930.18,6452,8920,2468,8412.146409,292.5251807
W10 2500,W10,2500,367,19702354.63,4674,8981,4307,8322.610354,589.3049508
W11 2500,W11,2500,364,19541299.96,1983,9012,7029,6582.892857,1557.515273
W12 2500,W12,2500,364,19541299.96,1732,7861,6129,5370.423077,1229.573837
W13 2500,W13,2500,372,19970779.08,965,7829,6864,4389.123656,1510.736451
W14 2500,W14,2500,365,19594984.85,3206,8294,5088,7289.416438,847.0120807
W15 2500,W15,2500,362,19433930.18,1973,8306,6333,6966.737569,1429.422568
W16 2500,W16,2500,362,19433930.18,3439,8870,5431,7913.549724,789.3156796
W17 2500,W17,2500,366,19648669.74,2371,8901,6530,8002.34153,793.410447
W18 2500,W18,2500,365,19594984.85,2976,9316,6340,8036.268493,740.2185529
W19 2500,W19,2500,370,19863409.3,1161,9604,8443,7283.232432,1753.967242
W20 2500,W20,2500,368,19756039.52,5093,8455,3362,7244.391304,950.0023222
W21 2500,W21,2500,364,19541299.96,357,8983,8626,6543.414835,2146.271109
W22 2500,W22,2500,370,19863409.3,531,8919,8388,4944.159459,2571.262434
W23 2500,W23,2500,364,19541299.96,3702,8239,4537,5204.587912,945.8768712
W24 2500,W24,2500,363,19487615.07,2014,8742,6728,6508.710744,2068.896265
W25 2500,W25,2500,370,19863409.3,1122,8642,7520,6901.005405,2093.657218
W26 2500,W26,2500,365,19594984.85,751,9787,9036,4612.443836,2315.876412
W27 2500,W27,2500,364,19541299.96,4763,8601,3838,7859.532967,723.6407011
W28 2500,W28,2500,366,19648669.74,1046,8775,7729,7136.278689,1579.288108
W29 2500,W29,2500,364,19541299.96,3064,8573,5509,7274.340659,1094.971526
W30 2500,W30,2500,364,19541299.96,3105,8740,5635,6905.206044,1057.111991
W31 2500,W31,2500,371,19917094.19,6997,9027,2030,8473.09973,346.1921755
W32 2500,W32,2500,365,19594984.85,4773,9175,4402,8637.238356,524.2955359
W33 2500,W33,2500,365,19594984.85,3464,9110,5646,8251.942466,865.1097069
W34 2500,W34,2500,365,19594984.85,1873,9241,7368,6789.506849,2253.966996
W35 2500,W35,2500,365,19594984.85,2468,8894,6426,7652.775342,1327.308327
W36 2500,W36,2500,362,19433930.18,2739,8744,6005,7672.588398,1335.080788
W37 2500,W37,2500,369,19809724.41,1892,9134,7242,6707.105691,2150.598272
W38 2500,W38,2500,364,19541299.96,8042,8898,856,8547.953297,159.6804519
W39 2500,W39,2500,370,19863409.3,4009,8846,4837,7389.705405,935.7504589
W40 2500,W40,2500,366,19648669.74,2640,8996,6356,7540.248634,1314.960751
W41 2500,W41,2500,367,19702354.63,3255,8804,5549,7872.757493,763.1888989
W42 2500,W42,2500,367,19702354.63,5146,8876,3730,7889.694823,778.115084
W43 2500,W43,2500,367,19702354.63,3375,8119,4744,7186.253406,1012.476863
W44 2500,W44,2500,364,19541299.96,3177,8722,5545,7548.332418,892.2703213
W45 2500,W45,2500,364,19541299.96,1883,8835,6952,6764.365385,1763.045223
W46 2500,W46,2500,364,19541299.96,2378,8668,6290,6884.162088,1588.020443
W47 2500,W47,2500,367,19702354.63,2477,8756,6279,7027.700272,1410.135278
W48 2500,W48,2500,363,19487615.07,7387,8860,1473,7889.528926,262.9990334
W49 2500,W49,2500,370,19863409.3,1944,8717,6773,6659.324324,1814.457774
W50 2500,W50,2500,365,19594984.85,4632,8736,4104,7731.646575,773.7254644
W51 2500,W51,2500,365,19594984.85,6767,8677,1910,7946.306849,459.4763238
W52 2500,W52,2500,365,19594984.85,1594,8758,7164,5185.808219,2011.259497
W53 2500,W53,2500,365,19594984.85,5778,8530,2752,7565.624658,553.029122
W54 2500,W54,2500,365,19594984.85,1699,8514,6815,5980.627397,2199.489344
W55 2500,W55,2500,372,19970779.08,2330,8972,6642,7944.591398,1357.50525
W56 2500,W56,2500,363,19487615.07,1578,8939,7361,7788.942149,1528.451605
W57 2500,W57,2500,365,19594984.85,1810,9349,7539,5207.572603,2086.539373
W58 2500,W58,2500,370,19863409.3,3201,9352,6151,7747.324324,1247.869271
W59 2500,W59,2500,367,19702354.63,1836,8450,6614,6005.757493,1627.065779
W60 2500,W60,2500,366,19648669.74,5646,8661,3015,8080.240437,411.4735975
W61 2500,W61,2500,365,19594984.85,1976,8836,6860,7658.038356,1203.250364
W62 2500,W62,2500,365,19594984.85,1255,9427,8172,5263.761644,2175.134971
W63 2500,W63,2500,365,19594984.85,720,8707,7987,3872.682192,2333.736519
W64 2500,W64,2500,364,19541299.96,3963,8851,4888,7261.804945,782.7910321
W65 2500,W65,2500,370,19863409.3,748,8679,7931,4695.967568,2400.79523
W66 2500,W66,2500,366,19648669.74,1182,8267,7085,4981.631148,2176.204368
WB_ E1 2500,WB_ E1,2500,371,19917094.19,171,8882,8711,4945.762803,2555.336604
WB_ E10 2500,WB_ E10,2500,367,19702354.63,1093,8450,7357,3989.040872,2017.240535
WB_ E2 2500,WB_ E2,2500,364,19541299.96,5978,8485,2507,7785.82967,417.6249679
WB_ E3 2500,WB_ E3,2500,369,19809724.41,7105,8691,1586,7808.181572,283.1820583
WB_ E4 2500,WB_ E4,2500,363,19487615.07,6188,8948,2760,8507.336088,454.609544
WB_ E5 2500,WB_ E5,2500,369,19809724.41,130,9272,9142,4318.184282,2638.813237
WB_ E6 2500,WB_ E6,2500,366,19648669.74,5730,8963,3233,7692.442623,407.5134457
WB_ E7 2500,WB_ E7,2500,364,19541299.96,1553,8601,7048,6443.288462,1898.142263
WB_ E8 2500,WB_ E8,2500,367,19702354.63,2022,9074,7052,7170.378747,2033.367203
WB_ E9 2500,WB_ E9,2500,373,20024463.97,1142,8769,7627,6150.560322,2305.185284
WB_ H1 2500,WB_ H1,2500,365,19594984.85,1611,8735,7124,7141.832877,1723.202581
WB_ H10 2500,WB_ H10,2500,366,19648669.74,1525,8687,7162,6029.368852,2334.053349
WB_ H2 2500,WB_ H2,2500,370,19863409.3,2286,9009,6723,6484.740541,1763.816249
WB_ H3 2500,WB_ H3,2500,362,19433930.18,1929,9261,7332,6289.80663,2281.169654
WB_ H4 2500,WB_ H4,2500,367,19702354.63,1511,8751,7240,6276.3297,2260.394444
WB_ H5 2500,WB_ H5,2500,367,19702354.63,1510,8645,7135,4784.027248,2384.901688
WB_ H6 2500,WB_ H6,2500,365,19594984.85,425,9424,8999,5217.027397,2570.645944
WB_ H7 2500,WB_ H7,2500,367,19702354.63,-503,9480,9983,4538.3297,2926.465881
WB_ H8 2500,WB_ H8,2500,362,19433930.18,1150,8561,7411,5019.093923,2416.71938
WB_ H9 2500,WB_ H9,2500,365,19594984.85,497,8442,7945,3503.249315,2512.29811
WB_ S1 2500,WB_ S1,2500,366,19648669.74,-283,9150,9433,4766.912568,2934.095299
WB_ S10 2500,WB_ S10,2500,362,19433930.18,720,9426,8706,5043.68232,2257.646389
WB_ S11 2500,WB_ S11,2500,365,19594984.85,911,8679,7768,5056.720548,2491.241013
WB_ S12 2500,WB_ S12,2500,369,19809724.41,1590,8363,6773,5465.943089,1793.920799
WB_ S13 2500,WB_ S13,2500,370,19863409.3,1528,8662,7134,4543.716216,1997.196472
WB_ S14 2500,WB_ S14,2500,372,19970779.08,4143,8694,4551,7553.80914,679.0842613
WB_ S15 2500,WB_ S15,2500,365,19594984.85,2378,8668,6290,7017.972603,1586.249437
WB_ S16 2500,WB_ S16,2500,370,19863409.3,751,8760,8009,5186.681081,2413.128186
WB_ S17 2500,WB_ S17,2500,366,19648669.74,3073,8550,5477,7224.467213,1124.706078
WB_ S18 2500,WB_ S18,2500,367,19702354.63,1873,9161,7288,6297.809264,2093.826564
WB_ S19 2500,WB_ S19,2500,368,19756039.52,2025,8850,6825,6679.747283,1895.576241
WB_ S2 2500,WB_ S2,2500,370,19863409.3,-698,9516,10214,4579.537838,3789.236273
WB_ S20 2500,WB_ S20,2500,365,19594984.85,6493,8902,2409,8580.049315,353.2580768
WB_ S21 2500,WB_ S21,2500,365,19594984.85,2961,8856,5895,7402.476712,1194.014101
WB_ S22 2500,WB_ S22,2500,366,19648669.74,7264,8963,1699,7862.453552,411.4390403
WB_ S23 2500,WB_ S23,2500,365,19594984.85,755,9040,8285,7249.008219,1592.040466
WB_ S24 2500,WB_ S24,2500,365,19594984.85,381,8414,8033,3021.882192,2310.564377
WB_ S25 2500,WB_ S25,2500,365,19594984.85,6227,8394,2167,7832.953425,270.3612915
WB_ S26 2500,WB_ S26,2500,369,19809724.41,4524,9206,4682,8362.669377,855.1707316
WB_ S27 2500,WB_ S27,2500,366,19648669.74,7513,8870,1357,8426.73224,299.8959007
WB_ S28 2500,WB_ S28,2500,362,19433930.18,6677,8906,2229,8381.074586,392.5359433
WB_ S29 2500,WB_ S29,2500,363,19487615.07,4087,8323,4236,6738.606061,1028.640659
WB_ S3 2500,WB_ S3,2500,362,19433930.18,1824,8576,6752,6248.325967,1590.53125
WB_ S4 2500,WB_ S4,2500,366,19648669.74,1011,8683,7672,4774.352459,2235.158952
WB_ S5 2500,WB_ S5,2500,369,19809724.41,1150,8771,7621,5578.720867,2582.113455
WB_ S6 2500,WB_ S6,2500,369,19809724.41,1511,8420,6909,4505.246612,1800.766826
WB_ S7 2500,WB_ S7,2500,365,19594984.85,5203,8610,3407,7847.043836,555.7178433
WB_ S8 2500,WB_ S8,2500,365,19594984.85,4542,9316,4774,8000.841096,718.3316111
WB_ S9 2500,WB_ S9,2500,370,19863409.3,349,8964,8615,4208.378378,2345.747616
WB_ W1 2500,WB_ W1,2500,365,19594984.85,1983,9040,7057,6685.079452,1571.328593
WB_ W10 2500,WB_ W10,2500,366,19648669.74,1941,8851,6910,6052.428962,1303.093303
WB_ W2 2500,WB_ W2,2500,367,19702354.63,1990,8832,6842,7943.47139,690.4777903
WB_ W3 2500,WB_ W3,2500,364,19541299.96,3743,8640,4897,6450.714286,1057.602545
WB_ W4 2500,WB_ W4,2500,366,19648669.74,3702,8437,4735,5843.090164,1389.587787
WB_ W5 2500,WB_ W5,2500,372,19970779.08,4476,8545,4069,7775.443548,517.3411652
WB_ W6 2500,WB_ W6,2500,366,19648669.74,6433,8948,2515,8537.806011,342.3965012
WB_ W7 2500,WB_ W7,2500,364,19541299.96,49,9178,9129,7029.994505,2059.486844
WB_ W8 2500,WB_ W8,2500,366,19648669.74,3740,8817,5077,7070.855191,936.1849091
WB_ W9 2500,WB_ W9,2500,366,19648669.74,2854,8894,6040,7953.23224,991.5798556
W01 2750,W01,2750,440,23621351.6,395,8591,8196,7014.297727,1538.553886
W02 2750,W02,2750,445,23889776.05,1261,8994,7733,8039.65618,757.529406
W03 2750,W03,2750,444,23836091.16,3089,9063,5974,7579.126126,1375.340502
W04 2750,W04,2750,445,23889776.05,5698,8906,3208,8384.103371,380.9320363
W05 2750,W05,2750,441,23675036.49,1990,8575,6585,7856.37415,704.5659851
W06 2750,W06,2750,441,23675036.49,5779,8835,3056,7918.346939,566.1832871
W07 2750,W07,2750,443,23782406.27,3743,8416,4673,6564.86456,988.6296326
W08 2750,W08,2750,441,23675036.49,1724,8920,7196,6376.219955,2160.01121
W09 2750,W09,2750,440,23621351.6,5433,8920,3487,8361.393182,392.955124
W10 2750,W10,2750,446,23943460.94,4425,8981,4556,8267.786996,696.5753201
W11 2750,W11,2750,440,23621351.6,1983,9040,7057,6443.695455,1663.196618
W12 2750,W12,2750,444,23836091.16,1493,7861,6368,5233.691441,1287.589497
W13 2750,W13,2750,444,23836091.16,822,8400,7578,4402.396396,1578.437383
W14 2750,W14,2750,444,23836091.16,3106,8332,5226,7229.20045,965.876362
W15 2750,W15,2750,440,23621351.6,1973,8500,6527,6973.034091,1458.043973
W16 2750,W16,2750,440,23621351.6,2437,8870,6433,7798.309091,1060.976765
W17 2750,W17,2750,442,23728721.38,1926,8901,6975,7770.542986,1255.766775
W18 2750,W18,2750,446,23943460.94,2976,9316,6340,7975.452915,851.7865247
W19 2750,W19,2750,443,23782406.27,1065,9604,8539,7225.024831,1852.093406
W20 2750,W20,2750,443,23782406.27,3262,8455,5193,7189.948081,1047.491291
W21 2750,W21,2750,444,23836091.16,357,9240,8883,6587.617117,2167.556113
W22 2750,W22,2750,442,23728721.38,531,8919,8388,4939.914027,2517.02346
W23 2750,W23,2750,444,23836091.16,2739,8657,5918,5382.195946,1084.285674
W24 2750,W24,2750,441,23675036.49,2014,8742,6728,6401.823129,2121.402311
W25 2750,W25,2750,445,23889776.05,1122,8642,7520,6741.139326,2170.834187
W26 2750,W26,2750,446,23943460.94,730,9787,9057,4526.618834,2280.524359
W27 2750,W27,2750,440,23621351.6,4486,8601,4115,7787.104545,801.7682152
W28 2750,W28,2750,443,23782406.27,957,8775,7818,7022.790068,1728.337321
W29 2750,W29,2750,443,23782406.27,1928,8775,6847,7182.86456,1211.511413
W30 2750,W30,2750,442,23728721.38,3105,8740,5635,7016.493213,1047.362026
W31 2750,W31,2750,444,23836091.16,6997,9027,2030,8471.358108,351.4833242
W32 2750,W32,2750,438,23513981.82,4773,9175,4402,8635.915525,524.7901557
W33 2750,W33,2750,440,23621351.6,3464,9110,5646,8238.361364,892.2605479
W34 2750,W34,2750,437,23460296.93,1873,9241,7368,6577.546911,2320.623842
W35 2750,W35,2750,440,23621351.6,2287,8899,6612,7587.115909,1421.199576
W36 2750,W36,2750,439,23567666.71,2411,8773,6362,7679.653759,1363.843493
W37 2750,W37,2750,445,23889776.05,1892,9134,7242,6809.332584,2101.529249
W38 2750,W38,2750,437,23460296.93,8042,8898,856,8555.20595,159.0343677
W39 2750,W39,2750,444,23836091.16,4009,8846,4837,7473.227477,909.7150455
W40 2750,W40,2750,445,23889776.05,2640,8996,6356,7448.501124,1375.464252
W41 2750,W41,2750,446,23943460.94,3140,8804,5664,7811.654709,833.9345513
W42 2750,W42,2750,447,23997145.83,5146,8946,3800,7899.163311,761.4613865
W43 2750,W43,2750,445,23889776.05,3375,8712,5337,7157.85618,1067.723754
W44 2750,W44,2750,443,23782406.27,3177,8722,5545,7587.96614,872.5444079
W45 2750,W45,2750,444,23836091.16,1883,8835,6952,6880.828829,1692.964137
W46 2750,W46,2750,442,23728721.38,2367,8687,6320,6930.325792,1610.784672
W47 2750,W47,2750,444,23836091.16,1962,8756,6794,6902.038288,1599.023644
W48 2750,W48,2750,443,23782406.27,7387,8860,1473,7897.875847,274.6274561
W49 2750,W49,2750,445,23889776.05,1787,8717,6930,6476.002247,1872.045336
W50 2750,W50,2750,445,23889776.05,4141,8736,4595,7716.770787,801.4544848
W51 2750,W51,2750,442,23728721.38,6757,8774,2017,7947.072398,469.7552836
W52 2750,W52,2750,444,23836091.16,1594,8758,7164,5197.414414,2023.496696
W53 2750,W53,2750,444,23836091.16,5778,8530,2752,7543.045045,554.4640442
W54 2750,W54,2750,437,23460296.93,1699,8514,6815,5921.94508,2169.04486
W55 2750,W55,2750,445,23889776.05,2241,8972,6731,7750.885393,1582.512696
W56 2750,W56,2750,441,23675036.49,1235,8939,7704,7695.961451,1657.868135
W57 2750,W57,2750,442,23728721.38,1810,9349,7539,5189.599548,2127.402901
W58 2750,W58,2750,444,23836091.16,2145,9352,7207,7604.813063,1402.887154
W59 2750,W59,2750,444,23836091.16,1799,8450,6651,5762.900901,1699.54502
W60 2750,W60,2750,445,23889776.05,5448,8661,3213,8025.170787,497.4661979
W61 2750,W61,2750,442,23728721.38,1976,8968,6992,7717.558824,1166.271205
W62 2750,W62,2750,444,23836091.16,1245,9427,8182,5267.529279,2257.496984
W63 2750,W63,2750,440,23621351.6,720,8707,7987,3745.65,2270.742094
W64 2750,W64,2750,437,23460296.93,3963,8851,4888,7248.457666,811.7356302
W65 2750,W65,2750,444,23836091.16,748,8679,7931,4508.918919,2445.648401
W66 2750,W66,2750,443,23782406.27,1155,8267,7112,4675.602709,2254.604804
WB_ E1 2750,WB_ E1,2750,443,23782406.27,171,9272,9101,5046.458239,2582.707236
WB_ E10 2750,WB_ E10,2750,441,23675036.49,1005,8450,7445,3942.097506,2044.289237
WB_ E2 2750,WB_ E2,2750,444,23836091.16,5978,8485,2507,7777.281532,450.7071666
WB_ E3 2750,WB_ E3,2750,446,23943460.94,7043,8691,1648,7792.856502,303.1311812
WB_ E4 2750,WB_ E4,2750,443,23782406.27,3412,8948,5536,8394.261851,685.9320094
WB_ E5 2750,WB_ E5,2750,444,23836091.16,130,9272,9142,4053.155405,2615.241303
WB_ E6 2750,WB_ E6,2750,446,23943460.94,4304,8963,4659,7633.784753,559.1477366
WB_ E7 2750,WB_ E7,2750,446,23943460.94,1553,8632,7079,6485.786996,1871.506287
WB_ E8 2750,WB_ E8,2750,446,23943460.94,2022,9074,7052,6925.446188,2156.854832
WB_ E9 2750,WB_ E9,2750,447,23997145.83,1142,8769,7627,5832.993289,2464.758438
WB_ H1 2750,WB_ H1,2750,437,23460296.93,1611,8735,7124,7129.02746,1776.323452
WB_ H10 2750,WB_ H10,2750,440,23621351.6,1525,8878,7353,6058.359091,2296.285036
WB_ H2 2750,WB_ H2,2750,444,23836091.16,2286,9009,6723,6581.986486,1777.270859
WB_ H3 2750,WB_ H3,2750,439,23567666.71,1929,9261,7332,6338.375854,2266.982392
WB_ H4 2750,WB_ H4,2750,446,23943460.94,1511,8751,7240,6294.975336,2182.795017
WB_ H5 2750,WB_ H5,2750,446,23943460.94,1510,8645,7135,4924.338565,2360.703926
WB_ H6 2750,WB_ H6,2750,444,23836091.16,425,9424,8999,5312.509009,2581.804238
WB_ H7 2750,WB_ H7,2750,445,23889776.05,-503,9480,9983,4558.779775,2824.525748
WB_ H8 2750,WB_ H8,2750,440,23621351.6,1150,8689,7539,5227.504545,2400.145817
WB_ H9 2750,WB_ H9,2750,445,23889776.05,497,8442,7945,3757.716854,2514.527887
WB_ S1 2750,WB_ S1,2750,438,23513981.82,-283,9150,9433,4594.856164,2996.052216
WB_ S10 2750,WB_ S10,2750,441,23675036.49,720,9427,8707,4920.156463,2373.818954
WB_ S11 2750,WB_ S11,2750,441,23675036.49,748,8679,7931,4974.365079,2537.715323
WB_ S12 2750,WB_ S12,2750,444,23836091.16,1360,8363,7003,5346.97973,1929.299911
WB_ S13 2750,WB_ S13,2750,445,23889776.05,1510,8754,7244,4694.242697,2082.86296
WB_ S14 2750,WB_ S14,2750,446,23943460.94,4011,8694,4683,7505.071749,757.2554937
WB_ S15 2750,WB_ S15,2750,437,23460296.93,2367,8668,6301,7026.329519,1598.60153
WB_ S16 2750,WB_ S16,2750,444,23836091.16,751,8760,8009,5204.623874,2467.160137
WB_ S17 2750,WB_ S17,2750,445,23889776.05,3073,8672,5599,7269.566292,1091.268083
WB_ S18 2750,WB_ S18,2750,446,23943460.94,1873,9161,7288,6364.134529,2089.487387
WB_ S19 2750,WB_ S19,2750,445,23889776.05,1934,8850,6916,6586.961798,1951.309721
WB_ S2 2750,WB_ S2,2750,442,23728721.38,-698,9516,10214,4542.911765,3821.69026
WB_ S20 2750,WB_ S20,2750,446,23943460.94,6493,8902,2409,8536.847534,405.4821899
WB_ S21 2750,WB_ S21,2750,441,23675036.49,2961,8856,5895,7388.056689,1190.955427
WB_ S22 2750,WB_ S22,2750,446,23943460.94,7264,8963,1699,7832.630045,400.3530224
WB_ S23 2750,WB_ S23,2750,443,23782406.27,755,9040,8285,7124.679458,1711.537603
WB_ S24 2750,WB_ S24,2750,444,23836091.16,381,8414,8033,3294.466216,2455.026692
WB_ S25 2750,WB_ S25,2750,447,23997145.83,4476,8736,4260,7830.541387,347.6864121
WB_ S26 2750,WB_ S26,2750,447,23997145.83,3670,9206,5536,8380.557047,837.0439789
WB_ S27 2750,WB_ S27,2750,446,23943460.94,7513,9070,1557,8448.390135,294.5229255
WB_ S28 2750,WB_ S28,2750,439,23567666.71,6677,8906,2229,8338.537585,416.0014377
WB_ S29 2750,WB_ S29,2750,441,23675036.49,4087,8326,4239,6788.673469,1025.312557
WB_ S3 2750,WB_ S3,2750,440,23621351.6,1623,8576,6953,6191.525,1713.722735
WB_ S4 2750,WB_ S4,2750,444,23836091.16,1011,8683,7672,4847.45045,2252.917884
WB_ S5 2750,WB_ S5,2750,445,23889776.05,1150,8771,7621,5667.67191,2532.198272
WB_ S6 2750,WB_ S6,2750,446,23943460.94,1511,8706,7195,4696.026906,1873.222431
WB_ S7 2750,WB_ S7,2750,443,23782406.27,5203,8610,3407,7827.620767,601.6510472
WB_ S8 2750,WB_ S8,2750,445,23889776.05,4542,9316,4774,7932.159551,767.782793
WB_ S9 2750,WB_ S9,2750,444,23836091.16,349,8964,8615,4288.813063,2320.150533
WB_ W1 2750,WB_ W1,2750,437,23460296.93,1572,9040,7468,6506.254005,1715.042325
WB_ W10 2750,WB_ W10,2750,443,23782406.27,1941,8851,6910,6077.155756,1392.413993
WB_ W2 2750,WB_ W2,2750,447,23997145.83,1990,8832,6842,7911.823266,809.899476
WB_ W3 2750,WB_ W3,2750,444,23836091.16,3743,8640,4897,6554.959459,1075.242559
WB_ W4 2750,WB_ W4,2750,445,23889776.05,3702,8444,4742,5969.301124,1415.213099
WB_ W5 2750,WB_ W5,2750,446,23943460.94,4476,8570,4094,7752.06278,541.3322634
WB_ W6 2750,WB_ W6,2750,444,23836091.16,6105,8948,2843,8482.918919,441.8396255
WB_ W7 2750,WB_ W7,2750,441,23675036.49,49,9178,9129,6796.503401,2337.852415
WB_ W8 2750,WB_ W8,2750,441,23675036.49,3740,8817,5077,7139.594104,904.8014482
WB_ W9 2750,WB_ W9,2750,446,23943460.94,2033,8894,6861,7925.663677,1045.237615
W01 3000,W01,3000,525,28184567.25,395,8873,8478,6942.558095,1676.724522
W02 3000,W02,3000,529,28399306.81,395,8994,8599,7954.722117,924.1644693
W03 3000,W03,3000,526,28238252.14,3089,9063,5974,7611.726236,1325.726539
W04 3000,W04,3000,533,28614046.37,5380,8906,3526,8343.821764,436.8789316
W05 3000,W05,3000,530,28452991.7,1922,8775,6853,7786.560377,872.6592503
W06 3000,W06,3000,526,28238252.14,5779,8835,3056,7935.007605,566.9767398
W07 3000,W07,3000,523,28077197.47,3282,8585,5303,6569.625239,1038.154892
W08 3000,W08,3000,526,28238252.14,1724,8920,7196,6490.469582,2137.347814
W09 3000,W09,3000,527,28291937.03,5233,8920,3687,8291.1537,516.9300867
W10 3000,W10,3000,528,28345621.92,2833,8981,6148,8194.835227,829.6132664
W11 3000,W11,3000,527,28291937.03,1572,9040,7468,6302.140417,1757.65733
W12 3000,W12,3000,522,28023512.58,975,7861,6886,5120.942529,1348.653725
W13 3000,W13,3000,531,28506676.59,511,8400,7889,4415.380414,1639.829037
W14 3000,W14,3000,525,28184567.25,3106,8651,5545,7200.739048,1010.937194
W15 3000,W15,3000,528,28345621.92,1973,8500,6527,7002.962121,1451.029159
W16 3000,W16,3000,527,28291937.03,2330,8870,6540,7649.768501,1283.843258
W17 3000,W17,3000,527,28291937.03,925,8949,8024,7564.309298,1589.979623
W18 3000,W18,3000,525,28184567.25,2699,9316,6617,7921.348571,952.4699932
W19 3000,W19,3000,528,28345621.92,397,9604,9207,7119.276515,2002.743097
W20 3000,W20,3000,531,28506676.59,3262,8455,5193,7101.19774,1154.959047
W21 3000,W21,3000,522,28023512.58,357,9240,8883,6651.1341,2182.016924
W22 3000,W22,3000,534,28667731.26,349,8919,8570,4947.707865,2464.003683
W23 3000,W23,3000,524,28130882.36,2480,8964,6484,5529.723282,1219.344562
W24 3000,W24,3000,527,28291937.03,1048,8742,7694,6336.354839,2153.709628
W25 3000,W25,3000,529,28399306.81,1122,8642,7520,6575.599244,2209.432623
W26 3000,W26,3000,525,28184567.25,615,9787,9172,4468.219048,2261.901887
W27 3000,W27,3000,527,28291937.03,3778,8601,4823,7670.311195,919.6302068
W28 3000,W28,3000,523,28077197.47,957,8775,7818,6953.388145,1790.582425
W29 3000,W29,3000,525,28184567.25,1928,8775,6847,7114.293333,1321.30879
W30 3000,W30,3000,526,28238252.14,3105,8740,5635,7112.423954,1039.338692
W31 3000,W31,3000,532,28560361.48,6997,9027,2030,8471.018797,351.3760378
W32 3000,W32,3000,526,28238252.14,4524,9227,4703,8622.294677,597.2703869
W33 3000,W33,3000,528,28345621.92,3464,9110,5646,8210.482955,889.1490525
W34 3000,W34,3000,525,28184567.25,1873,9261,7388,6403.942857,2356.439782
W35 3000,W35,3000,527,28291937.03,2171,8965,6794,7550.254269,1449.089765
W36 3000,W36,3000,527,28291937.03,2411,8883,6472,7696.88425,1362.928657
W37 3000,W37,3000,526,28238252.14,1892,9134,7242,6875.38403,2072.580842
W38 3000,W38,3000,526,28238252.14,7998,8902,904,8559.262357,158.2897053
W39 3000,W39,3000,533,28614046.37,4009,8846,4837,7539.793621,895.3956721
W40 3000,W40,3000,529,28399306.81,2640,8996,6356,7378.833648,1408.615694
W41 3000,W41,3000,527,28291937.03,3140,8815,5675,7781.303605,839.5064935
W42 3000,W42,3000,528,28345621.92,5146,8946,3800,7886.460227,770.8971274
W43 3000,W43,3000,527,28291937.03,3375,8715,5340,7164.891841,1060.412169
W44 3000,W44,3000,527,28291937.03,3177,8722,5545,7601.833017,878.8587728
W45 3000,W45,3000,524,28130882.36,1883,8835,6952,6938.135496,1651.294547
W46 3000,W46,3000,529,28399306.81,1918,8687,6769,6937.551985,1624.985983
W47 3000,W47,3000,526,28238252.14,1797,8756,6959,6828.857414,1665.841023
W48 3000,W48,3000,522,28023512.58,7387,8860,1473,7903.588123,283.0545973
W49 3000,W49,3000,532,28560361.48,1787,8717,6930,6340.488722,1932.497991
W50 3000,W50,3000,526,28238252.14,4141,8736,4595,7657.057034,875.6308951
W51 3000,W51,3000,526,28238252.14,5944,8774,2830,7950.444867,477.8020851
W52 3000,W52,3000,527,28291937.03,1594,8758,7164,5263.136622,2024.611715
W53 3000,W53,3000,526,28238252.14,5778,8530,2752,7526.918251,562.4307131
W54 3000,W54,3000,523,28077197.47,1699,8514,6815,5871.512428,2142.098541
W55 3000,W55,3000,533,28614046.37,2033,8972,6939,7579.971857,1730.440317
W56 3000,W56,3000,527,28291937.03,1235,8959,7724,7662.624288,1706.071374
W57 3000,W57,3000,529,28399306.81,1810,9349,7539,5259.442344,2174.636851
W58 3000,W58,3000,534,28667731.26,2001,9352,7351,7443.78839,1593.175899
W59 3000,W59,3000,527,28291937.03,1627,8450,6823,5624.216319,1737.432644
W60 3000,W60,3000,527,28291937.03,4283,8684,4401,7972.14611,616.2810045
W61 3000,W61,3000,529,28399306.81,1976,9115,7139,7751.387524,1129.910656
W62 3000,W62,3000,526,28238252.14,1245,9427,8182,5269.929658,2302.593743
W63 3000,W63,3000,527,28291937.03,720,8707,7987,3648.356736,2203.457004
W64 3000,W64,3000,527,28291937.03,3444,8851,5407,7231.087287,862.1113243
W65 3000,W65,3000,533,28614046.37,748,8679,7931,4316.921201,2436.528267
W66 3000,W66,3000,530,28452991.7,738,8517,7779,4468.286792,2302.386836
WB_ E1 3000,WB_ E1,3000,533,28614046.37,171,9272,9101,5089.816135,2589.510712
WB_ E10 3000,WB_ E10,3000,528,28345621.92,823,8450,7627,3887.518939,2030.055488
WB_ E2 3000,WB_ E2,3000,524,28130882.36,4173,8903,4730,7758.967557,518.2796344
WB_ E3 3000,WB_ E3,3000,529,28399306.81,6998,8691,1693,7767.548204,314.5369598
WB_ E4 3000,WB_ E4,3000,522,28023512.58,3412,8948,5536,8272.019157,885.5646702
WB_ E5 3000,WB_ E5,3000,531,28506676.59,130,9272,9142,3847.783427,2571.666874
WB_ E6 3000,WB_ E6,3000,526,28238252.14,4304,8963,4659,7604.062738,631.0401139
WB_ E7 3000,WB_ E7,3000,526,28238252.14,1553,9447,7894,6482.1673,1896.696457
WB_ E8 3000,WB_ E8,3000,527,28291937.03,1846,9074,7228,6733.886148,2242.111295
WB_ E9 3000,WB_ E9,3000,534,28667731.26,854,8769,7915,5548.378277,2561.923897
WB_ H1 3000,WB_ H1,3000,525,28184567.25,1611,8735,7124,7083.371429,1819.436134
WB_ H10 3000,WB_ H10,3000,526,28238252.14,1525,8878,7353,6055.674905,2237.970977
WB_ H2 3000,WB_ H2,3000,533,28614046.37,2281,9009,6728,6691.105066,1793.086956
WB_ H3 3000,WB_ H3,3000,526,28238252.14,1929,9261,7332,6335.54943,2279.965566
WB_ H4 3000,WB_ H4,3000,526,28238252.14,1511,8832,7321,6310.085551,2125.392697
WB_ H5 3000,WB_ H5,3000,527,28291937.03,1510,8662,7152,5016.891841,2348.84743
WB_ H6 3000,WB_ H6,3000,525,28184567.25,425,9424,8999,5292.737143,2609.351076
WB_ H7 3000,WB_ H7,3000,528,28345621.92,-503,9480,9983,4647.13447,2758.86752
WB_ H8 3000,WB_ H8,3000,526,28238252.14,1150,8771,7621,5397.427757,2425.903419
WB_ H9 3000,WB_ H9,3000,526,28238252.14,497,8442,7945,3931.448669,2510.829378
WB_ S1 3000,WB_ S1,3000,526,28238252.14,-283,9365,9648,4385.520913,3033.043817
WB_ S10 3000,WB_ S10,3000,527,28291937.03,720,9427,8707,4776.931689,2457.228247
WB_ S11 3000,WB_ S11,3000,528,28345621.92,748,8679,7931,5007.422348,2568.065003
WB_ S12 3000,WB_ S12,3000,532,28560361.48,1247,8363,7116,5255.537594,2005.458146
WB_ S13 3000,WB_ S13,3000,533,28614046.37,1510,8754,7244,4819.268293,2172.077195
WB_ S14 3000,WB_ S14,3000,534,28667731.26,3287,8694,5407,7413.559925,883.3443723
WB_ S15 3000,WB_ S15,3000,526,28238252.14,2367,8687,6320,7054.104563,1581.498282
WB_ S16 3000,WB_ S16,3000,534,28667731.26,751,8760,8009,5306.318352,2487.51061
WB_ S17 3000,WB_ S17,3000,528,28345621.92,3073,8672,5599,7314.683712,1048.88927
WB_ S18 3000,WB_ S18,3000,526,28238252.14,1873,9161,7288,6475.053232,2074.164017
WB_ S19 3000,WB_ S19,3000,526,28238252.14,1928,8850,6922,6539.372624,1964.17531
WB_ S2 3000,WB_ S2,3000,531,28506676.59,-698,9516,10214,4489.384181,3857.351111
WB_ S20 3000,WB_ S20,3000,528,28345621.92,3377,8902,5525,8478.526515,590.756211
WB_ S21 3000,WB_ S21,3000,527,28291937.03,2961,8856,5895,7384.675522,1166.993817
WB_ S22 3000,WB_ S22,3000,526,28238252.14,6675,8963,2288,7815.570342,394.1758233
WB_ S23 3000,WB_ S23,3000,529,28399306.81,755,9040,8285,7036.096408,1808.862309
WB_ S24 3000,WB_ S24,3000,526,28238252.14,381,8414,8033,3517.357414,2500.590302
WB_ S25 3000,WB_ S25,3000,526,28238252.14,4476,8736,4260,7824.585551,396.2519594
WB_ S26 3000,WB_ S26,3000,529,28399306.81,3670,9206,5536,8393.096408,812.07096
WB_ S27 3000,WB_ S27,3000,528,28345621.92,7362,9070,1708,8466.185606,291.7840948
WB_ S28 3000,WB_ S28,3000,526,28238252.14,6677,9063,2386,8313.418251,421.0530931
WB_ S29 3000,WB_ S29,3000,528,28345621.92,4087,8507,4420,6834.725379,1023.423595
WB_ S3 3000,WB_ S3,3000,526,28238252.14,1264,8576,7312,6113.34981,1828.661268
WB_ S4 3000,WB_ S4,3000,526,28238252.14,929,8869,7940,4856.507605,2239.437776
WB_ S5 3000,WB_ S5,3000,531,28506676.59,1150,8771,7621,5743.099812,2468.559369
WB_ S6 3000,WB_ S6,3000,526,28238252.14,1511,8832,7321,4872.039924,1933.088168
WB_ S7 3000,WB_ S7,3000,528,28345621.92,5203,8610,3407,7806.698864,625.1463028
WB_ S8 3000,WB_ S8,3000,526,28238252.14,4542,9316,4774,7894.235741,802.1930857
WB_ S9 3000,WB_ S9,3000,533,28614046.37,338,8964,8626,4415.056285,2330.486291
WB_ W1 3000,WB_ W1,3000,525,28184567.25,1572,9040,7468,6338.173333,1812.317804
WB_ W10 3000,WB_ W10,3000,523,28077197.47,1613,8851,7238,6074.527725,1476.753521
WB_ W2 3000,WB_ W2,3000,528,28345621.92,1922,8881,6959,7896.420455,878.2632922
WB_ W3 3000,WB_ W3,3000,525,28184567.25,3626,8640,5014,6615.154286,1091.572169
WB_ W4 3000,WB_ W4,3000,528,28345621.92,3702,8642,4940,6081.922348,1438.370512
WB_ W5 3000,WB_ W5,3000,532,28560361.48,4476,8661,4185,7755.229323,539.3970039
WB_ W6 3000,WB_ W6,3000,527,28291937.03,4695,8948,4253,8434.607211,532.1063434
WB_ W7 3000,WB_ W7,3000,525,28184567.25,-714,9431,10145,6603.497143,2558.113684
WB_ W8 3000,WB_ W8,3000,526,28238252.14,3740,8817,5077,7201.471483,882.2171032
WB_ W9 3000,WB_ W9,3000,525,28184567.25,2033,8894,6861,7882.571429,1093.436842
W01 3250,W01,3250,616,33069892.24,395,9102,8707,6920.829545,1741.184715
W02 3250,W02,3250,618,33177262.02,395,8994,8599,7869.317152,1086.947114
W03 3250,W03,3250,621,33338316.69,3089,9063,5974,7567.68599,1358.37236
W04 3250,W04,3250,618,33177262.02,4306,8906,4600,8293.153722,495.1833376
W05 3250,W05,3250,618,33177262.02,1922,8832,6910,7706.152104,988.4472424
W06 3250,W06,3250,615,33016207.35,5779,8835,3056,7955.16748,572.3137802
W07 3250,W07,3250,620,33284631.8,2516,8841,6325,6570.537097,1131.629587
W08 3250,W08,3250,615,33016207.35,1724,8920,7196,6612.593496,2073.644643
W09 3250,W09,3250,616,33069892.24,5106,8920,3814,8236.983766,584.1658053
W10 3250,W10,3250,621,33338316.69,2833,8981,6148,8123.091787,933.0676569
W11 3250,W11,3250,614,32962522.46,1572,9040,7468,6150.286645,1829.786911
W12 3250,W12,3250,620,33284631.8,975,8071,7096,5070.967742,1404.014446
W13 3250,W13,3250,618,33177262.02,511,8400,7889,4478.799353,1707.599613
W14 3250,W14,3250,621,33338316.69,3106,8651,5545,7144.821256,1091.559774
W15 3250,W15,3250,616,33069892.24,1973,8780,6807,7026.719156,1472.754014
W16 3250,W16,3250,616,33069892.24,976,8870,7894,7491.647727,1477.815537
W17 3250,W17,3250,617,33123577.13,38,9093,9055,7396.400324,1870.70069
W18 3250,W18,3250,621,33338316.69,927,9316,8389,7859.764895,1042.109923
W19 3250,W19,3250,618,33177262.02,397,9604,9207,7050.449838,2087.58281
W20 3250,W20,3250,618,33177262.02,1771,8504,6733,7015.964401,1267.322457
W21 3250,W21,3250,620,33284631.8,357,9240,8883,6689.991935,2194.516607
W22 3250,W22,3250,616,33069892.24,349,8919,8570,4962.040584,2445.757371
W23 3250,W23,3250,619,33230946.91,2480,8964,6484,5659.584814,1303.691871
W24 3250,W24,3250,616,33069892.24,751,8742,7991,6285.922078,2218.793495
W25 3250,W25,3250,619,33230946.91,1122,8642,7520,6504.654281,2184.391758
W26 3250,W26,3250,621,33338316.69,615,9787,9172,4420.125604,2219.120039
W27 3250,W27,3250,615,33016207.35,2922,8601,5679,7565.209756,1038.537298
W28 3250,W28,3250,618,33177262.02,957,8798,7841,6924.330097,1787.254123
W29 3250,W29,3250,620,33284631.8,1769,9102,7333,7064.879032,1380.647093
W30 3250,W30,3250,617,33123577.13,3105,8740,5635,7179.899514,1039.484095
W31 3250,W31,3250,617,33123577.13,6997,9027,2030,8468.205835,354.9490955
W32 3250,W32,3250,616,33069892.24,4524,9227,4703,8621.175325,618.1496019
W33 3250,W33,3250,615,33016207.35,3464,9110,5646,8196.092683,851.9227185
W34 3250,W34,3250,617,33123577.13,1873,9261,7388,6314.437601,2365.582616
W35 3250,W35,3250,617,33123577.13,2171,8965,6794,7510.531605,1461.638307
W36 3250,W36,3250,617,33123577.13,2411,8960,6549,7700.515397,1380.474029
W37 3250,W37,3250,623,33445686.47,1892,9134,7242,6952.264848,2034.290566
W38 3250,W38,3250,616,33069892.24,7936,8902,966,8557.37987,159.6167443
W39 3250,W39,3250,618,33177262.02,4009,8846,4837,7599.043689,881.9317517
W40 3250,W40,3250,619,33230946.91,2640,8996,6356,7336.638126,1428.462435
W41 3250,W41,3250,623,33445686.47,2995,8815,5820,7734.94703,883.6899375
W42 3250,W42,3250,622,33392001.58,4612,8946,4334,7885.607717,790.319086
W43 3250,W43,3250,623,33445686.47,3375,8963,5588,7198.274478,1051.800474
W44 3250,W44,3250,620,33284631.8,3177,8755,5578,7609.701613,874.9952864
W45 3250,W45,3250,621,33338316.69,1883,8835,6952,6958.487923,1614.667046
W46 3250,W46,3250,617,33123577.13,1918,8687,6769,6974.136143,1615.056731
W47 3250,W47,3250,619,33230946.91,1596,8756,7160,6763.872375,1733.640929
W48 3250,W48,3250,621,33338316.69,7114,8988,1874,7917.449275,305.2494021
W49 3250,W49,3250,619,33230946.91,1596,8729,7133,6284.827141,1981.524599
W50 3250,W50,3250,622,33392001.58,2357,8736,6379,7580.567524,974.2648615
W51 3250,W51,3250,620,33284631.8,5944,8774,2830,7938.520968,499.1695438
W52 3250,W52,3250,622,33392001.58,1594,8758,7164,5366.889068,2039.798438
W53 3250,W53,3250,620,33284631.8,5599,8530,2931,7521.979032,571.2407418
W54 3250,W54,3250,616,33069892.24,1699,8514,6815,5882.574675,2110.917363
W55 3250,W55,3250,617,33123577.13,2025,8972,6947,7425.513776,1861.395619
W56 3250,W56,3250,616,33069892.24,1235,8959,7724,7622.433442,1751.207442
W57 3250,W57,3250,618,33177262.02,1810,9349,7539,5311.063107,2202.64191
W58 3250,W58,3250,618,33177262.02,2001,9352,7351,7317.546926,1710.218003
W59 3250,W59,3250,621,33338316.69,1550,8513,6963,5450.289855,1802.820471
W60 3250,W60,3250,622,33392001.58,3062,8684,5622,7903.245981,785.6480023
W61 3250,W61,3250,618,33177262.02,1976,9115,7139,7772.545307,1098.887333
W62 3250,W62,3250,621,33338316.69,1245,9427,8182,5213.534622,2371.719551
W63 3250,W63,3250,614,32962522.46,720,8707,7987,3593.218241,2154.750668
W64 3250,W64,3250,614,32962522.46,3149,8851,5702,7174.798046,971.53275
W65 3250,W65,3250,618,33177262.02,748,8679,7931,4167.491909,2422.672534
W66 3250,W66,3250,619,33230946.91,135,8517,8382,4297.995153,2307.639847
WB_ E1 3250,WB_ E1,3250,617,33123577.13,171,9272,9101,5102.862237,2604.850852
WB_ E10 3250,WB_ E10,3250,617,33123577.13,823,8450,7627,3904.236629,2023.50598
WB_ E2 3250,WB_ E2,3250,619,33230946.91,3450,8931,5481,7740.778675,634.5366018
WB_ E3 3250,WB_ E3,3250,621,33338316.69,6751,8706,1955,7759.911433,331.2740159
WB_ E4 3250,WB_ E4,3250,618,33177262.02,2286,8948,6662,8143.962783,1083.506548
WB_ E5 3250,WB_ E5,3250,619,33230946.91,130,9272,9142,3775.600969,2522.609952
WB_ E6 3250,WB_ E6,3250,618,33177262.02,3375,8963,5588,7560.898058,724.5412795
WB_ E7 3250,WB_ E7,3250,621,33338316.69,1028,9447,8419,6499.718196,1928.883316
WB_ E8 3250,WB_ E8,3250,623,33445686.47,1680,9074,7394,6529.142857,2326.471913
WB_ E9 3250,WB_ E9,3250,616,33069892.24,854,8769,7915,5346.394481,2585.360358
WB_ H1 3250,WB_ H1,3250,619,33230946.91,1611,8735,7124,7075.479806,1831.550185
WB_ H10 3250,WB_ H10,3250,618,33177262.02,1525,8878,7353,5980.535599,2205.962334
WB_ H2 3250,WB_ H2,3250,618,33177262.02,1905,9009,7104,6779.18123,1805.714198
WB_ H3 3250,WB_ H3,3250,615,33016207.35,1829,9261,7432,6297.196748,2305.354532
WB_ H4 3250,WB_ H4,3250,623,33445686.47,1511,9112,7601,6351.284109,2076.108778
WB_ H5 3250,WB_ H5,3250,621,33338316.69,1510,8662,7152,5091.402576,2322.332901
WB_ H6 3250,WB_ H6,3250,620,33284631.8,425,9540,9115,5283.585484,2651.448424
WB_ H7 3250,WB_ H7,3250,620,33284631.8,-503,9480,9983,4864.003226,2721.21013
WB_ H8 3250,WB_ H8,3250,616,33069892.24,1150,8771,7621,5589.012987,2447.617607
WB_ H9 3250,WB_ H9,3250,620,33284631.8,497,8442,7945,4085.282258,2493.570161
WB_ S1 3250,WB_ S1,3250,614,32962522.46,-283,9365,9648,4270.469055,2981.707675
WB_ S10 3250,WB_ S10,3250,617,33123577.13,720,9427,8707,4670.615883,2482.286902
WB_ S11 3250,WB_ S11,3250,615,33016207.35,748,8679,7931,5042.265041,2579.17874
WB_ S12 3250,WB_ S12,3250,620,33284631.8,904,8363,7459,5181.16129,2021.285622
WB_ S13 3250,WB_ S13,3250,618,33177262.02,1510,8760,7250,4978.352751,2244.610972
WB_ S14 3250,WB_ S14,3250,616,33069892.24,3287,8694,5407,7365.420455,898.3283322
WB_ S15 3250,WB_ S15,3250,616,33069892.24,1918,8687,6769,7058.954545,1583.65719
WB_ S16 3250,WB_ S16,3250,617,33123577.13,751,8760,8009,5388.066451,2484.652843
WB_ S17 3250,WB_ S17,3250,619,33230946.91,3073,8740,5667,7371.717286,1027.162715
WB_ S18 3250,WB_ S18,3250,623,33445686.47,1237,9161,7924,6564.866774,2083.706122
WB_ S19 3250,WB_ S19,3250,623,33445686.47,1894,8850,6956,6552.796148,1968.42259
WB_ S2 3250,WB_ S2,3250,617,33123577.13,-698,9531,10229,4448.752026,3880.628832
WB_ S20 3250,WB_ S20,3250,623,33445686.47,2996,8902,5906,8403.903692,768.5160371
WB_ S21 3250,WB_ S21,3250,617,33123577.13,2961,8856,5895,7394.846029,1144.202719
WB_ S22 3250,WB_ S22,3250,624,33499371.36,6509,8963,2454,7792.083333,400.3267449
WB_ S23 3250,WB_ S23,3250,619,33230946.91,755,9040,8285,6942.757674,1885.866728
WB_ S24 3250,WB_ S24,3250,621,33338316.69,381,9272,8891,3711.405797,2512.460891
WB_ S25 3250,WB_ S25,3250,621,33338316.69,4476,8767,4291,7809.030596,434.4065536
WB_ S26 3250,WB_ S26,3250,619,33230946.91,3670,9227,5557,8379.411955,813.157016
WB_ S27 3250,WB_ S27,3250,624,33499371.36,7354,9091,1737,8471.358974,292.1794419
WB_ S28 3250,WB_ S28,3250,616,33069892.24,6677,9063,2386,8295.449675,417.6741111
WB_ S29 3250,WB_ S29,3250,617,33123577.13,4087,8536,4449,6878.554295,1026.329829
WB_ S3 3250,WB_ S3,3250,616,33069892.24,1212,8688,7476,6061.99513,1900.147681
WB_ S4 3250,WB_ S4,3250,623,33445686.47,929,8874,7945,4885.975923,2242.750061
WB_ S5 3250,WB_ S5,3250,619,33230946.91,1150,8771,7621,5819.528271,2429.282683
WB_ S6 3250,WB_ S6,3250,623,33445686.47,1511,9112,7601,5098.582665,2038.052057
WB_ S7 3250,WB_ S7,3250,619,33230946.91,3331,8677,5346,7773.830372,698.6125336
WB_ S8 3250,WB_ S8,3250,620,33284631.8,2976,9316,6340,7804.119355,957.6048794
WB_ S9 3250,WB_ S9,3250,618,33177262.02,-424,8964,9388,4479.946602,2319.580592
WB_ W1 3250,WB_ W1,3250,614,32962522.46,1572,9040,7468,6166.688925,1885.007
WB_ W10 3250,WB_ W10,3250,619,33230946.91,1613,8851,7238,6092.305331,1561.072747
WB_ W2 3250,WB_ W2,3250,620,33284631.8,1878,8887,7009,7864.685484,959.9373818
WB_ W3 3250,WB_ W3,3250,621,33338316.69,3626,8841,5215,6671.900161,1092.512343
WB_ W4 3250,WB_ W4,3250,622,33392001.58,3702,8642,4940,6166.821543,1462.902184
WB_ W5 3250,WB_ W5,3250,616,33069892.24,4476,8694,4218,7745.787338,559.3707288
WB_ W6 3250,WB_ W6,3250,623,33445686.47,3412,8948,5536,8380.431782,659.0452149
WB_ W7 3250,WB_ W7,3250,614,32962522.46,-714,9431,10145,6408.692182,2698.378452
WB_ W8 3250,WB_ W8,3250,615,33016207.35,3740,8817,5077,7246.97561,882.0560134
WB_ W9 3250,WB_ W9,3250,622,33392001.58,2033,8894,6861,7816.803859,1186.383186
W01 3500,W01,3500,718,38545751.02,395,9102,8707,6910.206128,1790.635618
W02 3500,W02,3500,716,38438381.24,395,8994,8599,7822.917598,1136.342887
W03 3500,W03,3500,713,38277326.57,2002,9063,7061,7515.388499,1440.2371
W04 3500,W04,3500,720,38653120.8,4136,9063,4927,8238.843056,554.5384633
W05 3500,W05,3500,717,38492066.13,1922,8832,6910,7635.642957,1095.64543
W06 3500,W06,3500,717,38492066.13,4009,8887,4878,7951.089261,632.5337443
W07 3500,W07,3500,717,38492066.13,1487,8841,7354,6589.062762,1218.797061
W08 3500,W08,3500,718,38545751.02,1724,8920,7196,6749.442897,1998.541958
W09 3500,W09,3500,719,38599435.91,4480,8920,4440,8193.717663,624.6196503
W10 3500,W10,3500,715,38384696.35,2125,8981,6856,8035.969231,1033.4228
W11 3500,W11,3500,719,38599435.91,863,9040,8177,5995.301808,1921.185798
W12 3500,W12,3500,718,38545751.02,975,8214,7239,5042.424791,1470.91301
W13 3500,W13,3500,722,38760490.58,507,8400,7893,4559.941828,1764.411743
W14 3500,W14,3500,714,38331011.46,1232,8741,7509,7067.92437,1217.377395
W15 3500,W15,3500,719,38599435.91,1973,8780,6807,7054.477051,1484.66159
W16 3500,W16,3500,716,38438381.24,402,8870,8468,7339.022346,1638.51405
W17 3500,W17,3500,717,38492066.13,38,9093,9055,7224.400279,2054.04535
W18 3500,W18,3500,715,38384696.35,927,9316,8389,7789.588811,1155.859163
W19 3500,W19,3500,719,38599435.91,307,9604,9297,6967.253129,2190.806659
W20 3500,W20,3500,722,38760490.58,1771,8508,6737,6919.655125,1404.905914
W21 3500,W21,3500,719,38599435.91,357,9240,8883,6710.243394,2197.324802
W22 3500,W22,3500,722,38760490.58,349,8964,8615,4973.285319,2450.762552
W23 3500,W23,3500,718,38545751.02,1771,8964,7193,5723.653203,1424.204515
W24 3500,W24,3500,717,38492066.13,751,8760,8009,6226.297071,2271.410023
W25 3500,W25,3500,718,38545751.02,1122,8642,7520,6456.820334,2128.016511
W26 3500,W26,3500,715,38384696.35,615,9787,9172,4373.492308,2198.543111
W27 3500,W27,3500,722,38760490.58,2308,8632,6324,7481.239612,1136.694913
W28 3500,W28,3500,716,38438381.24,957,8828,7871,6936.389665,1767.213008
W29 3500,W29,3500,714,38331011.46,1105,9102,7997,7011.109244,1479.38403
W30 3500,W30,3500,719,38599435.91,3105,8740,5635,7244.538248,1033.691198
W31 3500,W31,3500,720,38653120.8,6997,9027,2030,8477.425,352.1911491
W32 3500,W32,3500,720,38653120.8,4524,9227,4703,8620.963889,613.2028496
W33 3500,W33,3500,716,38438381.24,3464,9110,5646,8146.863128,869.9131728
W34 3500,W34,3500,718,38545751.02,1873,9261,7388,6281.901114,2336.56723
W35 3500,W35,3500,719,38599435.91,2171,8965,6794,7479.343533,1461.250063
W36 3500,W36,3500,717,38492066.13,2411,8960,6549,7716.179916,1368.268581
W37 3500,W37,3500,716,38438381.24,1892,9134,7242,6991.205307,2011.696552
W38 3500,W38,3500,718,38545751.02,7908,8902,994,8556.220056,160.8421311
W39 3500,W39,3500,721,38706805.69,4009,8846,4837,7646.768377,882.3748314
W40 3500,W40,3500,717,38492066.13,2170,8996,6826,7300.800558,1490.572129
W41 3500,W41,3500,715,38384696.35,2963,8815,5852,7681.531469,907.4137953
W42 3500,W42,3500,715,38384696.35,2894,8946,6052,7840.556643,907.3646251
W43 3500,W43,3500,717,38492066.13,3375,8963,5588,7225.058577,1033.127479
W44 3500,W44,3500,715,38384696.35,2554,8939,6385,7602.215385,910.6053906
W45 3500,W45,3500,721,38706805.69,1883,8835,6952,6967.26491,1587.197499
W46 3500,W46,3500,717,38492066.13,1918,8687,6769,7027.124128,1588.338363
W47 3500,W47,3500,717,38492066.13,1596,8756,7160,6705.719665,1781.393982
W48 3500,W48,3500,720,38653120.8,7114,8988,1874,7927.873611,320.4048166
W49 3500,W49,3500,722,38760490.58,1596,8729,7133,6278.638504,1981.910129
W50 3500,W50,3500,717,38492066.13,2357,8736,6379,7488.994421,1120.22346
W51 3500,W51,3500,718,38545751.02,4909,8774,3865,7922.111421,526.1049509
W52 3500,W52,3500,714,38331011.46,1589,8758,7169,5481.967787,2061.355328
W53 3500,W53,3500,715,38384696.35,5599,8630,3031,7519.832168,579.2596431
W54 3500,W54,3500,718,38545751.02,1699,8514,6815,5925.36351,2070.757953
W55 3500,W55,3500,721,38706805.69,1966,8972,7006,7284.006935,1951.915408
W56 3500,W56,3500,717,38492066.13,1235,8959,7724,7571.18689,1778.177466
W57 3500,W57,3500,717,38492066.13,1810,9349,7539,5362.504881,2221.97448
W58 3500,W58,3500,722,38760490.58,2001,9352,7351,7164.84072,1858.506918
W59 3500,W59,3500,716,38438381.24,1422,8513,7091,5309.442737,1847.030077
W60 3500,W60,3500,716,38438381.24,2417,8825,6408,7829.568436,927.6769581
W61 3500,W61,3500,717,38492066.13,1976,9115,7139,7748.238494,1149.87534
W62 3500,W62,3500,714,38331011.46,1245,9427,8182,5180.935574,2420.01975
W63 3500,W63,3500,721,38706805.69,697,8707,8010,3571.019417,2123.619169
W64 3500,W64,3500,717,38492066.13,1533,8851,7318,7107.48675,1111.999283
W65 3500,W65,3500,719,38599435.91,748,8679,7931,4054.449235,2389.969798
W66 3500,W66,3500,717,38492066.13,135,8517,8382,4180.030683,2308.074636
WB_ E1 3500,WB_ E1,3500,720,38653120.8,130,9272,9142,5034.0625,2622.215657
WB_ E10 3500,WB_ E10,3500,717,38492066.13,659,8450,7791,3954.41841,2034.765203
WB_ E2 3500,WB_ E2,3500,718,38545751.02,2099,8931,6832,7723.072423,746.6523135
WB_ E3 3500,WB_ E3,3500,717,38492066.13,6181,8706,2525,7746.216179,348.6567199
WB_ E4 3500,WB_ E4,3500,716,38438381.24,2286,8948,6662,8055.128492,1192.706751
WB_ E5 3500,WB_ E5,3500,717,38492066.13,130,9272,9142,3762.317992,2488.603377
WB_ E6 3500,WB_ E6,3500,716,38438381.24,3375,8963,5588,7519.28352,806.6349314
WB_ E7 3500,WB_ E7,3500,715,38384696.35,1028,9447,8419,6469.328671,1960.39525
WB_ E8 3500,WB_ E8,3500,717,38492066.13,1680,9074,7394,6443.832636,2333.970798
WB_ E9 3500,WB_ E9,3500,720,38653120.8,854,8769,7915,5187.988889,2569.474988
WB_ H1 3500,WB_ H1,3500,718,38545751.02,1611,8735,7124,7085.210306,1818.439849
WB_ H10 3500,WB_ H10,3500,720,38653120.8,1525,8878,7353,5927.444444,2176.320519
WB_ H2 3500,WB_ H2,3500,721,38706805.69,1905,9009,7104,6855.499307,1791.392771
WB_ H3 3500,WB_ H3,3500,718,38545751.02,1829,9261,7432,6257.05571,2303.483281
WB_ H4 3500,WB_ H4,3500,716,38438381.24,1511,9112,7601,6400.138268,2038.211162
WB_ H5 3500,WB_ H5,3500,714,38331011.46,1510,8662,7152,5135.623249,2293.691405
WB_ H6 3500,WB_ H6,3500,714,38331011.46,425,9540,9115,5274.022409,2648.729579
WB_ H7 3500,WB_ H7,3500,714,38331011.46,-503,9480,9983,5093.190476,2716.028931
WB_ H8 3500,WB_ H8,3500,719,38599435.91,1150,8771,7621,5758.207232,2427.644908
WB_ H9 3500,WB_ H9,3500,713,38277326.57,381,8442,8061,4197.086957,2511.847046
WB_ S1 3500,WB_ S1,3500,718,38545751.02,-283,9431,9714,4189.296657,2961.390778
WB_ S10 3500,WB_ S10,3500,718,38545751.02,720,9427,8707,4580.82312,2482.509527
WB_ S11 3500,WB_ S11,3500,720,38653120.8,748,8679,7931,5123.245833,2585.036146
WB_ S12 3500,WB_ S12,3500,720,38653120.8,904,8450,7546,5112.825,2023.265687
WB_ S13 3500,WB_ S13,3500,720,38653120.8,1510,8865,7355,5085.372222,2316.909881
WB_ S14 3500,WB_ S14,3500,720,38653120.8,2844,8694,5850,7289.794444,972.8079015
WB_ S15 3500,WB_ S15,3500,719,38599435.91,1918,8687,6769,7086.877608,1568.459468
WB_ S16 3500,WB_ S16,3500,722,38760490.58,751,8760,8009,5488.836565,2475.65523
WB_ S17 3500,WB_ S17,3500,715,38384696.35,3073,8740,5667,7415.953846,1004.614553
WB_ S18 3500,WB_ S18,3500,715,38384696.35,1237,9191,7954,6644.925874,2108.111154
WB_ S19 3500,WB_ S19,3500,716,38438381.24,1894,8883,6989,6611.701117,1974.489091
WB_ S2 3500,WB_ S2,3500,721,38706805.69,-698,9531,10229,4441.29681,3892.341346
WB_ S20 3500,WB_ S20,3500,714,38331011.46,2996,8902,5906,8332.64986,920.9602059
WB_ S21 3500,WB_ S21,3500,719,38599435.91,2961,8856,5895,7400.346314,1125.003562
WB_ S22 3500,WB_ S22,3500,716,38438381.24,5224,8963,3739,7771.297486,427.3098774
WB_ S23 3500,WB_ S23,3500,715,38384696.35,755,9040,8285,6917.135664,1887.955344
WB_ S24 3500,WB_ S24,3500,714,38331011.46,381,9272,8891,3876.687675,2526.947985
WB_ S25 3500,WB_ S25,3500,715,38384696.35,3536,8767,5231,7766.962238,519.776999
WB_ S26 3500,WB_ S26,3500,716,38438381.24,3670,9227,5557,8372.459497,814.7515368
WB_ S27 3500,WB_ S27,3500,718,38545751.02,6978,9091,2113,8475.969359,299.0745739
WB_ S28 3500,WB_ S28,3500,718,38545751.02,5199,9063,3864,8264.896936,452.7223232
WB_ S29 3500,WB_ S29,3500,717,38492066.13,4087,8686,4599,6928.566248,1042.189978
WB_ S3 3500,WB_ S3,3500,719,38599435.91,1175,8688,7513,5997.445063,1988.595844
WB_ S4 3500,WB_ S4,3500,715,38384696.35,929,8881,7952,4833.071329,2280.92927
WB_ S5 3500,WB_ S5,3500,719,38599435.91,1150,8771,7621,5884.944367,2399.358302
WB_ S6 3500,WB_ S6,3500,716,38438381.24,1511,9112,7601,5243.372905,2075.470949
WB_ S7 3500,WB_ S7,3500,720,38653120.8,2634,8677,6043,7719.702778,825.9900124
WB_ S8 3500,WB_ S8,3500,714,38331011.46,2861,9316,6455,7719.745098,1101.40138
WB_ S9 3500,WB_ S9,3500,718,38545751.02,-424,8964,9388,4533.238162,2305.009953
WB_ W1 3500,WB_ W1,3500,718,38545751.02,863,9040,8177,6025.805014,1954.250252
WB_ W10 3500,WB_ W10,3500,716,38438381.24,1017,8851,7834,6058.621508,1688.009078
WB_ W2 3500,WB_ W2,3500,717,38492066.13,1249,8906,7657,7818.93166,1041.994762
WB_ W3 3500,WB_ W3,3500,715,38384696.35,3626,8841,5215,6722.626573,1086.501384
WB_ W4 3500,WB_ W4,3500,717,38492066.13,3702,8642,4940,6238.871688,1472.691111
WB_ W5 3500,WB_ W5,3500,719,38599435.91,4057,8694,4637,7726.645341,608.3762133
WB_ W6 3500,WB_ W6,3500,715,38384696.35,3412,8948,5536,8317.303497,766.3387309
WB_ W7 3500,WB_ W7,3500,721,38706805.69,-714,9431,10145,6261.468793,2768.372852
WB_ W8 3500,WB_ W8,3500,720,38653120.8,3525,8817,5292,7290.145833,896.9284993
WB_ W9 3500,WB_ W9,3500,715,38384696.35,2033,8894,6861,7775.005594,1235.31682
W01 3750,W01,3750,821,44075294.69,395,9102,8707,6937.193666,1808.921125
W02 3750,W02,3750,821,44075294.69,395,8994,8599,7780.338611,1179.054716
W03 3750,W03,3750,823,44182664.47,988,9063,8075,7424.837181,1580.353849
W04 3750,W04,3750,818,43914240.02,3394,9063,5669,8195.531785,606.5124699
W05 3750,W05,3750,820,44021609.8,1535,8832,7297,7538.764634,1220.885243
W06 3750,W06,3750,823,44182664.47,2178,8906,6728,7917.432564,787.4077793
W07 3750,W07,3750,827,44397404.03,1137,8841,7704,6583.888755,1326.95694
W08 3750,W08,3750,822,44128979.58,1724,8920,7196,6883.76399,1938.380904
W09 3750,W09,3750,822,44128979.58,4480,8920,4440,8147.783455,662.1031791
W10 3750,W10,3750,821,44075294.69,2125,8981,6856,7950.366626,1135.106871
W11 3750,W11,3750,822,44128979.58,863,9040,8177,5848.997567,2000.486157
W12 3750,W12,3750,828,44451088.92,960,8222,7262,5099.65942,1528.339561
W13 3750,W13,3750,818,43914240.02,381,8400,8019,4642.308068,1790.190683
W14 3750,W14,3750,826,44343719.14,1083,8741,7658,6948.439467,1412.215968
W15 3750,W15,3750,823,44182664.47,1973,8780,6807,7059.701094,1503.060294
W16 3750,W16,3750,822,44128979.58,402,8870,8468,7224.380779,1768.5072
W17 3750,W17,3750,824,44236349.36,38,9093,9055,7101.216019,2142.416481
W18 3750,W18,3750,824,44236349.36,927,9316,8389,7708.537621,1282.279984
W19 3750,W19,3750,821,44075294.69,307,9604,9297,6889.499391,2264.574752
W20 3750,W20,3750,821,44075294.69,696,8581,7885,6810.399513,1591.27306
W21 3750,W21,3750,827,44397404.03,357,9240,8883,6736.018138,2184.095535
W22 3750,W22,3750,817,43860555.13,349,8964,8615,4955.090575,2427.969459
W23 3750,W23,3750,825,44290034.25,977,8964,7987,5748.962424,1533.739278
W24 3750,W24,3750,822,44128979.58,751,8931,8180,6224.243309,2275.103479
W25 3750,W25,3750,821,44075294.69,1122,8798,7676,6476.830694,2060.135881
W26 3750,W26,3750,825,44290034.25,615,9787,9172,4312.881212,2183.109308
W27 3750,W27,3750,822,44128979.58,1736,8642,6906,7401.980535,1254.420114
W28 3750,W28,3750,827,44397404.03,957,9102,8145,6939.547763,1766.700029
W29 3750,W29,3750,826,44343719.14,1105,9102,7997,6921.381356,1602.967278
W30 3750,W30,3750,824,44236349.36,3073,8817,5744,7293.532767,1040.524997
W31 3750,W31,3750,821,44075294.69,6856,9027,2171,8483.695493,351.5359614
W32 3750,W32,3750,822,44128979.58,4524,9227,4703,8602.725061,617.9224924
W33 3750,W33,3750,824,44236349.36,3464,9110,5646,8080.462379,935.1890799
W34 3750,W34,3750,825,44290034.25,1873,9261,7388,6275.064242,2293.550094
W35 3750,W35,3750,822,44128979.58,2171,8965,6794,7446.192214,1474.446119
W36 3750,W36,3750,825,44290034.25,2411,8960,6549,7708.415758,1381.49668
W37 3750,W37,3750,825,44290034.25,1892,9134,7242,7025.989091,1978.210295
W38 3750,W38,3750,826,44343719.14,7673,8902,1229,8550.847458,172.0968348
W39 3750,W39,3750,822,44128979.58,2961,8846,5885,7687.126521,897.5684
W40 3750,W40,3750,821,44075294.69,2170,8996,6826,7281.764921,1548.835958
W41 3750,W41,3750,826,44343719.14,2963,8815,5852,7606.530266,952.2160516
W42 3750,W42,3750,823,44182664.47,2894,8946,6052,7801.914945,1000.964112
W43 3750,W43,3750,825,44290034.25,3375,8963,5588,7254.581818,1022.082798
W44 3750,W44,3750,829,44504773.81,2450,8939,6489,7597.834741,973.2989159
W45 3750,W45,3750,827,44397404.03,1683,8835,7152,6934.286578,1600.574774
W46 3750,W46,3750,822,44128979.58,1913,8687,6774,7043.716545,1584.95966
W47 3750,W47,3750,826,44343719.14,1596,8756,7160,6667.361985,1842.739976
W48 3750,W48,3750,827,44397404.03,6867,9198,2331,7938.978235,341.5549683
W49 3750,W49,3750,822,44128979.58,1596,8729,7133,6272.844282,1977.88447
W50 3750,W50,3750,826,44343719.14,2092,8736,6644,7394.974576,1265.219154
W51 3750,W51,3750,827,44397404.03,4909,8774,3865,7885.380895,594.275437
W52 3750,W52,3750,827,44397404.03,1589,8758,7169,5605.62757,2078.035519
W53 3750,W53,3750,828,44451088.92,3868,8684,4816,7493.259662,634.4929669
W54 3750,W54,3750,825,44290034.25,1699,8514,6815,5993.94303,2022.983618
W55 3750,W55,3750,818,43914240.02,1928,8972,7044,7188.041565,2011.084933
W56 3750,W56,3750,823,44182664.47,1235,8959,7724,7478.012151,1831.490794
W57 3750,W57,3750,822,44128979.58,1810,9349,7539,5393.79562,2240.816278
W58 3750,W58,3750,817,43860555.13,2001,9352,7351,7053.634027,1948.175052
W59 3750,W59,3750,825,44290034.25,1360,8761,7401,5222.287273,1920.07726
W60 3750,W60,3750,825,44290034.25,1198,8826,7628,7743.426667,1138.454369
W61 3750,W61,3750,822,44128979.58,1976,9115,7139,7710.761557,1216.107644
W62 3750,W62,3750,826,44343719.14,1245,9427,8182,5145.447942,2468.150043
W63 3750,W63,3750,825,44290034.25,697,8707,8010,3541.644848,2099.731008
W64 3750,W64,3750,824,44236349.36,1533,8851,7318,7026.743932,1221.537887
W65 3750,W65,3750,821,44075294.69,748,8679,7931,4028.667479,2380.265135
W66 3750,W66,3750,820,44021609.8,135,8517,8382,4083.123171,2298.572466
WB_ E1 3750,WB_ E1,3750,821,44075294.69,130,9272,9142,4946.339829,2622.381048
WB_ E10 3750,WB_ E10,3750,825,44290034.25,659,8450,7791,4013.625455,2058.351702
WB_ E2 3750,WB_ E2,3750,826,44343719.14,1945,8931,6986,7692.309927,845.9149313
WB_ E3 3750,WB_ E3,3750,820,44021609.8,5737,8706,2969,7750.652439,378.2224535
WB_ E4 3750,WB_ E4,3750,827,44397404.03,2286,8948,6662,7979.685611,1289.446052
WB_ E5 3750,WB_ E5,3750,821,44075294.69,130,9272,9142,3803.842875,2474.538873
WB_ E6 3750,WB_ E6,3750,828,44451088.92,3375,8963,5588,7482,879.0425113
WB_ E7 3750,WB_ E7,3750,825,44290034.25,850,9447,8597,6396.206061,2024.037964
WB_ E8 3750,WB_ E8,3750,826,44343719.14,1680,9074,7394,6432.694915,2300.322695
WB_ E9 3750,WB_ E9,3750,820,44021609.8,854,8769,7915,5048.297561,2556.069448
WB_ H1 3750,WB_ H1,3750,827,44397404.03,1611,8735,7124,7073.097944,1804.716883
WB_ H10 3750,WB_ H10,3750,827,44397404.03,1525,8878,7353,5819.856106,2161.44814
WB_ H2 3750,WB_ H2,3750,820,44021609.8,1905,9009,7104,6924.797561,1770.199711
WB_ H3 3750,WB_ H3,3750,823,44182664.47,1829,9261,7432,6225.506683,2291.27626
WB_ H4 3750,WB_ H4,3750,827,44397404.03,1511,9112,7601,6414.712213,2012.979043
WB_ H5 3750,WB_ H5,3750,827,44397404.03,1510,8662,7152,5196.440145,2262.983688
WB_ H6 3750,WB_ H6,3750,826,44343719.14,425,9551,9126,5323.292978,2664.275705
WB_ H7 3750,WB_ H7,3750,820,44021609.8,-503,9480,9983,5360.695122,2717.788847
WB_ H8 3750,WB_ H8,3750,822,44128979.58,1142,8771,7629,5900.239659,2400.389075
WB_ H9 3750,WB_ H9,3750,824,44236349.36,381,8720,8339,4293.322816,2549.309453
WB_ S1 3750,WB_ S1,3750,824,44236349.36,-283,9431,9714,4164.800971,2904.547789
WB_ S10 3750,WB_ S10,3750,823,44182664.47,615,9427,8812,4498.46294,2467.809038
WB_ S11 3750,WB_ S11,3750,823,44182664.47,748,8679,7931,5188.320778,2583.74185
WB_ S12 3750,WB_ S12,3750,822,44128979.58,840,8513,7673,5068.940389,2017.513191
WB_ S13 3750,WB_ S13,3750,821,44075294.69,1510,8865,7355,5210.794153,2381.419533
WB_ S14 3750,WB_ S14,3750,820,44021609.8,2844,8694,5850,7239.537805,1041.825511
WB_ S15 3750,WB_ S15,3750,826,44343719.14,1918,8687,6769,7112.492736,1564.4386
WB_ S16 3750,WB_ S16,3750,821,44075294.69,751,8798,8047,5588.16078,2452.847674
WB_ S17 3750,WB_ S17,3750,822,44128979.58,3073,8740,5667,7453.40146,996.4617364
WB_ S18 3750,WB_ S18,3750,826,44343719.14,1021,9191,8170,6716.98063,2149.40964
WB_ S19 3750,WB_ S19,3750,825,44290034.25,1894,8883,6989,6696.665455,1972.552401
WB_ S2 3750,WB_ S2,3750,818,43914240.02,-698,9531,10229,4392.803178,3890.087768
WB_ S20 3750,WB_ S20,3750,824,44236349.36,2996,8902,5906,8279.457524,995.5228053
WB_ S21 3750,WB_ S21,3750,822,44128979.58,2961,8939,5978,7391.822384,1128.617117
WB_ S22 3750,WB_ S22,3750,826,44343719.14,5082,8963,3881,7756.299031,467.1846817
WB_ S23 3750,WB_ S23,3750,821,44075294.69,755,9040,8285,6903.74665,1872.370494
WB_ S24 3750,WB_ S24,3750,827,44397404.03,381,9272,8891,4044.458283,2518.024911
WB_ S25 3750,WB_ S25,3750,824,44236349.36,2353,8767,6414,7684.339806,724.4113972
WB_ S26 3750,WB_ S26,3750,820,44021609.8,3670,9227,5557,8356.859756,817.4256145
WB_ S27 3750,WB_ S27,3750,826,44343719.14,6863,9091,2228,8479.381356,307.8808433
WB_ S28 3750,WB_ S28,3750,822,44128979.58,5199,9063,3864,8219.215328,509.600164
WB_ S29 3750,WB_ S29,3750,822,44128979.58,3445,8686,5241,6955.051095,1063.111358
WB_ S3 3750,WB_ S3,3750,822,44128979.58,1175,8688,7513,5948.756691,2050.771391
WB_ S4 3750,WB_ S4,3750,827,44397404.03,723,8986,8263,4804.741233,2330.548022
WB_ S5 3750,WB_ S5,3750,824,44236349.36,1150,8771,7621,5959.512136,2368.242411
WB_ S6 3750,WB_ S6,3750,825,44290034.25,1511,9112,7601,5391.826667,2096.760808
WB_ S7 3750,WB_ S7,3750,826,44343719.14,1763,8677,6914,7674.133172,934.4512648
WB_ S8 3750,WB_ S8,3750,827,44397404.03,927,9604,8677,7586.893591,1348.901485
WB_ S9 3750,WB_ S9,3750,821,44075294.69,-424,8964,9388,4501.373934,2291.997342
WB_ W1 3750,WB_ W1,3750,825,44290034.25,863,9040,8177,5868.018182,2040.602668
WB_ W10 3750,WB_ W10,3750,827,44397404.03,1017,8851,7834,6032.281741,1797.940398
WB_ W2 3750,WB_ W2,3750,821,44075294.69,1249,8906,7657,7761.618758,1103.320299
WB_ W3 3750,WB_ W3,3750,827,44397404.03,3626,8841,5215,6764.415961,1086.877333
WB_ W4 3750,WB_ W4,3750,825,44290034.25,3293,8642,5349,6308.621818,1491.620561
WB_ W5 3750,WB_ W5,3750,820,44021609.8,4057,8694,4637,7711.62561,649.7604287
WB_ W6 3750,WB_ W6,3750,826,44343719.14,2400,8948,6548,8233.358354,912.2610576
WB_ W7 3750,WB_ W7,3750,823,44182664.47,-714,9431,10145,6089.609964,2834.541186
WB_ W8 3750,WB_ W8,3750,825,44290034.25,3525,8817,5292,7310.238788,904.7712599
WB_ W9 3750,WB_ W9,3750,825,44290034.25,2033,8894,6861,7703.946667,1326.005447
W01 4000,W01,4000,939,50410111.71,395,9102,8707,6970.963791,1828.508869
W02 4000,W02,4000,934,50141687.26,395,8994,8599,7750.273019,1215.038429
W03 4000,W03,4000,935,50195372.15,863,9063,8200,7335.807487,1695.217773
W04 4000,W04,4000,935,50195372.15,3394,9063,5669,8154.515508,640.5939453
W05 4000,W05,4000,936,50249057.04,1249,8832,7583,7438.544872,1355.631294
W06 4000,W06,4000,940,50463796.6,1060,8906,7846,7873.405319,971.7723163
W07 4000,W07,4000,935,50195372.15,988,8841,7853,6552.142246,1436.783201
W08 4000,W08,4000,939,50410111.71,1724,8920,7196,7017.772098,1878.987922
W09 4000,W09,4000,941,50517481.49,4480,8920,4440,8088.754516,704.6656794
W10 4000,W10,4000,934,50141687.26,1763,8981,7218,7855.957173,1270.970458
W11 4000,W11,4000,941,50517481.49,785,9040,8255,5687.187035,2067.849953
W12 4000,W12,4000,935,50195372.15,960,8290,7330,5151.791444,1595.372844
W13 4000,W13,4000,935,50195372.15,381,8414,8033,4745.256684,1811.994664
W14 4000,W14,4000,935,50195372.15,729,8878,8149,6842.477005,1584.445847
W15 4000,W15,4000,942,50571166.38,1843,8780,6937,7054.569002,1515.12847
W16 4000,W16,4000,939,50410111.71,163,8901,8738,7165.031949,1827.444538
W17 4000,W17,4000,936,50249057.04,38,9093,9055,7014.818376,2198.447919
W18 4000,W18,4000,934,50141687.26,927,9316,8389,7623.46788,1418.926141
W19 4000,W19,4000,933,50088002.37,227,9749,9522,6815.677385,2311.308762
W20 4000,W20,4000,938,50356426.82,589,8581,7992,6716.696162,1739.264456
W21 4000,W21,4000,935,50195372.15,357,9240,8883,6737.195722,2172.688478
W22 4000,W22,4000,936,50249057.04,210,8964,8754,4923.332265,2401.641872
W23 4000,W23,4000,938,50356426.82,977,8964,7987,5782.211087,1598.196483
W24 4000,W24,4000,940,50463796.6,751,8931,8180,6218.908511,2279.001548
W25 4000,W25,4000,935,50195372.15,1122,8798,7676,6519.403209,1986.921313
W26 4000,W26,4000,935,50195372.15,453,9787,9334,4314.439572,2200.75872
W27 4000,W27,4000,940,50463796.6,1553,8642,7089,7319.558511,1339.8395
W28 4000,W28,4000,933,50088002.37,957,9102,8145,6919.659164,1791.077767
W29 4000,W29,4000,934,50141687.26,1017,9102,8085,6859.373662,1653.826793
W30 4000,W30,4000,940,50463796.6,3073,8817,5744,7349.348936,1021.446618
W31 4000,W31,4000,932,50034317.48,6856,9027,2171,8487.945279,356.3670893
W32 4000,W32,4000,939,50410111.71,4457,9227,4770,8567.399361,661.7850689
W33 4000,W33,4000,938,50356426.82,2947,9110,6163,8006.49467,1030.389686
W34 4000,W34,4000,943,50624851.27,1873,9261,7388,6305.911983,2244.489364
W35 4000,W35,4000,941,50517481.49,2171,8965,6794,7430.901169,1489.537972
W36 4000,W36,4000,943,50624851.27,2411,8960,6549,7705.045599,1368.861343
W37 4000,W37,4000,936,50249057.04,1892,9134,7242,7082.695513,1931.16779
W38 4000,W38,4000,943,50624851.27,7612,8902,1290,8548.300106,179.4012726
W39 4000,W39,4000,939,50410111.71,2961,8846,5885,7727.631523,889.8113024
W40 4000,W40,4000,934,50141687.26,2170,8996,6826,7262.449679,1587.767051
W41 4000,W41,4000,935,50195372.15,2963,8815,5852,7529.185027,1008.452494
W42 4000,W42,4000,935,50195372.15,2640,8996,6356,7741.522995,1090.909341
W43 4000,W43,4000,937,50302741.93,3375,8963,5588,7284.039488,1000.864295
W44 4000,W44,4000,938,50356426.82,2450,8939,6489,7574.604478,1044.393463
W45 4000,W45,4000,938,50356426.82,1683,8835,7152,6913.378465,1591.823953
W46 4000,W46,4000,941,50517481.49,1913,8878,6965,7029.819341,1612.375707
W47 4000,W47,4000,936,50249057.04,1596,8839,7243,6665.553419,1854.963646
W48 4000,W48,4000,936,50249057.04,6867,9269,2402,7951.112179,364.0370291
W49 4000,W49,4000,938,50356426.82,1596,8729,7133,6261.109808,1975.576411
W50 4000,W50,4000,935,50195372.15,1537,8736,7199,7357.085561,1343.938617
W51 4000,W51,4000,937,50302741.93,3140,8774,5634,7824.044824,715.2864149
W52 4000,W52,4000,936,50249057.04,1589,8758,7169,5740.439103,2080.928597
W53 4000,W53,4000,936,50249057.04,3521,8751,5230,7476.553419,731.7011084
W54 4000,W54,4000,944,50678536.16,1699,8514,6815,6060.314619,1974.732447
W55 4000,W55,4000,936,50249057.04,1894,8972,7078,7115.657051,2011.368027
W56 4000,W56,4000,940,50463796.6,1235,8959,7724,7340.680851,1927.545426
W57 4000,W57,4000,936,50249057.04,1518,9349,7831,5415.448718,2251.971444
W58 4000,W58,4000,936,50249057.04,1353,9352,7999,6939.885684,2022.469231
W59 4000,W59,4000,937,50302741.93,1209,8931,7722,5120.273212,1994.950724
W60 4000,W60,4000,936,50249057.04,1130,8826,7696,7653.55235,1304.469176
W61 4000,W61,4000,935,50195372.15,1497,9115,7618,7648.946524,1322.749885
W62 4000,W62,4000,936,50249057.04,715,9427,8712,5121.717949,2508.839319
W63 4000,W63,4000,941,50517481.49,607,8707,8100,3492.840595,2072.131966
W64 4000,W64,4000,943,50624851.27,1533,9043,7510,6887.748674,1426.604097
W65 4000,W65,4000,935,50195372.15,748,8679,7931,4044.794652,2375.751377
W66 4000,W66,4000,937,50302741.93,135,8517,8382,3977.090715,2300.059498
WB_ E1 4000,WB_ E1,4000,932,50034317.48,130,9272,9142,4775.332618,2634.935535
WB_ E10 4000,WB_ E10,4000,937,50302741.93,659,8450,7791,4040.450374,2061.076539
WB_ E2 4000,WB_ E2,4000,938,50356426.82,1534,8931,7397,7643.33049,953.104541
WB_ E3 4000,WB_ E3,4000,936,50249057.04,5727,8706,2979,7753.121795,402.1799254
WB_ E4 4000,WB_ E4,4000,935,50195372.15,2281,8948,6667,7950.458824,1334.305977
WB_ E5 4000,WB_ E5,4000,936,50249057.04,130,9272,9142,3851.225427,2487.861152
WB_ E6 4000,WB_ E6,4000,937,50302741.93,3375,8963,5588,7469.319104,891.5708043
WB_ E7 4000,WB_ E7,4000,935,50195372.15,730,9787,9057,6327.042781,2085.328369
WB_ E8 4000,WB_ E8,4000,935,50195372.15,1680,9074,7394,6416.282353,2284.641866
WB_ E9 4000,WB_ E9,4000,936,50249057.04,854,8769,7915,4987.146368,2535.691248
WB_ H1 4000,WB_ H1,4000,944,50678536.16,1611,8749,7138,7096.229873,1786.286582
WB_ H10 4000,WB_ H10,4000,939,50410111.71,1525,8878,7353,5736.244941,2160.971856
WB_ H2 4000,WB_ H2,4000,936,50249057.04,1905,9009,7104,7017.854701,1736.889064
WB_ H3 4000,WB_ H3,4000,942,50571166.38,1829,9261,7432,6185.68896,2264.399826
WB_ H4 4000,WB_ H4,4000,936,50249057.04,1511,9112,7601,6431.776709,1969.935857
WB_ H5 4000,WB_ H5,4000,938,50356426.82,1510,8662,7152,5252.073561,2233.565062
WB_ H6 4000,WB_ H6,4000,933,50088002.37,117,9551,9434,5383.021436,2680.015382
WB_ H7 4000,WB_ H7,4000,933,50088002.37,-503,9548,10051,5617.007503,2706.069214
WB_ H8 4000,WB_ H8,4000,942,50571166.38,1142,8771,7629,6024.5,2350.858576
WB_ H9 4000,WB_ H9,4000,936,50249057.04,381,8839,8458,4400.814103,2574.401101
WB_ S1 4000,WB_ S1,4000,941,50517481.49,-283,9431,9714,4219.634431,2858.19965
WB_ S10 4000,WB_ S10,4000,943,50624851.27,615,9427,8812,4429.183457,2427.75784
WB_ S11 4000,WB_ S11,4000,941,50517481.49,748,8679,7931,5258.059511,2563.639212
WB_ S12 4000,WB_ S12,4000,937,50302741.93,802,8554,7752,5022.309498,2020.501431
WB_ S13 4000,WB_ S13,4000,936,50249057.04,1510,8865,7355,5297.616453,2432.176753
WB_ S14 4000,WB_ S14,4000,936,50249057.04,2796,8694,5898,7201.78953,1113.664903
WB_ S15 4000,WB_ S15,4000,943,50624851.27,1913,8878,6965,7121.180276,1566.630593
WB_ S16 4000,WB_ S16,4000,933,50088002.37,751,8798,8047,5673.05895,2425.07543
WB_ S17 4000,WB_ S17,4000,933,50088002.37,3073,8740,5667,7488.12433,996.6868177
WB_ S18 4000,WB_ S18,4000,935,50195372.15,896,9191,8295,6751.313369,2187.786662
WB_ S19 4000,WB_ S19,4000,937,50302741.93,1894,8883,6989,6764.967983,1944.105158
WB_ S2 4000,WB_ S2,4000,937,50302741.93,-698,9531,10229,4365.922092,3859.187164
WB_ S20 4000,WB_ S20,4000,937,50302741.93,2996,8902,5906,8231.55603,1060.65939
WB_ S21 4000,WB_ S21,4000,941,50517481.49,2961,8939,5978,7372.822529,1156.117898
WB_ S22 4000,WB_ S22,4000,939,50410111.71,4677,8963,4286,7737.796592,518.8484424
WB_ S23 4000,WB_ S23,4000,934,50141687.26,755,9040,8285,6918.396146,1824.049682
WB_ S24 4000,WB_ S24,4000,936,50249057.04,381,9272,8891,4133.877137,2521.533158
WB_ S25 4000,WB_ S25,4000,935,50195372.15,2089,8767,6678,7584.88877,944.685407
WB_ S26 4000,WB_ S26,4000,934,50141687.26,2002,9227,7225,8318.019272,888.4532632
WB_ S27 4000,WB_ S27,4000,936,50249057.04,6745,9091,2346,8468.115385,340.3954204
WB_ S28 4000,WB_ S28,4000,940,50463796.6,5199,9063,3864,8173.773404,553.7504476
WB_ S29 4000,WB_ S29,4000,940,50463796.6,3445,8701,5256,6975.734043,1084.89374
WB_ S3 4000,WB_ S3,4000,941,50517481.49,604,8688,8084,5890.010627,2114.96393
WB_ S4 4000,WB_ S4,4000,938,50356426.82,723,8986,8263,4766.275053,2361.086959
WB_ S5 4000,WB_ S5,4000,937,50302741.93,1150,8771,7621,5983.64461,2354.250842
WB_ S6 4000,WB_ S6,4000,936,50249057.04,1511,9112,7601,5503.221154,2108.504238
WB_ S7 4000,WB_ S7,4000,937,50302741.93,1537,8680,7143,7623.872999,1056.978312
WB_ S8 4000,WB_ S8,4000,935,50195372.15,927,9604,8677,7528.058824,1460.765781
WB_ S9 4000,WB_ S9,4000,935,50195372.15,-424,8964,9388,4495.988235,2280.722608
WB_ W1 4000,WB_ W1,4000,943,50624851.27,863,9040,8177,5714.908802,2099.673166
WB_ W10 4000,WB_ W10,4000,934,50141687.26,1017,8851,7834,6018.638116,1895.434947
WB_ W2 4000,WB_ W2,4000,930,49926947.7,1249,8906,7657,7720.373118,1133.07865
WB_ W3 4000,WB_ W3,4000,935,50195372.15,3626,8841,5215,6779.847059,1085.390347
WB_ W4 4000,WB_ W4,4000,934,50141687.26,3293,8642,5349,6353.052463,1504.301536
WB_ W5 4000,WB_ W5,4000,936,50249057.04,3525,8767,5242,7687.382479,690.4845576
WB_ W6 4000,WB_ W6,4000,936,50249057.04,2286,8948,6662,8169.78953,1013.457562
WB_ W7 4000,WB_ W7,4000,939,50410111.71,-714,9431,10145,5963.054313,2884.511045
WB_ W8 4000,WB_ W8,4000,937,50302741.93,3380,8817,5437,7326.6254,903.2127428
WB_ W9 4000,WB_ W9,4000,936,50249057.04,2033,8894,6861,7648.379274,1398.367977
W01 4250,W01,4250,1061,56959668.29,395,9102,8707,7020.557964,1827.329718
W02 4250,W02,4250,1057,56744928.73,395,9063,8668,7698.556291,1258.996969
W03 4250,W03,4250,1059,56852298.51,863,9063,8200,7257.028329,1780.513574
W04 4250,W04,4250,1050,56369134.5,2770,9063,6293,8118.773333,670.6864941
W05 4250,W05,4250,1061,56959668.29,1249,8887,7638,7361.517436,1450.515385
W06 4250,W06,4250,1061,56959668.29,1060,8906,7846,7825.219604,1032.055037
W07 4250,W07,4250,1061,56959668.29,863,8841,7978,6533.031103,1497.479093
W08 4250,W08,4250,1061,56959668.29,1724,8920,7196,7128.557964,1818.324955
W09 4250,W09,4250,1061,56959668.29,3278,8920,5642,7994.588124,808.2770455
W10 4250,W10,4250,1056,56691243.84,1763,8981,7218,7766.023674,1394.390632
W11 4250,W11,4250,1063,57067038.07,755,9040,8285,5579.073377,2085.540275
W12 4250,W12,4250,1060,56905983.4,595,8717,8122,5194.281132,1712.787783
W13 4250,W13,4250,1051,56422819.39,381,8414,8033,4850.627022,1831.025886
W14 4250,W14,4250,1060,56905983.4,726,8878,8152,6750.214151,1703.018949
W15 4250,W15,4250,1059,56852298.51,1843,8780,6937,7009.009443,1558.285996
W16 4250,W16,4250,1060,56905983.4,163,8998,8835,7106.371698,1882.224447
W17 4250,W17,4250,1057,56744928.73,38,9093,9055,6955.522233,2234.460409
W18 4250,W18,4250,1059,56852298.51,927,9316,8389,7550.811143,1512.599273
W19 4250,W19,4250,1052,56476504.28,210,9749,9539,6740.421103,2363.092257
W20 4250,W20,4250,1052,56476504.28,589,8581,7992,6655.170152,1834.993966
W21 4250,W21,4250,1060,56905983.4,357,9240,8883,6718.34434,2197.199665
W22 4250,W22,4250,1050,56369134.5,210,8964,8754,4888.215238,2374.304879
W23 4250,W23,4250,1063,57067038.07,977,8964,7987,5816.388523,1654.973255
W24 4250,W24,4250,1060,56905983.4,751,8931,8180,6213.665094,2290.710476
W25 4250,W25,4250,1053,56530189.17,1122,8798,7676,6565.475783,1934.737831
W26 4250,W26,4250,1058,56798613.62,453,9787,9334,4336.297732,2224.089539
W27 4250,W27,4250,1063,57067038.07,1553,8642,7089,7248.878645,1383.309765
W28 4250,W28,4250,1060,56905983.4,957,9102,8145,6870.200943,1834.128701
W29 4250,W29,4250,1058,56798613.62,1017,9102,8085,6765.206049,1741.369409
W30 4250,W30,4250,1061,56959668.29,3073,8817,5744,7391.257304,996.7800775
W31 4250,W31,4250,1051,56422819.39,6856,9027,2171,8496.560419,348.3750602
W32 4250,W32,4250,1063,57067038.07,4384,9227,4843,8522.121355,695.9974179
W33 4250,W33,4250,1061,56959668.29,2708,9115,6407,7943.664467,1105.785887
W34 4250,W34,4250,1059,56852298.51,1873,9261,7388,6353.417375,2198.113119
W35 4250,W35,4250,1063,57067038.07,2171,8965,6794,7425.980245,1503.07948
W36 4250,W36,4250,1060,56905983.4,2411,8960,6549,7680.666038,1370.700898
W37 4250,W37,4250,1057,56744928.73,1892,9134,7242,7128.136235,1888.257309
W38 4250,W38,4250,1061,56959668.29,6896,8902,2006,8542.367578,202.2912269
W39 4250,W39,4250,1055,56637558.95,2961,8846,5885,7753.859716,898.1808013
W40 4250,W40,4250,1059,56852298.51,2106,8996,6890,7255.929178,1589.653262
W41 4250,W41,4250,1058,56798613.62,2963,8815,5852,7440.520794,1074.194279
W42 4250,W42,4250,1056,56691243.84,2640,8996,6356,7714.623106,1138.156861
W43 4250,W43,4250,1057,56744928.73,3375,8963,5588,7318.44087,963.3016617
W44 4250,W44,4250,1059,56852298.51,2006,8939,6933,7499.381492,1162.541274
W45 4250,W45,4250,1064,57120722.96,1683,8835,7152,6896.156955,1597.420387
W46 4250,W46,4250,1063,57067038.07,1722,8878,7156,6979.144873,1677.832051
W47 4250,W47,4250,1061,56959668.29,1596,8839,7243,6659.603205,1869.144509
W48 4250,W48,4250,1062,57013353.18,5586,9269,3683,7940.655367,403.0906445
W49 4250,W49,4250,1056,56691243.84,1596,8729,7133,6288.679924,1949.658158
W50 4250,W50,4250,1060,56905983.4,1537,8736,7199,7304.292453,1423.845907
W51 4250,W51,4250,1063,57067038.07,2342,8774,6432,7731.169332,931.8372275
W52 4250,W52,4250,1059,56852298.51,1589,8758,7169,5837.592068,2080.88543
W53 4250,W53,4250,1059,56852298.51,2499,8751,6252,7418.738432,878.9136496
W54 4250,W54,4250,1061,56959668.29,1699,8514,6815,6124.05655,1918.249118
W55 4250,W55,4250,1051,56422819.39,1894,8972,7078,7045.187441,2021.766423
W56 4250,W56,4250,1063,57067038.07,1235,8959,7724,7187.539981,2033.037048
W57 4250,W57,4250,1062,57013353.18,1518,9349,7831,5464.062147,2280.125553
W58 4250,W58,4250,1050,56369134.5,1353,9352,7999,6860.880952,2070.415951
W59 4250,W59,4250,1057,56744928.73,904,8931,8027,5030.283822,2069.30554
W60 4250,W60,4250,1057,56744928.73,1092,8826,7734,7573.294229,1432.052173
W61 4250,W61,4250,1060,56905983.4,1140,9115,7975,7586.907547,1432.778393
W62 4250,W62,4250,1058,56798613.62,715,9427,8712,5114.738185,2542.473936
W63 4250,W63,4250,1063,57067038.07,-144,8707,8851,3497.388523,2053.863339
W64 4250,W64,4250,1061,56959668.29,1356,9043,7687,6774.915174,1585.974848
W65 4250,W65,4250,1052,56476504.28,748,8679,7931,4100.988593,2382.882141
W66 4250,W66,4250,1061,56959668.29,135,8517,8382,3938.839774,2306.852088
WB_ E1 4250,WB_ E1,4250,1050,56369134.5,130,9272,9142,4600.860952,2643.515281
WB_ E10 4250,WB_ E10,4250,1061,56959668.29,659,9145,8486,4071.834119,2065.906658
WB_ E2 4250,WB_ E2,4250,1063,57067038.07,1534,8938,7404,7552.796802,1126.054894
WB_ E3 4250,WB_ E3,4250,1057,56744928.73,5727,8706,2979,7765.481552,430.2066146
WB_ E4 4250,WB_ E4,4250,1061,56959668.29,1905,9009,7104,7930.421301,1386.798899
WB_ E5 4250,WB_ E5,4250,1053,56530189.17,130,9272,9142,3887.860399,2477.718819
WB_ E6 4250,WB_ E6,4250,1058,56798613.62,3375,8963,5588,7465.730624,889.6620799
WB_ E7 4250,WB_ E7,4250,1058,56798613.62,730,9787,9057,6234.666352,2133.141517
WB_ E8 4250,WB_ E8,4250,1058,56798613.62,1680,9074,7394,6393.594518,2280.309402
WB_ E9 4250,WB_ E9,4250,1050,56369134.5,854,8769,7915,4944.268571,2522.723006
WB_ H1 4250,WB_ H1,4250,1063,57067038.07,1611,8756,7145,7122,1759.927798
WB_ H10 4250,WB_ H10,4250,1062,57013353.18,1525,8878,7353,5664.268362,2159.610212
WB_ H2 4250,WB_ H2,4250,1050,56369134.5,1905,9009,7104,7093.268571,1711.873313
WB_ H3 4250,WB_ H3,4250,1060,56905983.4,1829,9261,7432,6162.023585,2222.279737
WB_ H4 4250,WB_ H4,4250,1059,56852298.51,1511,9112,7601,6430.430595,1955.22478
WB_ H5 4250,WB_ H5,4250,1058,56798613.62,1510,8675,7165,5339.823251,2236.024091
WB_ H6 4250,WB_ H6,4250,1058,56798613.62,117,9551,9434,5488.60775,2696.804663
WB_ H7 4250,WB_ H7,4250,1056,56691243.84,-503,9898,10401,5872.911932,2684.633531
WB_ H8 4250,WB_ H8,4250,1061,56959668.29,1142,8771,7629,6146.017908,2307.284002
WB_ H9 4250,WB_ H9,4250,1058,56798613.62,381,9272,8891,4549.238185,2604.866078
WB_ S1 4250,WB_ S1,4250,1060,56905983.4,-283,9431,9714,4337.372642,2830.175268
WB_ S10 4250,WB_ S10,4250,1060,56905983.4,615,9427,8812,4413.79717,2411.254199
WB_ S11 4250,WB_ S11,4250,1062,57013353.18,748,8679,7931,5332.614878,2547.55815
WB_ S12 4250,WB_ S12,4250,1054,56583874.06,802,8761,7959,4990.875712,2055.035864
WB_ S13 4250,WB_ S13,4250,1053,56530189.17,1510,8865,7355,5409.009497,2456.050251
WB_ S14 4250,WB_ S14,4250,1048,56261764.72,1883,8694,6811,7185.435115,1162.127915
WB_ S15 4250,WB_ S15,4250,1062,57013353.18,1766,8878,7112,7121.804143,1573.382009
WB_ S16 4250,WB_ S16,4250,1050,56369134.5,751,8798,8047,5731.366667,2400.177345
WB_ S17 4250,WB_ S17,4250,1057,56744928.73,3073,8740,5667,7525.994324,988.5982278
WB_ S18 4250,WB_ S18,4250,1057,56744928.73,896,9241,8345,6774.836329,2219.111261
WB_ S19 4250,WB_ S19,4250,1056,56691243.84,1894,8883,6989,6838.717803,1899.873103
WB_ S2 4250,WB_ S2,4250,1052,56476504.28,-698,9531,10229,4302.839354,3829.484043
WB_ S20 4250,WB_ S20,4250,1058,56798613.62,2170,8982,6812,8176.632325,1153.580538
WB_ S21 4250,WB_ S21,4250,1063,57067038.07,2961,8939,5978,7365.311383,1174.464127
WB_ S22 4250,WB_ S22,4250,1057,56744928.73,4017,8963,4946,7716.271523,558.6280947
WB_ S23 4250,WB_ S23,4250,1060,56905983.4,755,9040,8285,6914.20283,1768.127632
WB_ S24 4250,WB_ S24,4250,1058,56798613.62,381,9272,8891,4225.741966,2530.948688
WB_ S25 4250,WB_ S25,4250,1059,56852298.51,1553,8767,7214,7475.421152,1149.596152
WB_ S26 4250,WB_ S26,4250,1054,56583874.06,2002,9227,7225,8254.33871,977.1375217
WB_ S27 4250,WB_ S27,4250,1058,56798613.62,5884,9091,3207,8434.618147,417.3266455
WB_ S28 4250,WB_ S28,4250,1059,56852298.51,3218,9063,5845,8112.436261,660.3494128
WB_ S29 4250,WB_ S29,4250,1062,57013353.18,3445,8728,5283,6988.79661,1104.928977
WB_ S3 4250,WB_ S3,4250,1061,56959668.29,135,8688,8553,5841.563619,2163.529243
WB_ S4 4250,WB_ S4,4250,1056,56691243.84,723,8986,8263,4772.6875,2384.909916
WB_ S5 4250,WB_ S5,4250,1056,56691243.84,1142,8771,7629,5996.280303,2339.29305
WB_ S6 4250,WB_ S6,4250,1057,56744928.73,1511,9112,7601,5604.944182,2114.354512
WB_ S7 4250,WB_ S7,4250,1062,57013353.18,1537,8774,7237,7555.083804,1183.570563
WB_ S8 4250,WB_ S8,4250,1058,56798613.62,927,9604,8677,7454.785444,1552.61327
WB_ S9 4250,WB_ S9,4250,1052,56476504.28,-424,8964,9388,4486.708175,2283.422554
WB_ W1 4250,WB_ W1,4250,1058,56798613.62,755,9040,8285,5619.31569,2112.073669
WB_ W10 4250,WB_ W10,4250,1060,56905983.4,1017,8851,7834,5992.469811,1984.089657
WB_ W2 4250,WB_ W2,4250,1054,56583874.06,1249,8906,7657,7639.772296,1215.295791
WB_ W3 4250,WB_ W3,4250,1059,56852298.51,3626,8841,5215,6769.298395,1086.729168
WB_ W4 4250,WB_ W4,4250,1056,56691243.84,3217,8642,5425,6371.982008,1505.470383
WB_ W5 4250,WB_ W5,4250,1048,56261764.72,2353,8832,6479,7666.556298,734.2163675
WB_ W6 4250,WB_ W6,4250,1055,56637558.95,2286,8948,6662,8121.948815,1059.244441
WB_ W7 4250,WB_ W7,4250,1060,56905983.4,-714,9431,10145,5906.522642,2906.643216
WB_ W8 4250,WB_ W8,4250,1061,56959668.29,3380,8817,5437,7335.835061,897.3353569
WB_ W9 4250,WB_ W9,4250,1059,56852298.51,2033,8894,6861,7598.561851,1463.140885
W01 4500,W01,4500,1186,63670279.54,395,9102,8707,7007.623946,1878.295191
W02 4500,W02,4500,1187,63723964.43,395,9063,8668,7693.467565,1241.302662
W03 4500,W03,4500,1184,63562909.76,863,9063,8200,7186.284628,1836.711312
W04 4500,W04,4500,1179,63294485.31,2770,9063,6293,8076.014419,689.4113411
W05 4500,W05,4500,1187,63723964.43,1249,8906,7657,7296.588037,1507.186252
W06 4500,W06,4500,1187,63723964.43,1060,8906,7846,7779.625948,1068.034263
W07 4500,W07,4500,1185,63616594.65,863,8841,7978,6485.873418,1577.466977
W08 4500,W08,4500,1189,63831334.21,1724,8920,7196,7211.389403,1758.74018
W09 4500,W09,4500,1186,63670279.54,3278,8920,5642,7912.848229,887.7412765
W10 4500,W10,4500,1187,63723964.43,1763,8981,7218,7686.235889,1481.479736
W11 4500,W11,4500,1188,63777649.32,755,9040,8285,5549.093434,2069.747278
W12 4500,W12,4500,1185,63616594.65,595,9012,8417,5206.028692,1788.920526
W13 4500,W13,4500,1180,63348170.2,381,8414,8033,4949.497458,1854.25639
W14 4500,W14,4500,1182,63455539.98,684,8878,8194,6672.201354,1800.832491
W15 4500,W15,4500,1187,63723964.43,1788,8780,6992,6988.586352,1570.298599
W16 4500,W16,4500,1187,63723964.43,163,9008,8845,7056.754844,1932.63326
W17 4500,W17,4500,1186,63670279.54,38,9093,9055,6908.46543,2243.048781
W18 4500,W18,4500,1183,63509224.87,927,9316,8389,7505.206255,1557.390439
W19 4500,W19,4500,1186,63670279.54,210,9749,9539,6702.306914,2380.985374
W20 4500,W20,4500,1182,63455539.98,556,8919,8363,6602.980541,1920.91755
W21 4500,W21,4500,1185,63616594.65,357,9240,8883,6691.860759,2234.257769
W22 4500,W22,4500,1182,63455539.98,210,8964,8754,4838.814721,2340.524216
W23 4500,W23,4500,1187,63723964.43,699,8964,8265,5854.898905,1700.847325
W24 4500,W24,4500,1185,63616594.65,751,9240,8489,6211.895359,2300.74925
W25 4500,W25,4500,1184,63562909.76,1122,8798,7676,6604.836149,1890.47591
W26 4500,W26,4500,1185,63616594.65,453,9787,9334,4394.910549,2265.460133
W27 4500,W27,4500,1189,63831334.21,1249,8644,7395,7163.521447,1457.257413
W28 4500,W28,4500,1178,63240800.42,939,9102,8163,6787.385399,1918.2806
W29 4500,W29,4500,1184,63562909.76,1017,9102,8085,6682.90625,1819.867225
W30 4500,W30,4500,1188,63777649.32,3073,8817,5744,7429.963805,975.7374391
W31 4500,W31,4500,1188,63777649.32,6856,9027,2171,8506.554714,342.7885565
W32 4500,W32,4500,1191,63938703.99,2615,9227,6612,8476.798489,759.9296322
W33 4500,W33,4500,1186,63670279.54,2143,9134,6991,7876.642496,1202.24199
W34 4500,W34,4500,1194,64099758.66,1873,9261,7388,6428.334171,2148.582063
W35 4500,W35,4500,1189,63831334.21,2171,8965,6794,7457.077376,1487.408891
W36 4500,W36,4500,1192,63992388.88,2411,8970,6559,7646.775168,1391.359137
W37 4500,W37,4500,1185,63616594.65,1892,9134,7242,7176.611814,1852.629199
W38 4500,W38,4500,1193,64046073.77,4885,8902,4017,8534.786253,242.8708923
W39 4500,W39,4500,1184,63562909.76,2961,8846,5885,7782.261824,899.720399
W40 4500,W40,4500,1189,63831334.21,2106,8996,6890,7226.46762,1623.224943
W41 4500,W41,4500,1187,63723964.43,2963,8815,5852,7370.004212,1143.249561
W42 4500,W42,4500,1186,63670279.54,2640,8996,6356,7685.953626,1195.591672
W43 4500,W43,4500,1186,63670279.54,3375,8963,5588,7358.598651,931.2786822
W44 4500,W44,4500,1185,63616594.65,2006,8939,6933,7429.108861,1266.974485
W45 4500,W45,4500,1189,63831334.21,1683,8835,7152,6878.263246,1612.131393
W46 4500,W46,4500,1189,63831334.21,1722,8878,7156,6908.955425,1747.770988
W47 4500,W47,4500,1188,63777649.32,1596,8839,7243,6686,1852.669305
W48 4500,W48,4500,1187,63723964.43,3881,9269,5388,7922.201348,499.2303941
W49 4500,W49,4500,1184,63562909.76,1596,8729,7133,6311.543919,1930.838195
W50 4500,W50,4500,1187,63723964.43,1537,8736,7199,7284.064869,1467.668955
W51 4500,W51,4500,1187,63723964.43,2342,8774,6432,7640.598147,1094.239676
W52 4500,W52,4500,1185,63616594.65,1589,8758,7169,5900.877637,2069.931316
W53 4500,W53,4500,1188,63777649.32,2477,8751,6274,7375.63468,959.6400312
W54 4500,W54,4500,1194,64099758.66,1699,8514,6815,6133.695142,1881.14127
W55 4500,W55,4500,1179,63294485.31,1894,8972,7078,6989.608991,2023.599669
W56 4500,W56,4500,1187,63723964.43,1235,8959,7724,7050.025274,2100.366214
W57 4500,W57,4500,1191,63938703.99,1518,9349,7831,5523.599496,2300.99373
W58 4500,W58,4500,1186,63670279.54,1353,9352,7999,6770.182968,2129.60539
W59 4500,W59,4500,1185,63616594.65,823,8931,8108,4950.989873,2142.881778
W60 4500,W60,4500,1187,63723964.43,1092,8826,7734,7494.276327,1537.107212
W61 4500,W61,4500,1190,63885019.1,1140,9115,7975,7510.777311,1550.403524
W62 4500,W62,4500,1184,63562909.76,715,9427,8712,5118.431588,2560.929005
W63 4500,W63,4500,1188,63777649.32,-144,8707,8851,3518.042929,2046.249355
W64 4500,W64,4500,1193,64046073.77,1117,9043,7926,6630.828164,1758.086236
W65 4500,W65,4500,1185,63616594.65,748,8679,7931,4184.48692,2409.883583
W66 4500,W66,4500,1189,63831334.21,135,8517,8382,3885.761985,2291.812524
WB_ E1 4500,WB_ E1,4500,1186,63670279.54,130,9272,9142,4434.698988,2641.218692
WB_ E10 4500,WB_ E10,4500,1188,63777649.32,659,9145,8486,4075.986532,2069.144313
WB_ E2 4500,WB_ E2,4500,1187,63723964.43,1534,9043,7509,7452.830666,1285.360569
WB_ E3 4500,WB_ E3,4500,1188,63777649.32,5327,8706,3379,7777.196128,454.4290673
WB_ E4 4500,WB_ E4,4500,1184,63562909.76,1905,9009,7104,7928.381757,1398.322374
WB_ E5 4500,WB_ E5,4500,1183,63509224.87,130,9272,9142,3941.216399,2462.667058
WB_ E6 4500,WB_ E6,4500,1184,63562909.76,3375,8963,5588,7464.603041,887.6253611
WB_ E7 4500,WB_ E7,4500,1184,63562909.76,730,9787,9057,6170.35473,2151.942737
WB_ E8 4500,WB_ E8,4500,1186,63670279.54,1680,9349,7669,6343.028668,2308.61835
WB_ E9 4500,WB_ E9,4500,1178,63240800.42,854,8841,7987,4972.663837,2516.705336
WB_ H1 4500,WB_ H1,4500,1194,64099758.66,1611,8756,7145,7168.276382,1723.541527
WB_ H10 4500,WB_ H10,4500,1187,63723964.43,1525,8878,7353,5652.005897,2136.639134
WB_ H2 4500,WB_ H2,4500,1179,63294485.31,1905,9009,7104,7152.094148,1694.454562
WB_ H3 4500,WB_ H3,4500,1192,63992388.88,1762,9261,7499,6157.300336,2198.699954
WB_ H4 4500,WB_ H4,4500,1187,63723964.43,1511,9112,7601,6439.10278,1933.917913
WB_ H5 4500,WB_ H5,4500,1184,63562909.76,1510,8996,7486,5447.403716,2248.841041
WB_ H6 4500,WB_ H6,4500,1179,63294485.31,117,9551,9434,5592.140797,2715.590181
WB_ H7 4500,WB_ H7,4500,1186,63670279.54,-503,9898,10401,6071.821248,2645.529374
WB_ H8 4500,WB_ H8,4500,1192,63992388.88,1142,8771,7629,6246.912752,2258.568749
WB_ H9 4500,WB_ H9,4500,1185,63616594.65,381,9272,8891,4714.371308,2623.704156
WB_ S1 4500,WB_ S1,4500,1191,63938703.99,-283,9431,9714,4516.243493,2811.174405
WB_ S10 4500,WB_ S10,4500,1185,63616594.65,615,9427,8812,4445.05654,2412.964398
WB_ S11 4500,WB_ S11,4500,1188,63777649.32,748,8679,7931,5391.063973,2536.567409
WB_ S12 4500,WB_ S12,4500,1183,63509224.87,802,8931,8129,4977.881657,2098.30988
WB_ S13 4500,WB_ S13,4500,1186,63670279.54,1174,8865,7691,5514.432546,2476.148654
WB_ S14 4500,WB_ S14,4500,1178,63240800.42,1883,8709,6826,7204.347199,1186.040451
WB_ S15 4500,WB_ S15,4500,1194,64099758.66,1726,8878,7152,7067.173367,1638.839886
WB_ S16 4500,WB_ S16,4500,1184,63562909.76,477,8798,8321,5774.222973,2394.07312
WB_ S17 4500,WB_ S17,4500,1188,63777649.32,2548,8790,6242,7555.377946,996.5972398
WB_ S18 4500,WB_ S18,4500,1186,63670279.54,896,9261,8365,6799.746206,2232.676504
WB_ S19 4500,WB_ S19,4500,1185,63616594.65,1894,8883,6989,6903.316456,1863.051573
WB_ S2 4500,WB_ S2,4500,1181,63401855.09,-698,9531,10229,4193.700254,3781.975602
WB_ S20 4500,WB_ S20,4500,1186,63670279.54,2170,9134,6964,8111.902192,1263.398854
WB_ S21 4500,WB_ S21,4500,1190,63885019.1,2961,8939,5978,7369.729412,1176.293285
WB_ S22 4500,WB_ S22,4500,1188,63777649.32,4017,8963,4946,7694.83165,594.2166506
WB_ S23 4500,WB_ S23,4500,1187,63723964.43,755,9040,8285,6895.898905,1737.751672
WB_ S24 4500,WB_ S24,4500,1184,63562909.76,381,9272,8891,4274.079392,2527.113627
WB_ S25 4500,WB_ S25,4500,1184,63562909.76,1553,8767,7214,7372.939189,1305.415919
WB_ S26 4500,WB_ S26,4500,1188,63777649.32,2002,9227,7225,8189.622054,1058.552157
WB_ S27 4500,WB_ S27,4500,1186,63670279.54,3710,9091,5381,8400.376054,522.7707286
WB_ S28 4500,WB_ S28,4500,1187,63723964.43,3160,9063,5903,8043.670598,749.8218357
WB_ S29 4500,WB_ S29,4500,1186,63670279.54,2319,8880,6561,6976.578415,1140.533852
WB_ S3 4500,WB_ S3,4500,1191,63938703.99,135,8688,8553,5825.508816,2193.129271
WB_ S4 4500,WB_ S4,4500,1186,63670279.54,723,8986,8263,4767.73946,2381.889052
WB_ S5 4500,WB_ S5,4500,1184,63562909.76,1142,8771,7629,6008.423142,2333.881043
WB_ S6 4500,WB_ S6,4500,1186,63670279.54,1511,9112,7601,5713.039629,2108.638743
WB_ S7 4500,WB_ S7,4500,1189,63831334.21,1537,8774,7237,7474.318755,1305.121416
WB_ S8 4500,WB_ S8,4500,1184,63562909.76,927,9604,8677,7403.228041,1624.351713
WB_ S9 4500,WB_ S9,4500,1185,63616594.65,-424,8964,9388,4487.572152,2290.91217
WB_ W1 4500,WB_ W1,4500,1192,63992388.88,755,9040,8285,5592.954698,2086.860374
WB_ W10 4500,WB_ W10,4500,1179,63294485.31,1017,8851,7834,5986.235793,2041.305784
WB_ W2 4500,WB_ W2,4500,1185,63616594.65,1249,8906,7657,7580.348523,1262.762388
WB_ W3 4500,WB_ W3,4500,1183,63509224.87,3282,8841,5559,6746.244294,1102.686327
WB_ W4 4500,WB_ W4,4500,1185,63616594.65,2067,8642,6575,6373.42616,1532.061883
WB_ W5 4500,WB_ W5,4500,1177,63187115.53,1941,8937,6996,7642.956669,832.8564521
WB_ W6 4500,WB_ W6,4500,1185,63616594.65,2286,8948,6662,8085.908861,1095.658883
WB_ W7 4500,WB_ W7,4500,1189,63831334.21,-714,9431,10145,5848.316232,2941.281582
WB_ W8 4500,WB_ W8,4500,1186,63670279.54,3380,8817,5437,7347.306071,897.5919846
WB_ W9 4500,WB_ W9,4500,1188,63777649.32,2033,8894,6861,7532.827441,1560.693639
W01 4750,W01,4750,1325,71132479.25,343,9102,8759,7007.711698,1895.597401
W02 4750,W02,4750,1322,70971424.58,395,9102,8707,7683.928896,1244.332533
W03 4750,W03,4750,1321,70917739.69,863,9063,8200,7129.796366,1861.048069
W04 4750,W04,4750,1317,70703000.13,2770,9063,6293,8031.027335,716.2718785
W05 4750,W05,4750,1322,70971424.58,1197,8906,7709,7265.015129,1534.851629
W06 4750,W06,4750,1327,71239849.03,1060,9063,8003,7719.804823,1146.387666
W07 4750,W07,4750,1323,71025109.47,863,8841,7978,6443.154195,1624.604423
W08 4750,W08,4750,1327,71239849.03,1724,8920,7196,7280.453655,1706.730158
W09 4750,W09,4750,1325,71132479.25,3278,8920,5642,7843.596226,939.2850035
W10 4750,W10,4750,1320,70864054.8,1724,8981,7257,7639.909848,1539.564504
W11 4750,W11,4750,1327,71239849.03,755,9040,8285,5559.816127,2042.282577
W12 4750,W12,4750,1323,71025109.47,595,9040,8445,5206.203326,1852.290725
W13 4750,W13,4750,1317,70703000.13,381,8414,8033,5036.400911,1877.222547
W14 4750,W14,4750,1321,70917739.69,507,8878,8371,6589.981075,1903.321606
W15 4750,W15,4750,1325,71132479.25,1380,8780,7400,6981.968302,1583.953767
W16 4750,W16,4750,1325,71132479.25,163,9008,8845,6996.335849,1961.889254
W17 4750,W17,4750,1323,71025109.47,38,9093,9055,6855.833711,2253.159938
W18 4750,W18,4750,1319,70810369.91,927,9316,8389,7458.207733,1590.1182
W19 4750,W19,4750,1321,70917739.69,210,9749,9539,6652.052233,2400.36492
W20 4750,W20,4750,1316,70649315.24,556,9062,8506,6545.981763,1992.824345
W21 4750,W21,4750,1323,71025109.47,38,9240,9202,6675.191988,2265.73988
W22 4750,W22,4750,1318,70756685.02,2,8964,8962,4787.312595,2329.155378
W23 4750,W23,4750,1323,71025109.47,699,8964,8265,5886.811791,1764.411422
W24 4750,W24,4750,1323,71025109.47,751,9240,8489,6195.105064,2302.772074
W25 4750,W25,4750,1320,70864054.8,1122,8798,7676,6629.488636,1862.442331
W26 4750,W26,4750,1320,70864054.8,453,9787,9334,4446.37803,2289.25761
W27 4750,W27,4750,1326,71186164.14,1249,8644,7395,7089.231523,1515.679712
W28 4750,W28,4750,1323,71025109.47,572,9102,8530,6696.948602,2011.132939
W29 4750,W29,4750,1324,71078794.36,572,9102,8530,6618.64577,1877.759234
W30 4750,W30,4750,1325,71132479.25,3073,8817,5744,7459.637736,958.4708648
W31 4750,W31,4750,1320,70864054.8,6856,9070,2214,8513.615909,338.7207801
W32 4750,W32,4750,1327,71239849.03,2002,9227,7225,8416.848531,853.3169081
W33 4750,W33,4750,1323,71025109.47,1829,9134,7305,7809.461829,1269.549024
W34 4750,W34,4750,1322,70971424.58,1873,9261,7388,6503.686838,2109.955681
W35 4750,W35,4750,1328,71293533.92,2171,9024,6853,7511.211596,1454.739667
W36 4750,W36,4750,1323,71025109.47,2411,9008,6597,7604.02192,1430.563361
W37 4750,W37,4750,1317,70703000.13,1892,9134,7242,7215.418375,1841.866826
W38 4750,W38,4750,1324,71078794.36,4885,8902,4017,8532.672205,251.2710224
W39 4750,W39,4750,1319,70810369.91,2961,8846,5885,7805.053071,887.5183819
W40 4750,W40,4750,1322,70971424.58,1514,8996,7482,7178.371407,1673.764308
W41 4750,W41,4750,1322,70971424.58,1926,8815,6889,7290.808623,1237.952273
W42 4750,W42,4750,1321,70917739.69,2640,8996,6356,7698.906132,1180.393665
W43 4750,W43,4750,1319,70810369.91,3375,8963,5588,7404.939348,903.6738063
W44 4750,W44,4750,1325,71132479.25,1883,8939,7056,7366.099623,1334.383863
W45 4750,W45,4750,1324,71078794.36,1683,8835,7152,6873.996224,1633.370843
W46 4750,W46,4750,1326,71186164.14,1525,8878,7353,6843.377074,1821.257038
W47 4750,W47,4750,1324,71078794.36,1596,8839,7243,6721.77719,1824.203061
W48 4750,W48,4750,1326,71186164.14,2345,9269,6924,7881.897436,654.4254167
W49 4750,W49,4750,1321,70917739.69,1596,8729,7133,6336.221802,1917.67708
W50 4750,W50,4750,1323,71025109.47,1537,8736,7199,7268.498866,1489.077194
W51 4750,W51,4750,1325,71132479.25,1865,8774,6909,7541.914717,1259.954548
W52 4750,W52,4750,1322,70971424.58,1589,8758,7169,5955.985628,2061.3903
W53 4750,W53,4750,1324,71078794.36,2477,8751,6274,7316.098943,1023.116826
W54 4750,W54,4750,1319,70810369.91,1699,8514,6815,6121.024261,1875.576834
W55 4750,W55,4750,1316,70649315.24,1894,8972,7078,6958.743921,2009.609748
W56 4750,W56,4750,1325,71132479.25,1235,8959,7724,6951.893585,2151.161297
W57 4750,W57,4750,1323,71025109.47,1518,9349,7831,5606.829176,2316.015196
W58 4750,W58,4750,1319,70810369.91,1353,9352,7999,6713.865807,2170.325161
W59 4750,W59,4750,1319,70810369.91,802,8931,8129,4897.055345,2202.006851
W60 4750,W60,4750,1321,70917739.69,1092,8874,7782,7439.360333,1585.650607
W61 4750,W61,4750,1322,70971424.58,1052,9115,8063,7408.363843,1696.560395
W62 4750,W62,4750,1322,70971424.58,715,9427,8712,5151.334342,2564.284892
W63 4750,W63,4750,1327,71239849.03,-144,9043,9187,3645.987189,2093.328284
W64 4750,W64,4750,1324,71078794.36,1117,9043,7926,6519.420695,1871.771718
W65 4750,W65,4750,1321,70917739.69,748,8679,7931,4265.849357,2425.624298
W66 4750,W66,4750,1323,71025109.47,135,8576,8441,3887.42328,2292.41126
WB_ E1 4750,WB_ E1,4750,1320,70864054.8,130,9272,9142,4349.089394,2620.095492
WB_ E10 4750,WB_ E10,4750,1324,71078794.36,659,9145,8486,4108.902568,2073.91917
WB_ E2 4750,WB_ E2,4750,1323,71025109.47,1245,9043,7798,7349.954649,1434.663513
WB_ E3 4750,WB_ E3,4750,1323,71025109.47,5326,8730,3404,7786.687075,477.7292
WB_ E4 4750,WB_ E4,4750,1325,71132479.25,1905,9009,7104,7925.337358,1400.120733
WB_ E5 4750,WB_ E5,4750,1320,70864054.8,130,9272,9142,3999.173485,2433.635986
WB_ E6 4750,WB_ E6,4750,1323,71025109.47,3375,8963,5588,7462.565382,882.2235664
WB_ E7 4750,WB_ E7,4750,1320,70864054.8,715,9787,9072,6107.948485,2170.871015
WB_ E8 4750,WB_ E8,4750,1319,70810369.91,1629,9349,7720,6284.636088,2340.951009
WB_ E9 4750,WB_ E9,4750,1312,70434575.68,854,8841,7987,4991.866616,2519.898178
WB_ H1 4750,WB_ H1,4750,1323,71025109.47,1611,8839,7228,7201.167045,1692.237365
WB_ H10 4750,WB_ H10,4750,1325,71132479.25,1525,8878,7353,5682.377358,2112.95359
WB_ H2 4750,WB_ H2,4750,1317,70703000.13,1905,9009,7104,7187.077449,1711.66913
WB_ H3 4750,WB_ H3,4750,1323,71025109.47,1052,9261,8209,6157.341648,2197.468016
WB_ H4 4750,WB_ H4,4750,1321,70917739.69,1511,9112,7601,6420.910674,1942.580247
WB_ H5 4750,WB_ H5,4750,1320,70864054.8,1510,8996,7486,5549.862879,2266.232259
WB_ H6 4750,WB_ H6,4750,1323,71025109.47,117,9551,9434,5674.260771,2735.664176
WB_ H7 4750,WB_ H7,4750,1319,70810369.91,-503,9898,10401,6239.317665,2603.184721
WB_ H8 4750,WB_ H8,4750,1325,71132479.25,1142,8771,7629,6350.078491,2204.801519
WB_ H9 4750,WB_ H9,4750,1321,70917739.69,381,9272,8891,4843.245269,2624.027406
WB_ S1 4750,WB_ S1,4750,1324,71078794.36,-283,9431,9714,4714.351208,2806.36141
WB_ S10 4750,WB_ S10,4750,1324,71078794.36,615,9427,8812,4462.831571,2419.965619
WB_ S11 4750,WB_ S11,4750,1328,71293533.92,748,8679,7931,5471.204819,2522.548705
WB_ S12 4750,WB_ S12,4750,1318,70756685.02,802,8931,8129,4952.300455,2153.876842
WB_ S13 4750,WB_ S13,4750,1321,70917739.69,1174,8865,7691,5606.962907,2485.405173
WB_ S14 4750,WB_ S14,4750,1313,70488260.57,1883,8804,6921,7233.857578,1199.171369
WB_ S15 4750,WB_ S15,4750,1324,71078794.36,1722,8878,7156,7025.345166,1693.678261
WB_ S16 4750,WB_ S16,4750,1317,70703000.13,477,8798,8321,5806.536826,2396.919823
WB_ S17 4750,WB_ S17,4750,1322,70971424.58,1976,8790,6814,7572.185325,1005.478443
WB_ S18 4750,WB_ S18,4750,1321,70917739.69,896,9261,8365,6800.912188,2227.912259
WB_ S19 4750,WB_ S19,4750,1318,70756685.02,1894,8883,6989,6966.103945,1827.376258
WB_ S2 4750,WB_ S2,4750,1318,70756685.02,-1001,9531,10532,4067.053869,3731.573891
WB_ S20 4750,WB_ S20,4750,1322,70971424.58,2170,9134,6964,8069.068835,1333.585465
WB_ S21 4750,WB_ S21,4750,1328,71293533.92,2961,8939,5978,7385.53991,1171.746159
WB_ S22 4750,WB_ S22,4750,1321,70917739.69,4017,8963,4946,7683.697199,604.2161023
WB_ S23 4750,WB_ S23,4750,1322,70971424.58,755,9040,8285,6859.441755,1731.441489
WB_ S24 4750,WB_ S24,4750,1321,70917739.69,381,9272,8891,4320.998486,2498.260672
WB_ S25 4750,WB_ S25,4750,1321,70917739.69,1380,8767,7387,7294.071915,1400.018307
WB_ S26 4750,WB_ S26,4750,1320,70864054.8,2002,9227,7225,8135.399242,1108.679915
WB_ S27 4750,WB_ S27,4750,1316,70649315.24,2171,9091,6920,8352.711246,695.1497282
WB_ S28 4750,WB_ S28,4750,1325,71132479.25,3089,9063,5974,7983.340377,831.3495623
WB_ S29 4750,WB_ S29,4750,1323,71025109.47,2319,8880,6561,6974.095994,1162.683566
WB_ S3 4750,WB_ S3,4750,1325,71132479.25,135,8688,8553,5808.938868,2219.906232
WB_ S4 4750,WB_ S4,4750,1320,70864054.8,723,8986,8263,4755.933333,2363.080425
WB_ S5 4750,WB_ S5,4750,1320,70864054.8,1142,8888,7746,5994.656061,2348.177816
WB_ S6 4750,WB_ S6,4750,1318,70756685.02,1511,9112,7601,5813.498483,2111.096122
WB_ S7 4750,WB_ S7,4750,1326,71186164.14,1537,8774,7237,7402.38914,1404.61285
WB_ S8 4750,WB_ S8,4750,1319,70810369.91,927,9604,8677,7349.332828,1684.77239
WB_ S9 4750,WB_ S9,4750,1319,70810369.91,-424,8964,9388,4484.571645,2300.385641
WB_ W1 4750,WB_ W1,4750,1319,70810369.91,755,9040,8285,5603.210008,2059.321149
WB_ W10 4750,WB_ W10,4750,1322,70971424.58,1017,8851,7834,5973.978064,2090.694166
WB_ W2 4750,WB_ W2,4750,1321,70917739.69,1249,8906,7657,7532.236942,1305.002404
WB_ W3 4750,WB_ W3,4750,1322,70971424.58,2516,8841,6325,6699.056732,1151.513935
WB_ W4 4750,WB_ W4,4750,1318,70756685.02,2067,8697,6630,6342.490137,1595.447828
WB_ W5 4750,WB_ W5,4750,1310,70327205.9,1277,8937,7660,7623.752672,901.3585149
WB_ W6 4750,WB_ W6,4750,1317,70703000.13,2286,9009,6723,8048.553531,1125.520873
WB_ W7 4750,WB_ W7,4750,1325,71132479.25,-714,9431,10145,5807.799245,2975.892286
WB_ W8 4750,WB_ W8,4750,1325,71132479.25,3380,8817,5437,7353.135094,916.8222925
WB_ W9 4750,WB_ W9,4750,1320,70864054.8,2026,8894,6868,7478.732576,1630.422336
W01 5000,W01,5000,1463,78540994.07,249,9551,9302,6980.319891,1940.344645
W02 5000,W02,5000,1461,78433624.29,395,9102,8707,7672.764545,1249.388569
W03 5000,W03,5000,1464,78594678.96,863,9063,8200,7074.114754,1871.384686
W04 5000,W04,5000,1464,78594678.96,2770,9063,6293,7983.555328,760.1741242
W05 5000,W05,5000,1461,78433624.29,922,8906,7984,7233.864476,1563.033995
W06 5000,W06,5000,1463,78540994.07,1060,9063,8003,7672.594668,1201.551987
W07 5000,W07,5000,1462,78487309.18,863,8841,7978,6431.441176,1639.782075
W08 5000,W08,5000,1462,78487309.18,1724,8991,7267,7330.536936,1662.167168
W09 5000,W09,5000,1463,78540994.07,2100,8920,6820,7777.818865,1007.56346
W10 5000,W10,5000,1465,78648363.85,1724,8981,7257,7580.004778,1608.201179
W11 5000,W11,5000,1463,78540994.07,755,9040,8285,5595.177717,2013.900345
W12 5000,W12,5000,1461,78433624.29,595,9040,8445,5227.796715,1892.451618
W13 5000,W13,5000,1466,78702048.74,381,8414,8033,5089.746248,1904.381783
W14 5000,W14,5000,1459,78326254.51,381,8878,8497,6512.190541,1999.119299
W15 5000,W15,5000,1463,78540994.07,1380,8780,7400,6988.298701,1603.522098
W16 5000,W16,5000,1462,78487309.18,163,9486,9323,6944.197674,1987.259263
W17 5000,W17,5000,1461,78433624.29,38,9480,9442,6818.132786,2255.241995
W18 5000,W18,5000,1462,78487309.18,610,9316,8706,7429.173735,1617.141678
W19 5000,W19,5000,1463,78540994.07,210,9749,9539,6629.911141,2399.468702
W20 5000,W20,5000,1461,78433624.29,556,9316,8760,6524.826146,2023.270347
W21 5000,W21,5000,1461,78433624.29,38,9240,9202,6668.731006,2270.741141
W22 5000,W22,5000,1462,78487309.18,-424,8964,9388,4722.162791,2324.492016
W23 5000,W23,5000,1462,78487309.18,531,8964,8433,5909.398085,1803.511323
W24 5000,W24,5000,1462,78487309.18,751,9240,8489,6178.616963,2303.810246
W25 5000,W25,5000,1464,78594678.96,1122,8798,7676,6624.002732,1851.618585
W26 5000,W26,5000,1463,78540994.07,453,9787,9334,4498.760082,2291.799839
W27 5000,W27,5000,1463,78540994.07,1191,8798,7607,7032.272727,1564.055638
W28 5000,W28,5000,1462,78487309.18,572,9102,8530,6632.178523,2077.407159
W29 5000,W29,5000,1463,78540994.07,572,9102,8530,6589.171565,1903.748425
W30 5000,W30,5000,1463,78540994.07,3073,8817,5744,7482.638414,944.0189104
W31 5000,W31,5000,1462,78487309.18,6856,9070,2214,8521.311218,336.1907268
W32 5000,W32,5000,1467,78755733.63,2002,9227,7225,8370.867757,917.8923393
W33 5000,W33,5000,1463,78540994.07,1829,9145,7316,7728.937116,1364.936885
W34 5000,W34,5000,1470,78916788.3,1873,9261,7388,6578.80068,2069.454935
W35 5000,W35,5000,1463,78540994.07,2171,9069,6898,7561.124402,1427.841402
W36 5000,W36,5000,1466,78702048.74,2411,9134,6723,7569.602319,1467.895291
W37 5000,W37,5000,1467,78755733.63,1892,9134,7242,7252.716428,1851.448059
W38 5000,W38,5000,1468,78809418.52,4885,8902,4017,8530.46049,261.9870318
W39 5000,W39,5000,1464,78594678.96,2961,8846,5885,7828.991803,872.9021338
W40 5000,W40,5000,1463,78540994.07,1514,8996,7482,7118.745728,1748.599678
W41 5000,W41,5000,1463,78540994.07,1649,8815,7166,7212.150376,1338.746212
W42 5000,W42,5000,1462,78487309.18,2640,8996,6356,7717.243502,1155.459435
W43 5000,W43,5000,1466,78702048.74,3375,8963,5588,7455.423602,879.4244746
W44 5000,W44,5000,1466,78702048.74,1883,8939,7056,7317.163711,1376.884733
W45 5000,W45,5000,1462,78487309.18,1683,8835,7152,6876.567031,1640.055143
W46 5000,W46,5000,1464,78594678.96,1525,8878,7353,6769.217896,1889.359828
W47 5000,W47,5000,1466,78702048.74,1596,8839,7243,6767.439973,1790.554205
W48 5000,W48,5000,1463,78540994.07,2263,9269,7006,7854.376623,769.2143578
W49 5000,W49,5000,1464,78594678.96,1596,8729,7133,6372.246585,1903.474855
W50 5000,W50,5000,1465,78648363.85,1537,8736,7199,7273.935836,1489.633027
W51 5000,W51,5000,1465,78648363.85,1760,8774,7014,7452.851195,1385.023135
W52 5000,W52,5000,1467,78755733.63,1589,8774,7185,5965.5985,2061.821376
W53 5000,W53,5000,1468,78809418.52,2416,8751,6335,7265.357629,1092.464052
W54 5000,W54,5000,1471,78970473.19,1589,8514,6925,6054.811013,1932.850348
W55 5000,W55,5000,1468,78809418.52,1894,8976,7082,6954.521117,1985.038726
W56 5000,W56,5000,1464,78594678.96,1235,8959,7724,6870.640027,2183.910085
W57 5000,W57,5000,1462,78487309.18,1518,9352,7834,5723.691518,2315.194977
W58 5000,W58,5000,1464,78594678.96,1353,9352,7999,6643.256148,2212.450408
W59 5000,W59,5000,1466,78702048.74,659,9145,8486,4885.324693,2269.556243
W60 5000,W60,5000,1463,78540994.07,1092,8902,7810,7356.546822,1646.258551
W61 5000,W61,5000,1461,78433624.29,896,9115,8219,7318.937714,1799.611135
W62 5000,W62,5000,1462,78487309.18,715,9427,8712,5179.918605,2565.93325
W63 5000,W63,5000,1465,78648363.85,-144,9043,9187,3780.887372,2149.691064
W64 5000,W64,5000,1467,78755733.63,1091,9043,7952,6362.721881,2003.471794
W65 5000,W65,5000,1462,78487309.18,659,8679,8020,4347.04104,2446.032273
W66 5000,W66,5000,1463,78540994.07,135,8576,8441,3902.9419,2292.389164
WB_ E1 5000,WB_ E1,5000,1461,78433624.29,130,9272,9142,4307.552361,2605.748483
WB_ E10 5000,WB_ E10,5000,1464,78594678.96,659,9145,8486,4151.95082,2071.863389
WB_ E2 5000,WB_ E2,5000,1462,78487309.18,1117,9043,7926,7239.25513,1581.610271
WB_ E3 5000,WB_ E3,5000,1467,78755733.63,5315,8753,3438,7799.148603,501.7273052
WB_ E4 5000,WB_ E4,5000,1460,78379939.4,1905,9009,7104,7936.911644,1370.766164
WB_ E5 5000,WB_ E5,5000,1462,78487309.18,130,9272,9142,4092.27907,2424.613754
WB_ E6 5000,WB_ E6,5000,1465,78648363.85,3375,8963,5588,7459.823208,875.0552276
WB_ E7 5000,WB_ E7,5000,1463,78540994.07,715,9787,9072,6056.867396,2192.92486
WB_ E8 5000,WB_ E8,5000,1467,78755733.63,1628,9352,7724,6210.029312,2376.633384
WB_ E9 5000,WB_ E9,5000,1468,78809418.52,854,8841,7987,5058.754087,2511.348602
WB_ H1 5000,WB_ H1,5000,1471,78970473.19,1611,8839,7228,7247.742352,1650.204593
WB_ H10 5000,WB_ H10,5000,1465,78648363.85,1525,8878,7353,5722.204778,2097.308072
WB_ H2 5000,WB_ H2,5000,1463,78540994.07,1763,9009,7246,7188.203691,1757.166323
WB_ H3 5000,WB_ H3,5000,1467,78755733.63,1052,9261,8209,6170.615542,2198.755765
WB_ H4 5000,WB_ H4,5000,1465,78648363.85,1511,9112,7601,6396.474403,1966.721932
WB_ H5 5000,WB_ H5,5000,1466,78702048.74,1510,8996,7486,5662.24352,2279.053711
WB_ H6 5000,WB_ H6,5000,1462,78487309.18,117,9551,9434,5752.577975,2743.779119
WB_ H7 5000,WB_ H7,5000,1464,78594678.96,-503,9898,10401,6370.989754,2565.750131
WB_ H8 5000,WB_ H8,5000,1466,78702048.74,1142,8864,7722,6403.42292,2168.615451
WB_ H9 5000,WB_ H9,5000,1461,78433624.29,171,9272,9101,4957.154689,2618.867557
WB_ S1 5000,WB_ S1,5000,1467,78755733.63,-283,9431,9714,4926.894342,2811.105064
WB_ S10 5000,WB_ S10,5000,1464,78594678.96,615,9427,8812,4462.607923,2423.606706
WB_ S11 5000,WB_ S11,5000,1463,78540994.07,748,8679,7931,5508.556391,2520.02986
WB_ S12 5000,WB_ S12,5000,1462,78487309.18,659,8931,8272,4926.532832,2217.550069
WB_ S13 5000,WB_ S13,5000,1463,78540994.07,1174,8995,7821,5687.282297,2488.059776
WB_ S14 5000,WB_ S14,5000,1468,78809418.52,1883,8825,6942,7270.833106,1204.538261
WB_ S15 5000,WB_ S15,5000,1469,78863103.41,1611,8878,7267,6936.562968,1781.193521
WB_ S16 5000,WB_ S16,5000,1461,78433624.29,477,8798,8321,5836.125941,2399.153611
WB_ S17 5000,WB_ S17,5000,1463,78540994.07,1604,8875,7271,7565.712235,1063.722952
WB_ S18 5000,WB_ S18,5000,1463,78540994.07,896,9261,8365,6813.015038,2199.681285
WB_ S19 5000,WB_ S19,5000,1466,78702048.74,1894,8894,7000,7016.589359,1794.371675
WB_ S2 5000,WB_ S2,5000,1461,78433624.29,-1001,9531,10532,3930.347707,3697.861038
WB_ S20 5000,WB_ S20,5000,1466,78702048.74,2170,9134,6964,8033.328786,1389.665486
WB_ S21 5000,WB_ S21,5000,1465,78648363.85,2961,8939,5978,7400.937884,1151.634342
WB_ S22 5000,WB_ S22,5000,1468,78809418.52,4017,8963,4946,7666.788828,626.1639856
WB_ S23 5000,WB_ S23,5000,1462,78487309.18,755,9040,8285,6814.402873,1733.52343
WB_ S24 5000,WB_ S24,5000,1461,78433624.29,381,9272,8891,4374.436687,2473.373593
WB_ S25 5000,WB_ S25,5000,1463,78540994.07,1304,8767,7463,7244.556391,1451.093571
WB_ S26 5000,WB_ S26,5000,1465,78648363.85,2002,9227,7225,8091.674403,1159.397303
WB_ S27 5000,WB_ S27,5000,1470,78916788.3,2171,9091,6920,8306.440816,803.1978011
WB_ S28 5000,WB_ S28,5000,1464,78594678.96,3089,9063,5974,7938.140027,884.182696
WB_ S29 5000,WB_ S29,5000,1462,78487309.18,2319,8920,6601,6977.422709,1179.221968
WB_ S3 5000,WB_ S3,5000,1466,78702048.74,135,8688,8553,5780.534106,2235.194183
WB_ S4 5000,WB_ S4,5000,1470,78916788.3,723,8986,8263,4735.191156,2334.039633
WB_ S5 5000,WB_ S5,5000,1464,78594678.96,1142,8888,7746,5989.997268,2365.647896
WB_ S6 5000,WB_ S6,5000,1469,78863103.41,1511,9112,7601,5917.220558,2085.583895
WB_ S7 5000,WB_ S7,5000,1466,78702048.74,1537,8774,7237,7348.432469,1462.556615
WB_ S8 5000,WB_ S8,5000,1461,78433624.29,927,9604,8677,7290.091718,1756.791782
WB_ S9 5000,WB_ S9,5000,1462,78487309.18,-424,8964,9388,4469.155951,2307.530887
WB_ W1 5000,WB_ W1,5000,1468,78809418.52,755,9040,8285,5648.720708,2025.926706
WB_ W10 5000,WB_ W10,5000,1462,78487309.18,697,8851,8154,5954.153899,2119.961402
WB_ W2 5000,WB_ W2,5000,1461,78433624.29,1060,8906,7846,7494.894593,1351.893547
WB_ W3 5000,WB_ W3,5000,1462,78487309.18,2319,8841,6522,6643.195622,1224.441523
WB_ W4 5000,WB_ W4,5000,1465,78648363.85,1122,8697,7575,6302.590444,1672.651815
WB_ W5 5000,WB_ W5,5000,1468,78809418.52,1117,9017,7900,7587.51158,1009.884578
WB_ W6 5000,WB_ W6,5000,1468,78809418.52,2286,9009,6723,8010.507493,1159.727693
WB_ W7 5000,WB_ W7,5000,1465,78648363.85,-714,9431,10145,5732.187031,3002.76565
WB_ W8 5000,WB_ W8,5000,1464,78594678.96,3293,9009,5716,7365.977459,940.9074914
WB_ W9 5000,WB_ W9,5000,1463,78540994.07,1935,8935,7000,7423.876965,1689.328438
W01 5250,W01,5250,1614,86647412.46,249,9551,9302,6980.721809,1936.513242
W02 5250,W02,5250,1608,86325303.12,395,9102,8707,7659.576493,1256.722347
W03 5250,W03,5250,1617,86808467.13,863,9063,8200,7063.836735,1854.675183
W04 5250,W04,5250,1613,86593727.57,2770,9063,6293,7938.920645,809.7540923
W05 5250,W05,5250,1611,86486357.79,425,8906,8481,7205.552452,1595.207718
W06 5250,W06,5250,1615,86701097.35,1060,9063,8003,7617.897214,1247.101873
W07 5250,W07,5250,1612,86540042.68,863,8841,7978,6425.604839,1641.256179
W08 5250,W08,5250,1615,86701097.35,1724,8991,7267,7384.426625,1618.23156
W09 5250,W09,5250,1614,86647412.46,2100,8920,6820,7690.956629,1102.504246
W10 5250,W10,5250,1613,86593727.57,1724,8981,7257,7547.099814,1629.329761
W11 5250,W11,5250,1615,86701097.35,755,9040,8285,5631.888545,1988.944183
W12 5250,W12,5250,1614,86647412.46,595,9040,8445,5255.13259,1933.101447
W13 5250,W13,5250,1613,86593727.57,381,8414,8033,5143.081215,1935.199716
W14 5250,W14,5250,1615,86701097.35,381,8878,8497,6452.372136,2071.338999
W15 5250,W15,5250,1614,86647412.46,1304,8878,7574,7005.77881,1619.188554
W16 5250,W16,5250,1613,86593727.57,-503,9486,9989,6904.126472,2022.748378
W17 5250,W17,5250,1612,86540042.68,38,9480,9442,6810.127792,2232.044591
W18 5250,W18,5250,1616,86754782.24,366,9316,8950,7376.680693,1678.907056
W19 5250,W19,5250,1612,86540042.68,210,9749,9539,6600.501241,2393.972473
W20 5250,W20,5250,1616,86754782.24,556,9316,8760,6490.343441,2047.695642
W21 5250,W21,5250,1615,86701097.35,38,9240,9202,6690.882353,2254.885567
W22 5250,W22,5250,1616,86754782.24,-424,8964,9388,4644.730817,2337.033833
W23 5250,W23,5250,1612,86540042.68,349,8964,8615,5927.611042,1849.253572
W24 5250,W24,5250,1613,86593727.57,751,9240,8489,6149.50713,2303.956044
W25 5250,W25,5250,1613,86593727.57,1122,8798,7676,6604.598264,1850.871209
W26 5250,W26,5250,1616,86754782.24,453,9787,9334,4564.769802,2301.243442
W27 5250,W27,5250,1616,86754782.24,1122,8798,7676,6959.914604,1622.296767
W28 5250,W28,5250,1618,86862152.02,572,9102,8530,6586.913473,2124.140954
W29 5250,W29,5250,1615,86701097.35,572,9102,8530,6569.156656,1926.834
W30 5250,W30,5250,1615,86701097.35,3073,8817,5744,7499.09969,935.7251339
W31 5250,W31,5250,1616,86754782.24,6856,9091,2235,8533.134282,328.379691
W32 5250,W32,5250,1616,86754782.24,2002,9227,7225,8326.17203,966.8386392
W33 5250,W33,5250,1613,86593727.57,1829,9151,7322,7641.760074,1445.134349
W34 5250,W34,5250,1610,86432672.9,1873,9261,7388,6642.206211,2034.189473
W35 5250,W35,5250,1615,86701097.35,2171,9102,6931,7603.334985,1401.55418
W36 5250,W36,5250,1616,86754782.24,2033,9134,7101,7532.636757,1521.69837
W37 5250,W37,5250,1616,86754782.24,1489,9134,7645,7270.492574,1883.565069
W38 5250,W38,5250,1611,86486357.79,4885,8902,4017,8528.454997,267.2098396
W39 5250,W39,5250,1617,86808467.13,2961,8856,5895,7846.068027,862.8114386
W40 5250,W40,5250,1611,86486357.79,1509,8996,7487,7038.900683,1851.150582
W41 5250,W41,5250,1616,86754782.24,1290,8815,7525,7136.016089,1440.753404
W42 5250,W42,5250,1615,86701097.35,2640,8996,6356,7747.947368,1123.850397
W43 5250,W43,5250,1614,86647412.46,3375,8963,5588,7501.195167,859.1037214
W44 5250,W44,5250,1616,86754782.24,1883,8939,7056,7283.991337,1407.782391
W45 5250,W45,5250,1616,86754782.24,1683,8835,7152,6879.755569,1645.187768
W46 5250,W46,5250,1614,86647412.46,1525,8878,7353,6712.241636,1936.871305
W47 5250,W47,5250,1615,86701097.35,1596,8839,7243,6806.260681,1764.391572
W48 5250,W48,5250,1618,86862152.02,1936,9269,7333,7804.495056,928.698866
W49 5250,W49,5250,1618,86862152.02,1596,8729,7133,6422.587145,1888.655756
W50 5250,W50,5250,1617,86808467.13,1537,8736,7199,7291.96846,1485.179107
W51 5250,W51,5250,1616,86754782.24,1695,8774,7079,7359.824876,1504.756482
W52 5250,W52,5250,1617,86808467.13,1589,8774,7185,5981.433519,2057.744427
W53 5250,W53,5250,1614,86647412.46,2231,8751,6520,7206.019827,1171.379716
W54 5250,W54,5250,1611,86486357.79,1589,8565,6976,5990.939168,1987.443056
W55 5250,W55,5250,1618,86862152.02,1820,8976,7156,6946.15204,1975.092982
W56 5250,W56,5250,1613,86593727.57,1235,8959,7724,6827.252325,2185.667219
W57 5250,W57,5250,1612,86540042.68,1393,9352,7959,5841.057692,2316.571117
W58 5250,W58,5250,1620,86969521.8,1353,9352,7999,6576.951852,2231.72508
W59 5250,W59,5250,1614,86647412.46,659,9145,8486,4891.262701,2316.702209
W60 5250,W60,5250,1615,86701097.35,911,9191,8280,7293.746749,1697.358715
W61 5250,W61,5250,1611,86486357.79,896,9115,8219,7205.810677,1921.537536
W62 5250,W62,5250,1617,86808467.13,715,9427,8712,5264.866419,2558.248649
W63 5250,W63,5250,1614,86647412.46,-144,9054,9198,3951.032838,2230.637364
W64 5250,W64,5250,1611,86486357.79,1091,9043,7952,6240.345748,2088.798619
W65 5250,W65,5250,1615,86701097.35,659,8679,8020,4424.130031,2456.256523
W66 5250,W66,5250,1613,86593727.57,135,8576,8441,3931.523249,2284.306423
WB_ E1 5250,WB_ E1,5250,1615,86701097.35,130,9272,9142,4300.534365,2596.345518
WB_ E10 5250,WB_ E10,5250,1615,86701097.35,659,9145,8486,4214.109598,2079.27605
WB_ E2 5250,WB_ E2,5250,1613,86593727.57,1117,9043,7926,7139.65902,1700.513237
WB_ E3 5250,WB_ E3,5250,1614,86647412.46,5180,8753,3573,7806.283147,525.0288973
WB_ E4 5250,WB_ E4,5250,1613,86593727.57,1905,9009,7104,7940.915685,1339.781999
WB_ E5 5250,WB_ E5,5250,1614,86647412.46,130,9272,9142,4198.505576,2423.256931
WB_ E6 5250,WB_ E6,5250,1620,86969521.8,3375,9530,6155,7470.217901,860.6162772
WB_ E7 5250,WB_ E7,5250,1616,86754782.24,715,9787,9072,5986.298886,2225.096532
WB_ E8 5250,WB_ E8,5250,1613,86593727.57,1622,9352,7730,6154.83261,2400.37139
WB_ E9 5250,WB_ E9,5250,1624,87184261.36,854,8841,7987,5129.021552,2501.544059
WB_ H1 5250,WB_ H1,5250,1611,86486357.79,1611,8839,7228,7286.61018,1612.592429
WB_ H10 5250,WB_ H10,5250,1616,86754782.24,1525,8878,7353,5765.358911,2087.283127
WB_ H2 5250,WB_ H2,5250,1615,86701097.35,1724,9009,7285,7192.843963,1796.982194
WB_ H3 5250,WB_ H3,5250,1615,86701097.35,896,9261,8365,6170.556037,2233.167794
WB_ H4 5250,WB_ H4,5250,1617,86808467.13,1511,9112,7601,6374.134199,1987.184623
WB_ H5 5250,WB_ H5,5250,1618,86862152.02,1510,8996,7486,5764.508653,2282.378355
WB_ H6 5250,WB_ H6,5250,1617,86808467.13,117,9551,9434,5802.94867,2753.373253
WB_ H7 5250,WB_ H7,5250,1611,86486357.79,-503,9898,10401,6466.048417,2523.517528
WB_ H8 5250,WB_ H8,5250,1617,86808467.13,1142,8888,7746,6450.566481,2132.548613
WB_ H9 5250,WB_ H9,5250,1616,86754782.24,171,9272,9101,5045.29703,2604.324087
WB_ S1 5250,WB_ S1,5250,1611,86486357.79,-283,9431,9714,5116.828678,2807.869625
WB_ S10 5250,WB_ S10,5250,1613,86593727.57,615,9787,9172,4455.944203,2436.567402
WB_ S11 5250,WB_ S11,5250,1616,86754782.24,748,8679,7931,5564.457302,2514.947934
WB_ S12 5250,WB_ S12,5250,1614,86647412.46,659,8939,8280,4898.019207,2274.671414
WB_ S13 5250,WB_ S13,5250,1618,86862152.02,1174,9074,7900,5761.710136,2481.220939
WB_ S14 5250,WB_ S14,5250,1624,87184261.36,1883,8835,6952,7293.700123,1213.242118
WB_ S15 5250,WB_ S15,5250,1613,86593727.57,1525,8878,7353,6879.83075,1828.04346
WB_ S16 5250,WB_ S16,5250,1614,86647412.46,477,8798,8321,5844.520446,2409.713256
WB_ S17 5250,WB_ S17,5250,1612,86540042.68,1528,8875,7347,7546.836849,1135.032051
WB_ S18 5250,WB_ S18,5250,1616,86754782.24,896,9261,8365,6797.516708,2183.341827
WB_ S19 5250,WB_ S19,5250,1614,86647412.46,1894,8894,7000,7062.582404,1770.14817
WB_ S2 5250,WB_ S2,5250,1615,86701097.35,-1001,9531,10532,3853.078638,3655.540012
WB_ S20 5250,WB_ S20,5250,1617,86808467.13,1892,9134,7242,8015.495362,1413.988051
WB_ S21 5250,WB_ S21,5250,1616,86754782.24,2961,8939,5978,7421.14604,1127.127552
WB_ S22 5250,WB_ S22,5250,1617,86808467.13,4017,8963,4946,7663.040816,624.4223083
WB_ S23 5250,WB_ S23,5250,1610,86432672.9,755,9040,8285,6770.52236,1722.562156
WB_ S24 5250,WB_ S24,5250,1617,86808467.13,171,9272,9101,4408.272109,2444.250544
WB_ S25 5250,WB_ S25,5250,1618,86862152.02,1304,8767,7463,7205.18047,1497.594793
WB_ S26 5250,WB_ S26,5250,1614,86647412.46,2002,9227,7225,8059.44052,1196.054929
WB_ S27 5250,WB_ S27,5250,1612,86540042.68,2171,9091,6920,8279.35794,856.3084232
WB_ S28 5250,WB_ S28,5250,1612,86540042.68,2770,9063,6293,7893.191067,924.3556938
WB_ S29 5250,WB_ S29,5250,1613,86593727.57,2319,8920,6601,6974.592064,1198.806413
WB_ S3 5250,WB_ S3,5250,1615,86701097.35,135,8688,8553,5766.345511,2249.133507
WB_ S4 5250,WB_ S4,5250,1616,86754782.24,723,8986,8263,4722.813119,2318.356095
WB_ S5 5250,WB_ S5,5250,1614,86647412.46,1142,8888,7746,5971.439901,2379.420112
WB_ S6 5250,WB_ S6,5250,1616,86754782.24,1511,9112,7601,5993.852723,2060.376689
WB_ S7 5250,WB_ S7,5250,1616,86754782.24,1537,8774,7237,7291.072401,1525.817696
WB_ S8 5250,WB_ S8,5250,1616,86754782.24,441,9749,9308,7264.435644,1802.814772
WB_ S9 5250,WB_ S9,5250,1613,86593727.57,-424,8964,9388,4456.887787,2306.900883
WB_ W1 5250,WB_ W1,5250,1610,86432672.9,755,9040,8285,5683.95528,2001.18347
WB_ W10 5250,WB_ W10,5250,1618,86862152.02,697,8851,8154,5941.451174,2136.785714
WB_ W2 5250,WB_ W2,5250,1612,86540042.68,1060,8906,7846,7471.587469,1384.465175
WB_ W3 5250,WB_ W3,5250,1616,86754782.24,1137,8841,7704,6576.076733,1304.228744
WB_ W4 5250,WB_ W4,5250,1613,86593727.57,1122,8697,7575,6259.487911,1746.350684
WB_ W5 5250,WB_ W5,5250,1624,87184261.36,1117,9017,7900,7541.979064,1127.542977
WB_ W6 5250,WB_ W6,5250,1614,86647412.46,2286,9009,6723,7964.197026,1198.952654
WB_ W7 5250,WB_ W7,5250,1612,86540042.68,-714,9580,10294,5683.626551,3028.304497
WB_ W8 5250,WB_ W8,5250,1615,86701097.35,3105,9009,5904,7374.881734,961.7887226
WB_ W9 5250,WB_ W9,5250,1616,86754782.24,1935,8959,7024,7396.401609,1718.085532
W01 5500,W01,5500,1769,94968570.41,249,9551,9302,6951.011306,1948.364852
W02 5500,W02,5500,1770,95022255.3,395,9266,8871,7631.067232,1281.717884
W03 5500,W03,5500,1769,94968570.41,863,9063,8200,7073.27247,1822.660889
W04 5500,W04,5500,1778,95451734.42,2770,9063,6293,7906.631046,828.9333965
W05 5500,W05,5500,1767,94861200.63,425,8906,8481,7196.06678,1614.67344
W06 5500,W06,5500,1768,94914885.52,1060,9063,8003,7568.003394,1294.637747
W07 5500,W07,5500,1772,95129625.08,863,8885,8022,6409.126975,1650.723262
W08 5500,W08,5500,1768,94914885.52,1724,8991,7267,7426.088235,1580.094635
W09 5500,W09,5500,1769,94968570.41,1724,8920,7196,7609.258903,1199.514372
W10 5500,W10,5500,1770,95022255.3,1724,8981,7257,7503.90904,1658.630919
W11 5500,W11,5500,1767,94861200.63,755,9040,8285,5656.788908,1970.279728
W12 5500,W12,5500,1772,95129625.08,595,9040,8445,5293.119639,1966.636779
W13 5500,W13,5500,1775,95290679.75,381,8414,8033,5172.801127,1972.973427
W14 5500,W14,5500,1771,95075940.19,381,8878,8497,6389.071146,2143.944852
W15 5500,W15,5500,1769,94968570.41,1304,8934,7630,7019.099491,1639.602604
W16 5500,W16,5500,1768,94914885.52,-503,9898,10401,6861.211538,2067.858785
W17 5500,W17,5500,1769,94968570.41,38,9480,9442,6819.824194,2199.945337
W18 5500,W18,5500,1768,94914885.52,38,9316,9278,7335.152149,1732.706189
W19 5500,W19,5500,1776,95344364.64,210,9749,9539,6577.933559,2372.793807
W20 5500,W20,5500,1774,95236994.86,556,9316,8760,6467.49549,2066.530945
W21 5500,W21,5500,1772,95129625.08,38,9240,9202,6715.623025,2218.223122
W22 5500,W22,5500,1777,95398049.53,-424,8964,9388,4595.006753,2343.247257
W23 5500,W23,5500,1771,95075940.19,349,8964,8615,5931.40655,1879.049378
W24 5500,W24,5500,1769,94968570.41,366,9240,8874,6100.763143,2321.47496
W25 5500,W25,5500,1776,95344364.64,1122,8798,7676,6570.88232,1866.600612
W26 5500,W26,5500,1769,94968570.41,199,9787,9588,4624.609949,2310.931736
W27 5500,W27,5500,1766,94807515.74,1122,9447,8325,6888.580974,1685.326324
W28 5500,W28,5500,1773,95183309.97,572,9102,8530,6559.428088,2149.136179
W29 5500,W29,5500,1772,95129625.08,572,9102,8530,6555.30474,1937.368541
W30 5500,W30,5500,1770,95022255.3,1604,8817,7213,7499.081356,967.433411
W31 5500,W31,5500,1776,95344364.64,6856,9091,2235,8542.009572,321.3267285
W32 5500,W32,5500,1770,95022255.3,1624,9227,7603,8292.174576,988.2964013
W33 5500,W33,5500,1769,94968570.41,1117,9151,8034,7570.529678,1518.714946
W34 5500,W34,5500,1769,94968570.41,1873,9261,7388,6680.920859,2001.007099
W35 5500,W35,5500,1768,94914885.52,2171,9102,6931,7630.214367,1388.932971
W36 5500,W36,5500,1770,95022255.3,2033,9134,7101,7493.111864,1580.86448
W37 5500,W37,5500,1773,95183309.97,1489,9134,7645,7302.315285,1890.025013
W38 5500,W38,5500,1772,95129625.08,4885,8902,4017,8520.845937,279.8114015
W39 5500,W39,5500,1777,95398049.53,2961,8856,5895,7854.09229,858.2152598
W40 5500,W40,5500,1772,95129625.08,1509,8996,7487,6974.933973,1923.444971
W41 5500,W41,5500,1772,95129625.08,1290,8815,7525,7076.081264,1517.492193
W42 5500,W42,5500,1775,95290679.75,2640,8996,6356,7772.259718,1095.448382
W43 5500,W43,5500,1777,95398049.53,3375,9530,6155,7538.902645,836.3150469
W44 5500,W44,5500,1775,95290679.75,1883,8939,7056,7264.718873,1420.233656
W45 5500,W45,5500,1772,95129625.08,1683,8835,7152,6908.057562,1637.063781
W46 5500,W46,5500,1769,94968570.41,1525,8878,7353,6651.142453,1975.714403
W47 5500,W47,5500,1773,95183309.97,1596,8839,7243,6831.01128,1751.378871
W48 5500,W48,5500,1774,95236994.86,1936,9269,7333,7771.628523,1013.017487
W49 5500,W49,5500,1776,95344364.64,1537,8729,7192,6459.871622,1880.192649
W50 5500,W50,5500,1774,95236994.86,1537,8736,7199,7304.719842,1496.042037
W51 5500,W51,5500,1772,95129625.08,1417,8774,7357,7265.41535,1605.446081
W52 5500,W52,5500,1771,95075940.19,1589,8774,7185,5999.895539,2047.446911
W53 5500,W53,5500,1774,95236994.86,2067,8751,6684,7121.369222,1272.91727
W54 5500,W54,5500,1771,95075940.19,1589,8565,6976,5943.240542,2042.302921
W55 5500,W55,5500,1778,95451734.42,1820,9145,7325,6948.997188,1984.819375
W56 5500,W56,5500,1770,95022255.3,1235,8959,7724,6797.837288,2165.798657
W57 5500,W57,5500,1771,95075940.19,1393,9352,7959,5925.354037,2305.515919
W58 5500,W58,5500,1778,95451734.42,1353,9352,7999,6492.607424,2264.019545
W59 5500,W59,5500,1777,95398049.53,659,9145,8486,4943.458638,2357.188701
W60 5500,W60,5500,1774,95236994.86,911,9191,8280,7237.910372,1760.129211
W61 5500,W61,5500,1771,95075940.19,896,9115,8219,7128.752117,1979.494539
W62 5500,W62,5500,1770,95022255.3,715,9427,8712,5342.379661,2542.989642
W63 5500,W63,5500,1767,94861200.63,-144,9766,9910,4093.667233,2304.656148
W64 5500,W64,5500,1772,95129625.08,1091,9043,7952,6160.120767,2138.08112
W65 5500,W65,5500,1776,95344364.64,659,8679,8020,4502.744932,2465.453677
W66 5500,W66,5500,1768,94914885.52,135,8576,8441,3994.03224,2288.339139
WB_ E1 5500,WB_ E1,5500,1774,95236994.86,130,9272,9142,4317.348929,2583.469
WB_ E10 5500,WB_ E10,5500,1771,95075940.19,659,9145,8486,4312.277244,2112.013894
WB_ E2 5500,WB_ E2,5500,1772,95129625.08,1117,9043,7926,7016.274266,1844.524206
WB_ E3 5500,WB_ E3,5500,1773,95183309.97,5115,8753,3638,7814.557812,535.9470921
WB_ E4 5500,WB_ E4,5500,1772,95129625.08,1905,9009,7104,7953.85553,1309.314617
WB_ E5 5500,WB_ E5,5500,1776,95344364.64,130,9272,9142,4259.474099,2424.005013
WB_ E6 5500,WB_ E6,5500,1774,95236994.86,3375,9530,6155,7482.833709,841.6524293
WB_ E7 5500,WB_ E7,5500,1769,94968570.41,715,9787,9072,5951.755229,2242.992316
WB_ E8 5500,WB_ E8,5500,1773,95183309.97,1528,9352,7824,6087.58714,2431.109941
WB_ E9 5500,WB_ E9,5500,1783,95720158.87,854,8841,7987,5206.239484,2498.744457
WB_ H1 5500,WB_ H1,5500,1772,95129625.08,1611,8839,7228,7311.140519,1583.267358
WB_ H10 5500,WB_ H10,5500,1770,95022255.3,1525,8878,7353,5819.340678,2074.504561
WB_ H2 5500,WB_ H2,5500,1776,95344364.64,1724,9009,7285,7185.943131,1831.35379
WB_ H3 5500,WB_ H3,5500,1770,95022255.3,896,9261,8365,6197.848588,2260.57807
WB_ H4 5500,WB_ H4,5500,1772,95129625.08,1511,9112,7601,6366.335214,1987.369743
WB_ H5 5500,WB_ H5,5500,1771,95075940.19,1510,8996,7486,5839.521174,2288.625489
WB_ H6 5500,WB_ H6,5500,1772,95129625.08,117,9551,9434,5873.739842,2743.900438
WB_ H7 5500,WB_ H7,5500,1769,94968570.41,-503,9898,10401,6537.456755,2486.197228
WB_ H8 5500,WB_ H8,5500,1770,95022255.3,1142,8941,7799,6468.99661,2116.119967
WB_ H9 5500,WB_ H9,5500,1769,94968570.41,171,9272,9101,5099.66987,2583.79931
WB_ S1 5500,WB_ S1,5500,1769,94968570.41,-283,9431,9714,5306.619559,2793.68822
WB_ S10 5500,WB_ S10,5500,1768,94914885.52,595,9787,9192,4436.315045,2445.361094
WB_ S11 5500,WB_ S11,5500,1767,94861200.63,748,8679,7931,5603.434069,2511.777682
WB_ S12 5500,WB_ S12,5500,1774,95236994.86,659,8939,8280,4899.014656,2325.248674
WB_ S13 5500,WB_ S13,5500,1776,95344364.64,1174,9074,7900,5826.904279,2473.381982
WB_ S14 5500,WB_ S14,5500,1784,95773843.76,1883,8835,6952,7304.061099,1233.589253
WB_ S15 5500,WB_ S15,5500,1772,95129625.08,1525,8878,7353,6822.24605,1880.49226
WB_ S16 5500,WB_ S16,5500,1773,95183309.97,477,8798,8321,5856.293852,2412.475807
WB_ S17 5500,WB_ S17,5500,1772,95129625.08,1140,8875,7735,7520.361738,1200.980139
WB_ S18 5500,WB_ S18,5500,1771,95075940.19,896,9261,8365,6754.223038,2177.018798
WB_ S19 5500,WB_ S19,5500,1773,95183309.97,1894,8894,7000,7093.103215,1759.273112
WB_ S2 5500,WB_ S2,5500,1774,95236994.86,-1001,9531,10532,3795.92841,3631.3392
WB_ S20 5500,WB_ S20,5500,1770,95022255.3,1892,9134,7242,8006.841808,1417.185454
WB_ S21 5500,WB_ S21,5500,1769,94968570.41,2961,8939,5978,7447.508762,1103.575812
WB_ S22 5500,WB_ S22,5500,1775,95290679.75,4017,8963,4946,7657.854648,630.2060734
WB_ S23 5500,WB_ S23,5500,1771,95075940.19,755,9040,8285,6711.954263,1712.027287
WB_ S24 5500,WB_ S24,5500,1770,95022255.3,171,9272,9101,4449.119209,2419.804197
WB_ S25 5500,WB_ S25,5500,1769,94968570.41,1304,8767,7463,7189.629734,1506.360585
WB_ S26 5500,WB_ S26,5500,1773,95183309.97,1624,9227,7603,8033.355894,1232.842498
WB_ S27 5500,WB_ S27,5500,1772,95129625.08,2171,9091,6920,8264.336907,873.2992539
WB_ S28 5500,WB_ S28,5500,1770,95022255.3,2770,9063,6293,7862.89548,933.94824
WB_ S29 5500,WB_ S29,5500,1769,94968570.41,2100,8920,6820,6961.37931,1234.900787
WB_ S3 5500,WB_ S3,5500,1770,95022255.3,135,8688,8553,5758.207345,2262.76222
WB_ S4 5500,WB_ S4,5500,1770,95022255.3,723,8986,8263,4675.49661,2313.296315
WB_ S5 5500,WB_ S5,5500,1778,95451734.42,1142,8888,7746,5971.913386,2393.319526
WB_ S6 5500,WB_ S6,5500,1775,95290679.75,1511,9112,7601,6045.20169,2041.651158
WB_ S7 5500,WB_ S7,5500,1771,95075940.19,1537,8774,7237,7217.702428,1596.203935
WB_ S8 5500,WB_ S8,5500,1768,94914885.52,397,9749,9352,7230.589932,1876.13084
WB_ S9 5500,WB_ S9,5500,1775,95290679.75,-424,8964,9388,4449.164507,2329.345395
WB_ W1 5500,WB_ W1,5500,1769,94968570.41,755,9040,8285,5719.759186,1976.867883
WB_ W10 5500,WB_ W10,5500,1775,95290679.75,697,9043,8346,5908.300845,2158.266245
WB_ W2 5500,WB_ W2,5500,1768,94914885.52,1060,8906,7846,7452.052036,1394.781551
WB_ W3 5500,WB_ W3,5500,1772,95129625.08,988,8841,7853,6534.156885,1362.492237
WB_ W4 5500,WB_ W4,5500,1775,95290679.75,1122,8964,7842,6232.597746,1803.357125
WB_ W5 5500,WB_ W5,5500,1783,95720158.87,1117,9017,7900,7491.450365,1207.799609
WB_ W6 5500,WB_ W6,5500,1770,95022255.3,2281,9009,6728,7919.151977,1248.160281
WB_ W7 5500,WB_ W7,5500,1768,94914885.52,-714,9580,10294,5634.18552,3046.108441
WB_ W8 5500,WB_ W8,5500,1767,94861200.63,2665,9017,6352,7399.800792,980.7320279
WB_ W9 5500,WB_ W9,5500,1773,95183309.97,1934,8972,7038,7373.172025,1732.096263
W01 5750,W01,5750,1930,103611837.7,249,9551,9302,6932.956477,1958.518103
W02 5750,W02,5750,1936,103933947,395,9266,8871,7603.802169,1324.394457
W03 5750,W03,5750,1936,103933947,863,9063,8200,7101.220041,1784.996984
W04 5750,W04,5750,1937,103987631.9,2770,9063,6293,7866.920496,869.4196789
W05 5750,W05,5750,1935,103880262.1,425,8908,8483,7181.178295,1645.020193
W06 5750,W06,5750,1932,103719207.5,1060,9063,8003,7506.032091,1361.02127
W07 5750,W07,5750,1933,103772892.4,863,8934,8071,6388.273151,1672.501183
W08 5750,W08,5750,1932,103719207.5,1724,8991,7267,7447.592133,1557.249763
W09 5750,W09,5750,1930,103611837.7,1724,8920,7196,7521.07513,1292.697897
W10 5750,W10,5750,1939,104095001.7,1724,8981,7257,7470.415678,1660.544294
W11 5750,W11,5750,1931,103665522.6,755,9040,8285,5688.122216,1959.362538
W12 5750,W12,5750,1934,103826577.3,495,9116,8621,5328.886763,2018.659442
W13 5750,W13,5750,1936,103933947,381,8414,8033,5204.818182,1997.317141
W14 5750,W14,5750,1937,103987631.9,381,8878,8497,6333.567372,2186.792267
W15 5750,W15,5750,1930,103611837.7,1121,8934,7813,7003.910881,1680.118552
W16 5750,W16,5750,1931,103665522.6,-503,9898,10401,6818.684619,2108.086066
W17 5750,W17,5750,1934,103826577.3,38,9480,9442,6830.470527,2175.500418
W18 5750,W18,5750,1938,104041316.8,38,9316,9278,7283.022188,1781.772243
W19 5750,W19,5750,1940,104148686.6,210,9749,9539,6568.60567,2354.949369
W20 5750,W20,5750,1939,104095001.7,397,9316,8919,6448.510572,2087.325926
W21 5750,W21,5750,1934,103826577.3,38,9316,9278,6739.249741,2188.581059
W22 5750,W22,5750,1939,104095001.7,-424,8964,9388,4574.677669,2363.448346
W23 5750,W23,5750,1934,103826577.3,349,8964,8615,5937.736298,1911.674875
W24 5750,W24,5750,1932,103719207.5,357,9240,8883,6073.606625,2336.710245
W25 5750,W25,5750,1938,104041316.8,1122,8798,7676,6525.44324,1894.759554
W26 5750,W26,5750,1938,104041316.8,-287,9787,10074,4705.844169,2336.300356
W27 5750,W27,5750,1931,103665522.6,1122,9447,8325,6774.995339,1786.563987
W28 5750,W28,5750,1936,103933947,572,9102,8530,6554.909607,2142.373563
W29 5750,W29,5750,1936,103933947,572,9102,8530,6547.551136,1934.610106
W30 5750,W30,5750,1935,103880262.1,1528,8817,7289,7491.482171,1018.426199
W31 5750,W31,5750,1943,104309741.3,6856,9091,2235,8546.886258,316.0602119
W32 5750,W32,5750,1932,103719207.5,1621,9227,7606,8239.296584,1047.034444
W33 5750,W33,5750,1935,103880262.1,1117,9151,8034,7523.709044,1554.368546
W34 5750,W34,5750,1932,103719207.5,1873,9261,7388,6716.150621,1976.110628
W35 5750,W35,5750,1932,103719207.5,2171,9102,6931,7665.627329,1378.22644
W36 5750,W36,5750,1930,103611837.7,1892,9134,7242,7446.401554,1651.860279
W37 5750,W37,5750,1940,104148686.6,1414,9134,7720,7337.891753,1882.227981
W38 5750,W38,5750,1933,103772892.4,4885,8902,4017,8509.312468,295.3471878
W39 5750,W39,5750,1942,104256056.4,2961,8856,5895,7852.304325,865.4541598
W40 5750,W40,5750,1940,104148686.6,1509,8996,7487,6904.102062,2005.034564
W41 5750,W41,5750,1939,104095001.7,1290,8876,7586,7015.669933,1586.855954
W42 5750,W42,5750,1940,104148686.6,2640,8996,6356,7795.087113,1066.216726
W43 5750,W43,5750,1941,104202371.5,3375,9530,6155,7564.337455,819.1657095
W44 5750,W44,5750,1938,104041316.8,1850,8939,7089,7238.609907,1433.712146
W45 5750,W45,5750,1938,104041316.8,1683,8835,7152,6923.99742,1635.566187
W46 5750,W46,5750,1937,103987631.9,1525,8878,7353,6628.043366,1983.434306
W47 5750,W47,5750,1938,104041316.8,1596,8839,7243,6828.44324,1770.483591
W48 5750,W48,5750,1936,103933947,1936,9269,7333,7737.629649,1075.058467
W49 5750,W49,5750,1944,104363426.2,1537,9269,7732,6518.909465,1871.799588
W50 5750,W50,5750,1939,104095001.7,1537,8800,7263,7334.154719,1491.44147
W51 5750,W51,5750,1939,104095001.7,1417,8858,7441,7181.350181,1689.553011
W52 5750,W52,5750,1940,104148686.6,1589,8774,7185,6035.681443,2025.280872
W53 5750,W53,5750,1938,104041316.8,1640,8751,7111,7031.21517,1381.325404
W54 5750,W54,5750,1937,103987631.9,1589,8565,6976,5891.602478,2081.146826
W55 5750,W55,5750,1941,104202371.5,1820,9145,7325,6940.950026,2015.052467
W56 5750,W56,5750,1936,103933947,1235,8959,7724,6771.303202,2147.234983
W57 5750,W57,5750,1938,104041316.8,1393,9352,7959,5993.294634,2305.903716
W58 5750,W58,5750,1941,104202371.5,1150,9352,8202,6415.062339,2286.815403
W59 5750,W59,5750,1940,104148686.6,659,9145,8486,4962.597423,2385.197398
W60 5750,W60,5750,1939,104095001.7,911,9191,8280,7194.861784,1796.452324
W61 5750,W61,5750,1937,103987631.9,896,9115,8219,7058.133196,2018.715032
W62 5750,W62,5750,1938,104041316.8,715,9787,9072,5439.437049,2519.830291
W63 5750,W63,5750,1931,103665522.6,-144,9766,9910,4242.267219,2364.829422
W64 5750,W64,5750,1932,103719207.5,1091,9043,7952,6103.36646,2184.638652
W65 5750,W65,5750,1942,104256056.4,659,8679,8020,4578.240989,2470.955308
W66 5750,W66,5750,1939,104095001.7,135,8688,8553,4063.89015,2295.870268
WB_ E1 5750,WB_ E1,5750,1942,104256056.4,130,9272,9142,4327.436148,2558.034894
WB_ E10 5750,WB_ E10,5750,1935,103880262.1,659,9145,8486,4396.704393,2142.097448
WB_ E2 5750,WB_ E2,5750,1934,103826577.3,1117,9043,7926,6910.97001,1952.397686
WB_ E3 5750,WB_ E3,5750,1945,104417111,5115,8753,3638,7805.186632,540.4594614
WB_ E4 5750,WB_ E4,5750,1936,103933947,1905,9009,7104,7961.779442,1279.597329
WB_ E5 5750,WB_ E5,5750,1938,104041316.8,130,9272,9142,4332.579463,2435.302217
WB_ E6 5750,WB_ E6,5750,1939,104095001.7,3375,9530,6155,7505.722537,821.3182151
WB_ E7 5750,WB_ E7,5750,1938,104041316.8,715,9787,9072,5919.341073,2254.507505
WB_ E8 5750,WB_ E8,5750,1941,104202371.5,1510,9352,7842,6029.022669,2439.948474
WB_ E9 5750,WB_ E9,5750,1940,104148686.6,854,8841,7987,5273.993814,2494.302969
WB_ H1 5750,WB_ H1,5750,1933,103772892.4,1611,8878,7267,7316.326436,1571.216539
WB_ H10 5750,WB_ H10,5750,1935,103880262.1,1525,8878,7353,5871.915245,2077.36359
WB_ H2 5750,WB_ H2,5750,1941,104202371.5,1724,9009,7285,7205.976301,1840.323781
WB_ H3 5750,WB_ H3,5750,1929,103558152.8,896,9261,8365,6252.307932,2280.245509
WB_ H4 5750,WB_ H4,5750,1940,104148686.6,1511,9112,7601,6381.981959,1969.004741
WB_ H5 5750,WB_ H5,5750,1940,104148686.6,1510,8996,7486,5914.594845,2278.449279
WB_ H6 5750,WB_ H6,5750,1936,103933947,117,9551,9434,5924.131715,2738.891822
WB_ H7 5750,WB_ H7,5750,1937,103987631.9,-503,9898,10401,6590.471347,2456.970926
WB_ H8 5750,WB_ H8,5750,1932,103719207.5,1142,8941,7799,6460.085921,2102.25902
WB_ H9 5750,WB_ H9,5750,1938,104041316.8,171,9272,9101,5148.457172,2563.739689
WB_ S1 5750,WB_ S1,5750,1928,103504467.9,-283,9431,9714,5466.145228,2772.772234
WB_ S10 5750,WB_ S10,5750,1931,103665522.6,493,9787,9294,4429.147074,2449.575073
WB_ S11 5750,WB_ S11,5750,1935,103880262.1,748,8679,7931,5649.998966,2512.997961
WB_ S12 5750,WB_ S12,5750,1942,104256056.4,659,8939,8280,4895.717302,2370.081431
WB_ S13 5750,WB_ S13,5750,1942,104256056.4,1174,9074,7900,5870.288363,2450.130543
WB_ S14 5750,WB_ S14,5750,1942,104256056.4,1683,8835,7152,7322.833162,1246.023657
WB_ S15 5750,WB_ S15,5750,1934,103826577.3,1525,8878,7353,6785.376422,1906.455672
WB_ S16 5750,WB_ S16,5750,1941,104202371.5,477,8798,8321,5839.847501,2424.808051
WB_ S17 5750,WB_ S17,5750,1939,104095001.7,1140,8968,7828,7483.097989,1256.731564
WB_ S18 5750,WB_ S18,5750,1938,104041316.8,896,9261,8365,6709.69453,2179.590071
WB_ S19 5750,WB_ S19,5750,1940,104148686.6,1894,8894,7000,7113.676804,1752.916543
WB_ S2 5750,WB_ S2,5750,1940,104148686.6,-1001,9580,10581,3799.729897,3608.722785
WB_ S20 5750,WB_ S20,5750,1938,104041316.8,1892,9134,7242,8004.772446,1411.531993
WB_ S21 5750,WB_ S21,5750,1934,103826577.3,2961,8939,5978,7475.282834,1079.048078
WB_ S22 5750,WB_ S22,5750,1942,104256056.4,4017,8963,4946,7653.84552,639.3914813
WB_ S23 5750,WB_ S23,5750,1936,103933947,755,9040,8285,6636.941632,1726.151202
WB_ S24 5750,WB_ S24,5750,1938,104041316.8,130,9272,9142,4506.130547,2402.900633
WB_ S25 5750,WB_ S25,5750,1938,104041316.8,1304,8767,7463,7178.174407,1508.091382
WB_ S26 5750,WB_ S26,5750,1938,104041316.8,1624,9227,7603,8011.544376,1253.874943
WB_ S27 5750,WB_ S27,5750,1940,104148686.6,2171,9091,6920,8267.368041,874.3547409
WB_ S28 5750,WB_ S28,5750,1929,103558152.8,2770,9063,6293,7818.81182,965.9699844
WB_ S29 5750,WB_ S29,5750,1933,103772892.4,2100,8920,6820,6941.506984,1269.147826
WB_ S3 5750,WB_ S3,5750,1931,103665522.6,135,8688,8553,5757.160021,2280.509583
WB_ S4 5750,WB_ S4,5750,1941,104202371.5,289,8986,8697,4615.72746,2336.246335
WB_ S5 5750,WB_ S5,5750,1942,104256056.4,994,8888,7894,5950.762101,2410.712875
WB_ S6 5750,WB_ S6,5750,1941,104202371.5,1511,9112,7601,6092.749098,2023.110008
WB_ S7 5750,WB_ S7,5750,1935,103880262.1,1537,8774,7237,7146.562791,1665.118317
WB_ S8 5750,WB_ S8,5750,1938,104041316.8,346,9749,9403,7207.903509,1927.101741
WB_ S9 5750,WB_ S9,5750,1939,104095001.7,-424,8964,9388,4450.249097,2340.946698
WB_ W1 5750,WB_ W1,5750,1933,103772892.4,755,9040,8285,5748.919814,1949.531035
WB_ W10 5750,WB_ W10,5750,1937,103987631.9,460,9181,8721,5875.747031,2182.053778
WB_ W2 5750,WB_ W2,5750,1937,103987631.9,1060,8906,7846,7432.951988,1408.8631
WB_ W3 5750,WB_ W3,5750,1937,103987631.9,863,8841,7978,6481.955601,1434.9089
WB_ W4 5750,WB_ W4,5750,1939,104095001.7,1077,8964,7887,6206.53739,1833.72547
WB_ W5 5750,WB_ W5,5750,1939,104095001.7,1117,9017,7900,7447.439402,1272.652948
WB_ W6 5750,WB_ W6,5750,1939,104095001.7,1905,9009,7104,7875.231047,1283.299065
WB_ W7 5750,WB_ W7,5750,1928,103504467.9,-714,9580,10294,5607.547718,3046.338863
WB_ W8 5750,WB_ W8,5750,1934,103826577.3,2253,9017,6764,7418.754912,1002.950583
WB_ W9 5750,WB_ W9,5750,1940,104148686.6,1489,8972,7483,7353.562371,1745.615169
W01 6000,W01,6000,2108,113167748.1,249,9551,9302,6907.731025,1979.970853
W02 6000,W02,6000,2109,113221433,395,9266,8871,7574.159791,1365.642048
W03 6000,W03,6000,2104,112953008.6,863,9063,8200,7129.379278,1746.426849
W04 6000,W04,6000,2114,113489857.5,1261,9063,7802,7821.550615,930.6649633
W05 6000,W05,6000,2108,113167748.1,425,8908,8483,7183.436433,1654.904956
W06 6000,W06,6000,2104,112953008.6,1060,9063,8003,7486.029943,1379.992891
W07 6000,W07,6000,2104,112953008.6,863,8934,8071,6373.677281,1684.337561
W08 6000,W08,6000,2104,112953008.6,1724,8991,7267,7443.238118,1557.573778
W09 6000,W09,6000,2109,113221433,1724,8934,7210,7438.226648,1375.584233
W10 6000,W10,6000,2109,113221433,1724,8981,7257,7405.018966,1698.250636
W11 6000,W11,6000,2104,112953008.6,755,9040,8285,5716.379278,1938.519904
W12 6000,W12,6000,2108,113167748.1,421,9272,8851,5356.328273,2063.069453
W13 6000,W13,6000,2114,113489857.5,381,8452,8071,5212.067644,2023.763898
W14 6000,W14,6000,2107,113114063.2,381,8878,8497,6278.798766,2227.210493
W15 6000,W15,6000,2107,113114063.2,726,8934,8208,6987.853821,1731.790656
W16 6000,W16,6000,2110,113275117.9,-503,9898,10401,6765.364455,2160.215349
W17 6000,W17,6000,2109,113221433,38,9480,9442,6829.857278,2171.852711
W18 6000,W18,6000,2106,113060378.3,38,9316,9278,7231.190408,1840.08286
W19 6000,W19,6000,2108,113167748.1,210,9749,9539,6554.610531,2335.969703
W20 6000,W20,6000,2115,113543542.4,210,9316,9106,6434.123404,2116.988363
W21 6000,W21,6000,2107,113114063.2,38,9316,9278,6763.761272,2154.296391
W22 6000,W22,6000,2114,113489857.5,-424,8964,9388,4562.909177,2399.587421
W23 6000,W23,6000,2105,113006693.4,349,8964,8615,5928.868409,1936.21748
W24 6000,W24,6000,2108,113167748.1,357,9240,8883,6037.263283,2339.69744
W25 6000,W25,6000,2108,113167748.1,957,8798,7841,6461.8074,1942.463073
W26 6000,W26,6000,2107,113114063.2,-424,9787,10211,4762.202183,2363.272686
W27 6000,W27,6000,2104,112953008.6,1028,9447,8419,6682.13403,1856.459401
W28 6000,W28,6000,2108,113167748.1,572,9102,8530,6583.00759,2120.392245
W29 6000,W29,6000,2107,113114063.2,572,9102,8530,6550.381585,1934.809922
W30 6000,W30,6000,2106,113060378.3,1528,8865,7337,7479.731719,1064.462983
W31 6000,W31,6000,2112,113382487.7,6856,9091,2235,8547.182765,317.3346425
W32 6000,W32,6000,2104,112953008.6,1621,9227,7606,8186.292776,1111.116093
W33 6000,W33,6000,2108,113167748.1,1117,9206,8089,7498.37334,1567.51237
W34 6000,W34,6000,2104,112953008.6,1873,9261,7388,6718.400665,1969.075201
W35 6000,W35,6000,2104,112953008.6,2171,9102,6931,7690.934411,1379.066002
W36 6000,W36,6000,2109,113221433,1892,9134,7242,7403.080607,1712.615911
W37 6000,W37,6000,2112,113382487.7,1414,9134,7720,7393.147727,1854.063616
W38 6000,W38,6000,2101,112791953.9,4885,8946,4061,8494.175155,315.1900174
W39 6000,W39,6000,2115,113543542.4,2961,8856,5895,7850.436407,871.5317166
W40 6000,W40,6000,2113,113436172.6,1509,8996,7487,6846.902982,2063.865138
W41 6000,W41,6000,2111,113328802.8,1290,8876,7586,6965.460445,1623.417993
W42 6000,W42,6000,2112,113382487.7,2640,8996,6356,7805.162879,1042.21135
W43 6000,W43,6000,2112,113382487.7,3375,9530,6155,7588.366951,806.7028522
W44 6000,W44,6000,2108,113167748.1,1683,8939,7256,7218.686907,1446.728782
W45 6000,W45,6000,2107,113114063.2,1683,8835,7152,6953.44186,1631.929285
W46 6000,W46,6000,2114,113489857.5,1525,8878,7353,6602.547777,1988.976009
W47 6000,W47,6000,2115,113543542.3,1596,8839,7243,6813.464303,1806.554801
W48 6000,W48,6000,2112,113382487.7,1936,9269,7333,7709.948864,1120.903844
W49 6000,W49,6000,2116,113597227.2,1537,9269,7732,6570.029773,1859.803643
W50 6000,W50,6000,2111,113328802.8,1537,8872,7335,7352.201326,1502.219982
W51 6000,W51,6000,2111,113328802.8,1417,8858,7441,7114.978209,1745.779751
W52 6000,W52,6000,2108,113167748.1,1589,8774,7185,6073.058824,2000.26488
W53 6000,W53,6000,2112,113382487.7,1525,8751,7226,6925.450284,1519.049836
W54 6000,W54,6000,2102,112845638.8,1589,8565,6976,5880.487631,2083.693516
W55 6000,W55,6000,2115,113543542.4,1342,9145,7803,6930.423168,2036.668376
W56 6000,W56,6000,2110,113275117.9,1235,8959,7724,6744.475829,2130.050853
W57 6000,W57,6000,2109,113221433,990,9352,8362,6019.785206,2305.698701
W58 6000,W58,6000,2116,113597227.2,1150,9352,8202,6332.258507,2303.891681
W59 6000,W59,6000,2110,113275117.9,659,9145,8486,4987.756872,2410.758034
W60 6000,W60,6000,2110,113275117.9,911,9191,8280,7164.601896,1819.854435
W61 6000,W61,6000,2108,113167748.1,896,9115,8219,7018.901803,2027.303458
W62 6000,W62,6000,2105,113006693.5,715,9787,9072,5502.717815,2497.492551
W63 6000,W63,6000,2106,113060378.3,-144,9766,9910,4367.556505,2414.620083
W64 6000,W64,6000,2100,112738269,1091,9043,7952,6049.079524,2233.104006
W65 6000,W65,6000,2111,113328802.8,659,8679,8020,4642.558977,2471.845457
W66 6000,W66,6000,2112,113382487.7,135,8688,8553,4148.866004,2314.949821
WB_ E1 6000,WB_ E1,6000,2109,113221433,130,9272,9142,4340.234708,2534.629921
WB_ E10 6000,WB_ E10,6000,2109,113221433,659,9145,8486,4468.144144,2178.933223
WB_ E2 6000,WB_ E2,6000,2107,113114063.2,1092,9043,7951,6796.594684,2056.269547
WB_ E3 6000,WB_ E3,6000,2114,113489857.5,5115,8753,3638,7793.798013,549.1350508
WB_ E4 6000,WB_ E4,6000,2110,113275117.9,1905,9009,7104,7975.277725,1247.430306
WB_ E5 6000,WB_ E5,6000,2110,113275117.9,130,9272,9142,4389.459716,2443.553732
WB_ E6 6000,WB_ E6,6000,2110,113275117.9,3375,9530,6155,7524.996682,799.6652401
WB_ E7 6000,WB_ E7,6000,2108,113167748.1,715,9787,9072,5906.689279,2266.343603
WB_ E8 6000,WB_ E8,6000,2112,113382487.7,1510,9352,7842,5987.328125,2447.115064
WB_ E9 6000,WB_ E9,6000,2115,113543542.4,854,8841,7987,5366.956974,2483.505895
WB_ H1 6000,WB_ H1,6000,2104,112953008.6,1611,8878,7267,7299.864068,1587.200618
WB_ H10 6000,WB_ H10,6000,2110,113275117.9,1525,8878,7353,5931.077725,2066.101705
WB_ H2 6000,WB_ H2,6000,2115,113543542.3,1724,9009,7285,7213.096927,1841.953652
WB_ H3 6000,WB_ H3,6000,2106,113060378.3,896,9261,8365,6323.937322,2290.016355
WB_ H4 6000,WB_ H4,6000,2111,113328802.8,1511,9112,7601,6403.750829,1949.059429
WB_ H5 6000,WB_ H5,6000,2108,113167748.1,1510,8996,7486,5970.167457,2278.407827
WB_ H6 6000,WB_ H6,6000,2104,112953008.6,117,9551,9434,5972.818441,2724.423411
WB_ H7 6000,WB_ H7,6000,2112,113382487.7,-503,9898,10401,6627.241004,2436.308641
WB_ H8 6000,WB_ H8,6000,2110,113275117.9,1142,8941,7799,6412.516114,2118.434446
WB_ H9 6000,WB_ H9,6000,2102,112845638.8,171,9272,9101,5175.211227,2553.517129
WB_ S1 6000,WB_ S1,6000,2103,112899323.7,-283,9580,9863,5620.422254,2742.086703
WB_ S10 6000,WB_ S10,6000,2110,113275117.9,493,9787,9294,4427.67109,2452.156423
WB_ S11 6000,WB_ S11,6000,2106,113060378.3,748,8679,7931,5664.846629,2510.487395
WB_ S12 6000,WB_ S12,6000,2116,113597227.2,659,9237,8578,4965.01465,2410.961988
WB_ S13 6000,WB_ S13,6000,2112,113382487.7,1174,9074,7900,5883.863636,2432.360022
WB_ S14 6000,WB_ S14,6000,2114,113489857.5,1683,8835,7152,7328.758278,1268.291964
WB_ S15 6000,WB_ S15,6000,2102,112845638.8,1525,8878,7353,6756.519981,1932.457234
WB_ S16 6000,WB_ S16,6000,2111,113328802.8,477,8798,8321,5856.530554,2419.134218
WB_ S17 6000,WB_ S17,6000,2113,113436172.6,1052,8968,7916,7453.355892,1306.462092
WB_ S18 6000,WB_ S18,6000,2108,113167748.1,896,9261,8365,6637.198292,2206.750588
WB_ S19 6000,WB_ S19,6000,2111,113328802.8,1894,8894,7000,7144.537186,1747.434499
WB_ S2 6000,WB_ S2,6000,2116,113597227.2,-1001,9580,10581,3783.965501,3587.421068
WB_ S20 6000,WB_ S20,6000,2107,113114063.2,1892,9134,7242,7989.744661,1409.37516
WB_ S21 6000,WB_ S21,6000,2104,112953008.6,2961,8939,5978,7503.54135,1054.230496
WB_ S22 6000,WB_ S22,6000,2108,113167748.1,3375,8963,5588,7653.023245,657.3653049
WB_ S23 6000,WB_ S23,6000,2108,113167748.1,755,9040,8285,6588.220588,1734.147355
WB_ S24 6000,WB_ S24,6000,2103,112899323.7,130,9272,9142,4573.029957,2391.377793
WB_ S25 6000,WB_ S25,6000,2108,113167748.1,1304,8767,7463,7174.208729,1498.572721
WB_ S26 6000,WB_ S26,6000,2111,113328802.8,1621,9227,7606,7984.986736,1289.655389
WB_ S27 6000,WB_ S27,6000,2110,113275117.9,2171,9102,6931,8273.914218,862.7893104
WB_ S28 6000,WB_ S28,6000,2108,113167748.1,2219,9063,6844,7758.486717,1038.242859
WB_ S29 6000,WB_ S29,6000,2109,113221433,2100,8920,6820,6934.607397,1290.50603
WB_ S3 6000,WB_ S3,6000,2109,113221433,135,8742,8607,5763.803698,2296.447603
WB_ S4 6000,WB_ S4,6000,2107,113114063.2,289,8986,8697,4558.416232,2371.221173
WB_ S5 6000,WB_ S5,6000,2113,113436172.6,994,8888,7894,5946.486512,2420.87361
WB_ S6 6000,WB_ S6,6000,2112,113382487.7,1511,9112,7601,6138.278883,2009.30217
WB_ S7 6000,WB_ S7,6000,2109,113221433,1537,8774,7237,7074.008061,1721.60263
WB_ S8 6000,WB_ S8,6000,2104,112953008.6,307,9749,9442,7163.114544,1980.026888
WB_ S9 6000,WB_ S9,6000,2111,113328802.8,-617,8964,9581,4425.187115,2353.269931
WB_ W1 6000,WB_ W1,6000,2099,112684584.1,755,9040,8285,5782.000953,1931.553835
WB_ W10 6000,WB_ W10,6000,2109,113221433,460,9181,8721,5847.588431,2216.443173
WB_ W2 6000,WB_ W2,6000,2111,113328802.8,1060,8906,7846,7423.309806,1408.082069
WB_ W3 6000,WB_ W3,6000,2106,113060378.3,863,8841,7978,6444.108737,1492.402417
WB_ W4 6000,WB_ W4,6000,2112,113382487.7,1077,8964,7887,6200.154356,1853.745126
WB_ W5 6000,WB_ W5,6000,2109,113221433,1117,9017,7900,7417.398767,1308.718077
WB_ W6 6000,WB_ W6,6000,2106,113060378.3,1905,9009,7104,7842.94397,1308.370605
WB_ W7 6000,WB_ W7,6000,2103,112899323.7,-714,9580,10294,5609.921065,3026.515361
WB_ W8 6000,WB_ W8,6000,2106,113060378.3,2253,9131,6878,7418.447293,1051.336163
WB_ W9 6000,WB_ W9,6000,2107,113114063.2,1489,8972,7483,7319.607973,1776.306859
W01 6250,W01,6250,2284,122616288.8,249,9551,9302,6906.907618,1987.456571
W02 6250,W02,6250,2288,122831028.3,395,9266,8871,7553.489948,1383.548663
W03 6250,W03,6250,2289,122884713.2,863,9063,8200,7154.570992,1709.260669
W04 6250,W04,6250,2289,122884713.2,395,9063,8668,7775.032765,1003.595456
W05 6250,W05,6250,2289,122884713.2,425,8908,8483,7184.456531,1665.093301
W06 6250,W06,6250,2279,122347864.3,1060,9063,8003,7469.074594,1385.977022
W07 6250,W07,6250,2283,122562603.9,863,9063,8200,6362.8318,1691.83249
W08 6250,W08,6250,2279,122347864.3,1724,8991,7267,7430.924528,1562.41626
W09 6250,W09,6250,2285,122669973.7,1724,8934,7210,7377.143545,1412.051666
W10 6250,W10,6250,2290,122938398.1,1724,8981,7257,7354.003493,1731.957746
W11 6250,W11,6250,2279,122347864.3,755,9040,8285,5737.779289,1925.091901
W12 6250,W12,6250,2281,122455234.1,365,9272,8907,5360.463393,2118.05756
W13 6250,W13,6250,2288,122831028.3,381,8452,8071,5243.408217,2045.20834
W14 6250,W14,6250,2288,122831028.3,381,8878,8497,6221.710227,2265.279419
W15 6250,W15,6250,2288,122831028.3,726,8934,8208,6943.89729,1802.932762
W16 6250,W16,6250,2286,122723658.5,-503,9898,10401,6717.688539,2188.571016
W17 6250,W17,6250,2290,122938398.1,38,9480,9442,6852.976856,2162.880175
W18 6250,W18,6250,2289,122884713.2,38,9316,9278,7180.619484,1870.89919
W19 6250,W19,6250,2289,122884713.2,210,9749,9539,6550.250765,2319.73134
W20 6250,W20,6250,2290,122938398.1,210,9316,9106,6422.040611,2144.231362
W21 6250,W21,6250,2280,122401549.2,38,9316,9278,6779.555263,2128.527233
W22 6250,W22,6250,2292,123045767.9,-617,8964,9581,4577.724695,2430.936943
W23 6250,W23,6250,2281,122455234.1,349,8964,8615,5938.533538,1958.978651
W24 6250,W24,6250,2288,122831028.3,357,9240,8883,6024.069493,2333.394306
W25 6250,W25,6250,2289,122884713.2,751,8798,8047,6412.201835,1976.995572
W26 6250,W26,6250,2289,122884713.2,-424,9787,10211,4827.215378,2405.485286
W27 6250,W27,6250,2282,122508919,1026,9447,8421,6574.001753,1939.673598
W28 6250,W28,6250,2283,122562603.9,572,9102,8530,6613.740692,2097.252789
W29 6250,W29,6250,2287,122777343.4,572,9102,8530,6567.940096,1931.818506
W30 6250,W30,6250,2282,122508919,1140,8914,7774,7465.286591,1114.957976
W31 6250,W31,6250,2293,123099452.8,4832,9110,4278,8542.918447,337.9701908
W32 6250,W32,6250,2278,122294179.4,1621,9227,7606,8134.918349,1174.719719
W33 6250,W33,6250,2287,122777343.4,1117,9206,8089,7481.686926,1571.17667
W34 6250,W34,6250,2286,122723658.5,1237,9261,8024,6712.237095,1986.131026
W35 6250,W35,6250,2279,122347864.3,2171,9102,6931,7704.016674,1389.857138
W36 6250,W36,6250,2284,122616288.8,1892,9134,7242,7365.377408,1752.259543
W37 6250,W37,6250,2292,123045767.9,1414,9134,7720,7452.280977,1824.259056
W38 6250,W38,6250,2286,122723658.5,4885,8946,4061,8472.379703,354.7771696
W39 6250,W39,6250,2293,123099452.8,2961,8856,5895,7844.244658,889.8705511
W40 6250,W40,6250,2293,123099452.8,1414,8996,7582,6787.35543,2117.518733
W41 6250,W41,6250,2291,122992083,1174,8876,7702,6910.324313,1665.40965
W42 6250,W42,6250,2292,123045767.9,2640,8996,6356,7805.800611,1026.443218
W43 6250,W43,6250,2293,123099452.8,3375,9530,6155,7607.78587,787.6224642
W44 6250,W44,6250,2290,122938398.1,1683,8939,7256,7191.008734,1467.766519
W45 6250,W45,6250,2284,122616288.8,1683,8939,7256,6978.430823,1626.435437
W46 6250,W46,6250,2289,122884713.2,1525,8878,7353,6602.349934,1993.559811
W47 6250,W47,6250,2292,123045767.9,1568,8839,7271,6804.983857,1844.108705
W48 6250,W48,6250,2288,122831028.3,1936,9269,7333,7693.167832,1148.779012
W49 6250,W49,6250,2293,123099452.8,1537,9269,7732,6628.776712,1849.622098
W50 6250,W50,6250,2292,123045767.9,1537,8872,7335,7365.566318,1505.8462
W51 6250,W51,6250,2287,122777343.4,1417,8858,7441,7044.04941,1811.968974
W52 6250,W52,6250,2293,123099452.8,1589,8774,7185,6118.16703,1976.351961
W53 6250,W53,6250,2292,123045767.9,1523,8751,7228,6821.940663,1644.604715
W54 6250,W54,6250,2289,122884713.2,1511,8565,7054,5855.684142,2082.217429
W55 6250,W55,6250,2289,122884713.2,1342,9145,7803,6925.978156,2041.998004
W56 6250,W56,6250,2289,122884713.2,1235,8959,7724,6724.229795,2121.775828
W57 6250,W57,6250,2291,122992083,990,9352,8362,6022.351375,2312.9811
W58 6250,W58,6250,2297,123314192.3,1150,9352,8202,6256.180235,2318.883453
W59 6250,W59,6250,2291,122992083,659,9145,8486,4993.132257,2421.589783
W60 6250,W60,6250,2288,122831028.3,911,9191,8280,7139.772727,1845.685917
W61 6250,W61,6250,2287,122777343.4,896,9115,8219,6996.813293,2024.132241
W62 6250,W62,6250,2289,122884713.2,715,9787,9072,5562.631717,2491.567557
W63 6250,W63,6250,2283,122562603.9,-144,9766,9910,4472.640385,2442.496684
W64 6250,W64,6250,2285,122669973.7,1017,9043,8026,5984.370241,2278.042483
W65 6250,W65,6250,2292,123045767.9,460,8679,8219,4706.929756,2476.120128
W66 6250,W66,6250,2291,122992083,135,8688,8553,4242.862069,2332.690301
WB_ E1 6250,WB_ E1,6250,2292,123045767.9,130,9272,9142,4360.49171,2526.690891
WB_ E10 6250,WB_ E10,6250,2288,122831028.3,659,9145,8486,4541.244318,2209.145801
WB_ E2 6250,WB_ E2,6250,2282,122508919,1092,9043,7951,6707.185802,2123.760499
WB_ E3 6250,WB_ E3,6250,2292,123045767.9,5115,8945,3830,7787.262653,554.5932718
WB_ E4 6250,WB_ E4,6250,2286,122723658.5,1905,9009,7104,7980.993438,1222.892668
WB_ E5 6250,WB_ E5,6250,2290,122938398.1,130,9272,9142,4479.729258,2445.27895
WB_ E6 6250,WB_ E6,6250,2291,122992083,3375,9530,6155,7543.051506,779.1487419
WB_ E7 6250,WB_ E7,6250,2289,122884713.2,715,9787,9072,5900.19135,2272.592549
WB_ E8 6250,WB_ E8,6250,2294,123153137.7,1510,9352,7842,5966.149956,2435.355213
WB_ E9 6250,WB_ E9,6250,2292,123045767.9,854,8841,7987,5449.372164,2468.55656
WB_ H1 6250,WB_ H1,6250,2289,122884713.2,1611,8878,7267,7263.340323,1633.869947
WB_ H10 6250,WB_ H10,6250,2285,122669973.7,1525,8878,7353,5990.293654,2059.201436
WB_ H2 6250,WB_ H2,6250,2293,123099452.8,1724,9009,7285,7246.605757,1824.497178
WB_ H3 6250,WB_ H3,6250,2284,122616288.8,896,9261,8365,6401.78634,2296.437501
WB_ H4 6250,WB_ H4,6250,2291,122992083,1511,9112,7601,6443.250546,1926.365678
WB_ H5 6250,WB_ H5,6250,2291,122992083,1510,8996,7486,6040.811,2274.74107
WB_ H6 6250,WB_ H6,6250,2287,122777343.4,117,9551,9434,6035.388282,2694.90133
WB_ H7 6250,WB_ H7,6250,2290,122938398.1,-503,9898,10401,6657.386463,2422.623762
WB_ H8 6250,WB_ H8,6250,2285,122669973.7,1142,8941,7799,6354.458206,2154.286019
WB_ H9 6250,WB_ H9,6250,2289,122884713.2,171,9272,9101,5187.402359,2546.581296
WB_ S1 6250,WB_ S1,6250,2284,122616288.8,-283,9580,9863,5756.618214,2711.772702
WB_ S10 6250,WB_ S10,6250,2286,122723658.5,453,9787,9334,4429.467192,2464.936105
WB_ S11 6250,WB_ S11,6250,2283,122562603.9,748,8679,7931,5685.744634,2507.034476
WB_ S12 6250,WB_ S12,6250,2291,122992083,659,9237,8578,5027.616761,2427.512037
WB_ S13 6250,WB_ S13,6250,2292,123045767.9,1174,9074,7900,5897.783159,2412.861609
WB_ S14 6250,WB_ S14,6250,2292,123045767.9,1683,8835,7152,7331.289267,1282.214941
WB_ S15 6250,WB_ S15,6250,2288,122831028.3,1525,8878,7353,6744.906469,1935.972135
WB_ S16 6250,WB_ S16,6250,2293,123099452.8,477,8931,8454,5854.306585,2417.433387
WB_ S17 6250,WB_ S17,6250,2291,122992083,1052,9115,8063,7421.127455,1359.230378
WB_ S18 6250,WB_ S18,6250,2290,122938398.1,896,9261,8365,6587.453275,2225.600771
WB_ S19 6250,WB_ S19,6250,2290,122938398.1,1873,8894,7021,7173.406987,1743.681452
WB_ S2 6250,WB_ S2,6250,2287,122777343.4,-1001,9580,10581,3822.077394,3569.451026
WB_ S20 6250,WB_ S20,6250,2294,123153137.7,1892,9134,7242,7972.959895,1408.980545
WB_ S21 6250,WB_ S21,6250,2282,122508919,2961,8939,5978,7532.85057,1031.385895
WB_ S22 6250,WB_ S22,6250,2291,122992083,3375,8963,5588,7654.29725,669.9640988
WB_ S23 6250,WB_ S23,6250,2289,122884713.2,755,9040,8285,6560.436872,1744.94359
WB_ S24 6250,WB_ S24,6250,2288,122831028.3,130,9272,9142,4644.869755,2380.098961
WB_ S25 6250,WB_ S25,6250,2291,122992083,1304,8780,7476,7164.543431,1493.828687
WB_ S26 6250,WB_ S26,6250,2290,122938398.1,1621,9227,7606,7955.072926,1326.616787
WB_ S27 6250,WB_ S27,6250,2292,123045767.9,2171,9102,6931,8281.63918,855.0092578
WB_ S28 6250,WB_ S28,6250,2283,122562603.9,1665,9063,7398,7688.04205,1125.209707
WB_ S29 6250,WB_ S29,6250,2287,122777343.4,2100,8920,6820,6924.726716,1313.216183
WB_ S3 6250,WB_ S3,6250,2285,122669973.7,135,9500,9365,5752.921663,2304.329462
WB_ S4 6250,WB_ S4,6250,2294,123153137.7,289,8986,8697,4504.061465,2398.910956
WB_ S5 6250,WB_ S5,6250,2293,123099452.8,854,8888,8034,5933.344527,2431.292591
WB_ S6 6250,WB_ S6,6250,2292,123045767.9,1511,9112,7601,6179.128709,2000.290612
WB_ S7 6250,WB_ S7,6250,2286,122723658.5,1537,8774,7237,7009.528434,1771.354578
WB_ S8 6250,WB_ S8,6250,2288,122831028.3,266,9749,9483,7117.061626,2014.977924
WB_ S9 6250,WB_ S9,6250,2291,122992083,-617,8964,9581,4404.292012,2361.202123
WB_ W1 6250,WB_ W1,6250,2285,122669973.7,755,9063,8308,5809.841138,1914.745439
WB_ W10 6250,WB_ W10,6250,2283,122562603.9,460,9181,8721,5822.455979,2252.293762
WB_ W2 6250,WB_ W2,6250,2288,122831028.3,1060,8908,7848,7413.238636,1417.350858
WB_ W3 6250,WB_ W3,6250,2287,122777343.4,863,8841,7978,6416.702667,1548.899481
WB_ W4 6250,WB_ W4,6250,2291,122992083,1077,8971,7894,6187.387167,1869.855535
WB_ W5 6250,WB_ W5,6250,2292,123045767.9,1117,9026,7909,7386.125218,1352.708913
WB_ W6 6250,WB_ W6,6250,2290,122938398.1,1905,9009,7104,7821.815721,1328.463486
WB_ W7 6250,WB_ W7,6250,2283,122562603.9,-714,9580,10294,5600.268506,3010.520628
WB_ W8 6250,WB_ W8,6250,2285,122669973.7,1829,9131,7302,7403.287527,1112.032437
WB_ W9 6250,WB_ W9,6250,2289,122884713.2,1489,8972,7483,7269.286151,1809.989826
W01 6500,W01,6500,2471,132655363.2,249,9551,9302,6906.8017,2005.265469
W02 6500,W02,6500,2476,132923787.6,395,9266,8871,7535.43538,1401.007299
W03 6500,W03,6500,2470,132601678.3,863,9063,8200,7172.502834,1680.987589
W04 6500,W04,6500,2474,132816417.9,395,9063,8668,7718.729992,1084.064975
W05 6500,W05,6500,2474,132816417.9,425,8908,8483,7173.172191,1690.209941
W06 6500,W06,6500,2472,132709048.1,1060,9063,8003,7458.025485,1393.102117
W07 6500,W07,6500,2474,132816417.9,863,9063,8200,6374.570331,1698.572547
W08 6500,W08,6500,2472,132709048.1,1724,8991,7267,7419.147249,1564.82976
W09 6500,W09,6500,2473,132762733,1724,8934,7210,7319.800243,1443.344931
W10 6500,W10,6500,2475,132870102.8,1724,8981,7257,7302.775354,1767.338258
W11 6500,W11,6500,2471,132655363.2,755,9063,8308,5772.536625,1911.576103
W12 6500,W12,6500,2475,132870102.8,233,9272,9039,5359.702222,2160.810842
W13 6500,W13,6500,2477,132977472.5,381,8660,8279,5291.333064,2066.099703
W14 6500,W14,6500,2474,132816417.9,381,8878,8497,6188.165319,2293.248063
W15 6500,W15,6500,2474,132816417.9,726,8939,8213,6911.945432,1850.639699
W16 6500,W16,6500,2472,132709048.1,-503,9898,10401,6674.954693,2218.738126
W17 6500,W17,6500,2472,132709048.1,38,9480,9442,6877.36246,2157.444362
W18 6500,W18,6500,2472,132709048.1,38,9316,9278,7117.973706,1914.379531
W19 6500,W19,6500,2473,132762733,210,9749,9539,6545.597655,2310.888814
W20 6500,W20,6500,2476,132923787.6,210,9316,9106,6406.378433,2171.08376
W21 6500,W21,6500,2476,132923787.6,38,9316,9278,6785.76454,2104.267649
W22 6500,W22,6500,2476,132923787.6,-617,8964,9581,4584.890953,2470.798096
W23 6500,W23,6500,2473,132762733,349,9146,8797,5946.769106,1982.826381
W24 6500,W24,6500,2474,132816417.9,357,9240,8883,6016.595796,2324.44208
W25 6500,W25,6500,2474,132816417.9,751,8798,8047,6360.09135,2010.133918
W26 6500,W26,6500,2475,132870102.8,-424,9787,10211,4887.808889,2430.922622
W27 6500,W27,6500,2472,132709048.1,850,9447,8597,6496.447816,1998.24235
W28 6500,W28,6500,2477,132977472.5,572,9102,8530,6657.42067,2059.17705
W29 6500,W29,6500,2473,132762733,572,9102,8530,6577.145977,1935.393207
W30 6500,W30,6500,2474,132816417.9,1140,9131,7991,7439.827405,1175.682939
W31 6500,W31,6500,2475,132870102.8,2171,9110,6939,8528.711111,417.5729395
W32 6500,W32,6500,2471,132655363.2,1621,9227,7606,8094.502226,1201.930253
W33 6500,W33,6500,2478,133031157.4,1117,9206,8089,7470.013317,1567.789627
W34 6500,W34,6500,2470,132601678.3,1237,9261,8024,6713.331984,1992.875814
W35 6500,W35,6500,2474,132816417.9,1894,9123,7229,7700.913096,1423.946759
W36 6500,W36,6500,2476,132923787.6,1892,9134,7242,7352.667205,1774.268815
W37 6500,W37,6500,2476,132923787.6,1414,9134,7720,7499.144184,1800.098285
W38 6500,W38,6500,2472,132709048.1,3377,8946,5569,8447.043689,425.7956949
W39 6500,W39,6500,2478,133031157.4,2961,8856,5895,7838.362389,904.5247457
W40 6500,W40,6500,2477,132977472.5,1414,8996,7582,6750.813484,2142.78762
W41 6500,W41,6500,2477,132977472.5,1174,8876,7702,6870.624546,1692.164516
W42 6500,W42,6500,2479,133084842.3,2640,8996,6356,7797.537313,1031.426636
W43 6500,W43,6500,2476,132923787.6,3375,9530,6155,7627.394588,772.8740264
W44 6500,W44,6500,2475,132870102.8,1683,8939,7256,7173.249293,1467.302937
W45 6500,W45,6500,2480,133138527.2,1683,8939,7256,7008.67379,1616.49564
W46 6500,W46,6500,2479,133084842.3,1525,8878,7353,6595.328358,2003.26145
W47 6500,W47,6500,2474,132816417.9,1568,8906,7338,6798.024656,1869.711174
W48 6500,W48,6500,2484,133353266.8,1936,9269,7333,7667.852254,1186.448689
W49 6500,W49,6500,2478,133031157.4,1537,9269,7732,6681.060533,1839.131133
W50 6500,W50,6500,2476,132923787.6,1537,8872,7335,7371.700323,1510.916717
W51 6500,W51,6500,2476,132923787.6,1417,8858,7441,6977.207189,1861.58555
W52 6500,W52,6500,2475,132870102.8,1589,8774,7185,6166.730101,1958.013584
W53 6500,W53,6500,2474,132816417.9,1511,8751,7240,6719.661277,1762.887043
W54 6500,W54,6500,2473,132762733,1509,8565,7056,5815.359887,2082.846241
W55 6500,W55,6500,2477,132977472.5,1342,9145,7803,6929.532903,2038.559021
W56 6500,W56,6500,2479,133084842.3,1235,8959,7724,6714.960065,2118.754398
W57 6500,W57,6500,2477,132977472.5,852,9352,8500,6007.005652,2326.177479
W58 6500,W58,6500,2476,132923787.6,994,9352,8358,6204.085218,2330.451756
W59 6500,W59,6500,2474,132816417.9,659,9145,8486,5010.331851,2436.009061
W60 6500,W60,6500,2475,132870102.8,911,9191,8280,7112.010505,1866.161076
W61 6500,W61,6500,2476,132923787.6,896,9115,8219,7000.71567,2004.733088
W62 6500,W62,6500,2474,132816417.9,715,9787,9072,5602.547292,2494.789129
W63 6500,W63,6500,2471,132655363.2,-144,9766,9910,4562.346014,2468.008525
W64 6500,W64,6500,2470,132601678.3,1017,9043,8026,5927.859109,2310.1594
W65 6500,W65,6500,2474,132816417.9,460,8679,8219,4770.170978,2479.06101
W66 6500,W66,6500,2476,132923787.6,135,8688,8553,4348.793619,2359.690346
WB_ E1 6500,WB_ E1,6500,2475,132870102.8,130,9272,9142,4392.867879,2517.212234
WB_ E10 6500,WB_ E10,6500,2475,132870102.8,659,9145,8486,4619.84,2236.038921
WB_ E2 6500,WB_ E2,6500,2476,132923787.6,911,9043,8132,6604.589661,2190.383002
WB_ E3 6500,WB_ E3,6500,2479,133084842.3,5115,8945,3830,7784.5119,556.9581316
WB_ E4 6500,WB_ E4,6500,2475,132870102.8,1905,9009,7104,7982.673535,1214.204269
WB_ E5 6500,WB_ E5,6500,2473,132762733,130,9272,9142,4578.538213,2435.585553
WB_ E6 6500,WB_ E6,6500,2476,132923787.6,3375,9530,6155,7558.580775,759.8950529
WB_ E7 6500,WB_ E7,6500,2475,132870102.8,615,9787,9172,5906.817778,2263.426098
WB_ E8 6500,WB_ E8,6500,2474,132816417.9,1510,9352,7842,5960.7692,2423.462049
WB_ E9 6500,WB_ E9,6500,2480,133138527.2,854,8841,7987,5510.247177,2448.070339
WB_ H1 6500,WB_ H1,6500,2474,132816417.9,1596,8878,7282,7221.508084,1678.017121
WB_ H10 6500,WB_ H10,6500,2477,132977472.5,1525,8878,7353,6054.543399,2054.520064
WB_ H2 6500,WB_ H2,6500,2476,132923787.6,1724,9009,7285,7271.537964,1812.353143
WB_ H3 6500,WB_ H3,6500,2473,132762733,896,9261,8365,6489.144763,2283.6737
WB_ H4 6500,WB_ H4,6500,2477,132977472.5,1511,9112,7601,6476.395236,1907.945357
WB_ H5 6500,WB_ H5,6500,2475,132870102.8,1409,8996,7587,6101.863434,2282.296678
WB_ H6 6500,WB_ H6,6500,2473,132762733,117,9551,9434,6081.215528,2672.123319
WB_ H7 6500,WB_ H7,6500,2475,132870102.8,-503,9898,10401,6689.309899,2400.399163
WB_ H8 6500,WB_ H8,6500,2474,132816417.9,1142,8941,7799,6267.464026,2204.679735
WB_ H9 6500,WB_ H9,6500,2472,132709048.1,130,9272,9142,5205.58657,2543.727679
WB_ S1 6500,WB_ S1,6500,2470,132601678.3,-283,9580,9863,5899.926721,2681.336314
WB_ S10 6500,WB_ S10,6500,2472,132709048.1,199,9787,9588,4419.961974,2473.605832
WB_ S11 6500,WB_ S11,6500,2475,132870102.8,748,8679,7931,5696.117576,2505.029361
WB_ S12 6500,WB_ S12,6500,2478,133031157.4,659,9237,8578,5120.009685,2437.083633
WB_ S13 6500,WB_ S13,6500,2475,132870102.8,1174,9074,7900,5906.202424,2403.45729
WB_ S14 6500,WB_ S14,6500,2479,133084842.3,1683,8835,7152,7328.352965,1295.980986
WB_ S15 6500,WB_ S15,6500,2474,132816417.9,1525,8878,7353,6720.292643,1952.751444
WB_ S16 6500,WB_ S16,6500,2474,132816417.9,477,8960,8483,5884.052142,2396.560785
WB_ S17 6500,WB_ S17,6500,2477,132977472.5,1052,9115,8063,7405.410981,1401.592154
WB_ S18 6500,WB_ S18,6500,2475,132870102.8,896,9261,8365,6547.582626,2245.033959
WB_ S19 6500,WB_ S19,6500,2476,132923787.6,1873,8972,7099,7207.418821,1732.275793
WB_ S2 6500,WB_ S2,6500,2478,133031157.4,-1001,9580,10581,3857.507667,3558.895883
WB_ S20 6500,WB_ S20,6500,2473,132762733,1892,9134,7242,7957.6296,1409.413384
WB_ S21 6500,WB_ S21,6500,2475,132870102.8,2961,8939,5978,7558.469899,1013.049385
WB_ S22 6500,WB_ S22,6500,2475,132870102.8,3375,8963,5588,7659.495758,672.7780905
WB_ S23 6500,WB_ S23,6500,2474,132816417.9,755,9040,8285,6546.510509,1752.243586
WB_ S24 6500,WB_ S24,6500,2474,132816417.9,130,9272,9142,4709.240501,2374.002598
WB_ S25 6500,WB_ S25,6500,2472,132709048.1,1277,8832,7555,7140.254045,1521.292274
WB_ S26 6500,WB_ S26,6500,2476,132923787.6,1621,9227,7606,7927.210824,1365.163201
WB_ S27 6500,WB_ S27,6500,2472,132709048.1,2171,9102,6931,8282.404935,853.7854826
WB_ S28 6500,WB_ S28,6500,2472,132709048.1,1060,9063,8003,7601.56877,1241.988589
WB_ S29 6500,WB_ S29,6500,2475,132870102.8,2100,8920,6820,6913.808889,1332.639583
WB_ S3 6500,WB_ S3,6500,2473,132762733,135,9664,9529,5749.065912,2312.485015
WB_ S4 6500,WB_ S4,6500,2474,132816417.9,289,8986,8697,4448.694422,2414.678452
WB_ S5 6500,WB_ S5,6500,2477,132977472.5,854,9352,8498,5921.576504,2436.539663
WB_ S6 6500,WB_ S6,6500,2476,132923787.6,1511,9112,7601,6206.761712,1997.928619
WB_ S7 6500,WB_ S7,6500,2478,133031157.4,1537,8774,7237,6947.397094,1811.73785
WB_ S8 6500,WB_ S8,6500,2474,132816417.9,210,9749,9539,7074.688359,2038.841367
WB_ S9 6500,WB_ S9,6500,2474,132816417.9,-617,8964,9581,4401.849232,2372.390215
WB_ W1 6500,WB_ W1,6500,2467,132440623.6,755,9063,8308,5845.061208,1911.169061
WB_ W10 6500,WB_ W10,6500,2479,133084842.3,460,9181,8721,5801.870109,2282.286296
WB_ W2 6500,WB_ W2,6500,2472,132709048.1,922,8908,7986,7406.5089,1438.220194
WB_ W3 6500,WB_ W3,6500,2472,132709048.1,863,8841,7978,6401.739078,1592.546498
WB_ W4 6500,WB_ W4,6500,2473,132762733,1077,9422,8345,6194.04165,1882.777571
WB_ W5 6500,WB_ W5,6500,2478,133031157.4,1117,9026,7909,7347.843422,1400.439266
WB_ W6 6500,WB_ W6,6500,2473,132762733,1905,9009,7104,7818.607764,1332.074936
WB_ W7 6500,WB_ W7,6500,2471,132655363.2,-714,9749,10463,5596.44314,3001.245848
WB_ W8 6500,WB_ W8,6500,2475,132870102.8,1571,9131,7560,7378.767273,1193.26971
WB_ W9 6500,WB_ W9,6500,2475,132870102.8,1489,8972,7483,7234.723636,1827.292365
W01 6750,W01,6750,2665,143070231.8,249,9551,9302,6929.67955,2003.445277
W02 6750,W02,6750,2666,143123916.7,395,9266,8871,7512.293698,1419.801744
W03 6750,W03,6750,2665,143070231.8,863,9063,8200,7180.318949,1657.503828
W04 6750,W04,6750,2669,143284971.4,395,9063,8668,7661.716748,1147.983751
W05 6750,W05,6750,2667,143177601.6,425,8908,8483,7176.950506,1700.61666
W06 6750,W06,6750,2665,143070231.8,988,9063,8075,7425.592495,1431.613791
W07 6750,W07,6750,2667,143177601.6,863,9063,8200,6391.72291,1704.399045
W08 6750,W08,6750,2665,143070231.8,1724,8991,7267,7402.026266,1567.472625
W09 6750,W09,6750,2667,143177601.6,1724,8981,7257,7266.999625,1462.416937
W10 6750,W10,6750,2668,143231286.5,1724,8981,7257,7264.097451,1796.275455
W11 6750,W11,6750,2665,143070231.8,755,9063,8308,5815.991745,1902.326308
W12 6750,W12,6750,2668,143231286.5,130,9272,9142,5345.53973,2193.293506
W13 6750,W13,6750,2670,143338656.3,381,9116,8735,5346.369663,2090.932798
W14 6750,W14,6750,2667,143177601.6,381,8898,8517,6172.505812,2309.996822
W15 6750,W15,6750,2667,143177601.6,726,8939,8213,6881.221222,1889.454423
W16 6750,W16,6750,2665,143070231.8,-503,9898,10401,6622.133208,2259.339225
W17 6750,W17,6750,2664,143016547,38,9480,9442,6888.431682,2147.089184
W18 6750,W18,6750,2664,143016547,38,9316,9278,7067.688814,1938.51266
W19 6750,W19,6750,2671,143392341.2,210,9749,9539,6535.564583,2300.292484
W20 6750,W20,6750,2666,143123916.7,210,9316,9106,6395.791823,2184.959294
W21 6750,W21,6750,2668,143231286.5,38,9316,9278,6780.89018,2084.531273
W22 6750,W22,6750,2669,143284971.4,-617,8964,9581,4601.711502,2517.328677
W23 6750,W23,6750,2668,143231286.5,349,9146,8797,5947.17054,2014.471811
W24 6750,W24,6750,2664,143016547,357,9240,8883,6009.798799,2309.733221
W25 6750,W25,6750,2669,143284971.4,751,8798,8047,6314.461596,2030.359629
W26 6750,W26,6750,2666,143123916.7,-424,9787,10211,4928.01838,2455.02533
W27 6750,W27,6750,2670,143338656.3,730,9787,9057,6407.716105,2061.111826
W28 6750,W28,6750,2669,143284971.4,572,9102,8530,6697.386287,2025.488836
W29 6750,W29,6750,2667,143177601.6,572,9102,8530,6580.08174,1938.514144
W30 6750,W30,6750,2666,143123916.7,1052,9131,8079,7411.331208,1228.921558
W31 6750,W31,6750,2671,143392341.2,2171,9110,6939,8507.754399,507.1538206
W32 6750,W32,6750,2669,143284971.4,1621,9227,7606,8042.890221,1248.863498
W33 6750,W33,6750,2669,143284971.4,1117,9206,8089,7463.6287,1559.580894
W34 6750,W34,6750,2674,143553395.9,896,9261,8365,6694.819746,2018.642003
W35 6750,W35,6750,2667,143177601.6,1894,9123,7229,7684.75778,1477.459117
W36 6750,W36,6750,2670,143338656.3,1892,9134,7242,7342.632959,1789.19044
W37 6750,W37,6750,2670,143338656.3,1414,9134,7720,7538.309738,1771.915145
W38 6750,W38,6750,2673,143499711,2996,8946,5950,8413.211747,524.6324786
W39 6750,W39,6750,2670,143338656.3,2961,8939,5978,7838.334082,920.6726738
W40 6750,W40,6750,2669,143284971.4,1409,8996,7587,6723.726864,2158.601879
W41 6750,W41,6750,2668,143231286.5,1174,8876,7702,6820.604198,1751.029705
W42 6750,W42,6750,2670,143338656.3,2640,8996,6356,7787.871161,1033.570833
W43 6750,W43,6750,2671,143392341.2,3375,9530,6155,7631.809435,759.8227428
W44 6750,W44,6750,2669,143284971.4,1683,8939,7256,7158.674785,1472.216118
W45 6750,W45,6750,2670,143338656.3,1605,8939,7334,7024.455805,1616.368672
W46 6750,W46,6750,2670,143338656.3,1525,8878,7353,6588.668539,2012.586138
W47 6750,W47,6750,2673,143499711,1568,8906,7338,6776.087542,1914.975899
W48 6750,W48,6750,2670,143338656.3,1936,9269,7333,7655.757303,1195.332515
W49 6750,W49,6750,2670,143338656.3,1537,9269,7732,6729.084644,1822.601857
W50 6750,W50,6750,2672,143446026.1,1537,8872,7335,7356.525823,1531.06856
W51 6750,W51,6750,2675,143607080.7,1417,8858,7441,6913.664673,1893.282776
W52 6750,W52,6750,2669,143284971.4,1589,8774,7185,6215.762833,1951.958355
W53 6750,W53,6750,2671,143392341.2,1511,8751,7240,6627.95058,1859.144484
W54 6750,W54,6750,2681,143929190.1,1422,8565,7143,5783.405819,2088.902818
W55 6750,W55,6750,2670,143338656.3,1342,9145,7803,6923.620599,2045.557674
W56 6750,W56,6750,2668,143231286.5,1235,8959,7724,6687.64018,2122.56809
W57 6750,W57,6750,2668,143231286.5,802,9352,8550,5967.881934,2351.404794
W58 6750,W58,6750,2674,143553395.9,994,9352,8358,6141.162678,2353.895823
W59 6750,W59,6750,2669,143284971.4,659,9145,8486,5046.431248,2443.670655
W60 6750,W60,6750,2668,143231286.5,748,9191,8443,7073.523988,1911.343911
W61 6750,W61,6750,2667,143177601.6,896,9145,8249,7019.396325,1991.377386
W62 6750,W62,6750,2668,143231286.5,615,9787,9172,5667.075337,2495.998415
W63 6750,W63,6750,2669,143284971.4,-144,9766,9910,4637.30236,2473.070996
W64 6750,W64,6750,2672,143446026.1,460,9043,8583,5870.376497,2346.590003
W65 6750,W65,6750,2669,143284971.4,135,8679,8544,4824.467591,2482.605934
W66 6750,W66,6750,2669,143284971.4,135,8688,8553,4449.154365,2383.141391
WB_ E1 6750,WB_ E1,6750,2669,143284971.4,130,9272,9142,4445.936306,2513.657828
WB_ E10 6750,WB_ E10,6750,2670,143338656.3,659,9145,8486,4680.452809,2258.42841
WB_ E2 6750,WB_ E2,6750,2668,143231286.5,911,9043,8132,6519.597826,2238.112348
WB_ E3 6750,WB_ E3,6750,2670,143338656.3,5115,8945,3830,7783.74382,562.2972959
WB_ E4 6750,WB_ E4,6750,2665,143070231.9,1905,9009,7104,7981.081051,1215.285042
WB_ E5 6750,WB_ E5,6750,2668,143231286.5,130,9272,9142,4684.337706,2420.538472
WB_ E6 6750,WB_ E6,6750,2672,143446026.1,3375,9530,6155,7572.95247,741.8367153
WB_ E7 6750,WB_ E7,6750,2667,143177601.6,615,9787,9172,5902.849269,2263.506417
WB_ E8 6750,WB_ E8,6750,2669,143284971.4,1510,9352,7842,5950.771825,2415.567157
WB_ E9 6750,WB_ E9,6750,2676,143660765.6,854,8841,7987,5549.705531,2426.882982
WB_ H1 6750,WB_ H1,6750,2682,143982875,1596,8878,7282,7170.693139,1725.219377
WB_ H10 6750,WB_ H10,6750,2673,143499711,1525,8878,7353,6128.8107,2045.039485
WB_ H2 6750,WB_ H2,6750,2669,143284971.4,1724,9009,7285,7303.572124,1803.510662
WB_ H3 6750,WB_ H3,6750,2668,143231286.5,896,9261,8365,6574.672789,2267.733755
WB_ H4 6750,WB_ H4,6750,2667,143177601.6,1511,9112,7601,6514.95838,1883.444367
WB_ H5 6750,WB_ H5,6750,2666,143123916.7,1409,9008,7599,6164.554014,2278.788312
WB_ H6 6750,WB_ H6,6750,2667,143177601.6,117,9551,9434,6136.776528,2641.989807
WB_ H7 6750,WB_ H7,6750,2667,143177601.6,-503,9898,10401,6721.306337,2367.92428
WB_ H8 6750,WB_ H8,6750,2669,143284971.4,1142,8941,7799,6184.367928,2252.717796
WB_ H9 6750,WB_ H9,6750,2667,143177601.6,130,9272,9142,5214.72291,2541.367172
WB_ S1 6750,WB_ S1,6750,2668,143231286.5,-283,9580,9863,6029.068216,2640.677468
WB_ S10 6750,WB_ S10,6750,2665,143070231.8,91,9787,9696,4391.30394,2478.289692
WB_ S11 6750,WB_ S11,6750,2670,143338656.3,748,8755,8007,5712.494382,2505.880325
WB_ S12 6750,WB_ S12,6750,2668,143231286.5,659,9349,8690,5209.182534,2434.428568
WB_ S13 6750,WB_ S13,6750,2670,143338656.3,1174,9074,7900,5921.580524,2390.067073
WB_ S14 6750,WB_ S14,6750,2674,143553395.9,1683,8835,7152,7313.357517,1302.834502
WB_ S15 6750,WB_ S15,6750,2675,143607080.7,1525,8878,7353,6710.980935,1959.194304
WB_ S16 6750,WB_ S16,6750,2668,143231286.5,477,9102,8625,5910.661544,2377.028288
WB_ S17 6750,WB_ S17,6750,2665,143070231.8,1052,9131,8079,7384.995497,1439.751549
WB_ S18 6750,WB_ S18,6750,2666,143123916.7,896,9261,8365,6532.009752,2252.188652
WB_ S19 6750,WB_ S19,6750,2669,143284971.4,1873,8972,7099,7238.05695,1730.785336
WB_ S2 6750,WB_ S2,6750,2669,143284971.4,-1001,9580,10581,3901.645185,3557.036883
WB_ S20 6750,WB_ S20,6750,2669,143284971.4,1892,9134,7242,7940.398651,1418.874471
WB_ S21 6750,WB_ S21,6750,2669,143284971.4,2961,8939,5978,7583.924691,994.8802583
WB_ S22 6750,WB_ S22,6750,2670,143338656.3,3375,8963,5588,7659.559176,677.9224244
WB_ S23 6750,WB_ S23,6750,2666,143123916.7,497,9040,8543,6520.122281,1778.41583
WB_ S24 6750,WB_ S24,6750,2667,143177601.6,130,9272,9142,4786.980127,2367.183414
WB_ S25 6750,WB_ S25,6750,2666,143123916.7,1117,8832,7715,7112.106902,1554.438645
WB_ S26 6750,WB_ S26,6750,2669,143284971.4,1621,9227,7606,7891.591233,1395.554204
WB_ S27 6750,WB_ S27,6750,2668,143231286.5,2171,9102,6931,8279.434033,867.9167832
WB_ S28 6750,WB_ S28,6750,2665,143070231.8,988,9063,8075,7518.546717,1340.296728
WB_ S29 6750,WB_ S29,6750,2665,143070231.8,2100,8920,6820,6916.452908,1345.35179
WB_ S3 6750,WB_ S3,6750,2668,143231286.5,135,9667,9532,5714.312219,2321.067017
WB_ S4 6750,WB_ S4,6750,2667,143177601.6,289,8986,8697,4407.423697,2425.236112
WB_ S5 6750,WB_ S5,6750,2671,143392341.2,854,9352,8498,5902.390116,2442.598591
WB_ S6 6750,WB_ S6,6750,2670,143338656.3,1485,9112,7627,6222.470412,2000.715511
WB_ S7 6750,WB_ S7,6750,2674,143553395.9,1537,8774,7237,6889.131264,1852.078632
WB_ S8 6750,WB_ S8,6750,2667,143177601.6,210,9749,9539,7021.289839,2075.001788
WB_ S9 6750,WB_ S9,6750,2668,143231286.5,-717,8964,9681,4414.230135,2389.042787
WB_ W1 6750,WB_ W1,6750,2670,143338656.3,755,9063,8308,5877.457678,1907.060871
WB_ W10 6750,WB_ W10,6750,2669,143284971.4,135,9490,9355,5777.907456,2309.792268
WB_ W2 6750,WB_ W2,6750,2667,143177601.6,425,8915,8490,7391.925384,1476.75891
WB_ W3 6750,WB_ W3,6750,2667,143177601.6,863,8841,7978,6404.190476,1618.641596
WB_ W4 6750,WB_ W4,6750,2667,143177601.6,1077,9447,8370,6184.537308,1914.661289
WB_ W5 6750,WB_ W5,6750,2674,143553395.9,1117,9026,7909,7315.158938,1440.096849
WB_ W6 6750,WB_ W6,6750,2666,143123916.7,1905,9009,7104,7819.492123,1325.66614
WB_ W7 6750,WB_ W7,6750,2667,143177601.6,-714,9749,10463,5560.564304,2996.283598
WB_ W8 6750,WB_ W8,6750,2669,143284971.4,1528,9131,7603,7357.946797,1253.084521
WB_ W9 6750,WB_ W9,6750,2669,143284971.4,1489,8972,7483,7201.937055,1851.493473
W01 7000,W01,7000,2866,153860894.7,249,9551,9302,6936.255059,2026.082455
W02 7000,W02,7000,2865,153807209.8,395,9266,8871,7490.08726,1432.771251
W03 7000,W03,7000,2873,154236689,863,9063,8200,7163.76401,1642.745354
W04 7000,W04,7000,2866,153860894.7,395,9063,8668,7593.092812,1225.337921
W05 7000,W05,7000,2866,153860894.7,425,9313,8888,7193.931961,1692.387711
W06 7000,W06,7000,2868,153968264.5,988,9063,8075,7398.264296,1456.320612
W07 7000,W07,7000,2868,153968264.5,863,9063,8200,6417.057183,1707.861187
W08 7000,W08,7000,2868,153968264.5,1724,8991,7267,7383.396095,1570.893707
W09 7000,W09,7000,2870,154075634.3,1724,8981,7257,7228.897561,1469.263568
W10 7000,W10,7000,2865,153807209.8,1724,9009,7285,7237.256195,1819.181044
W11 7000,W11,7000,2869,154021949.4,755,9063,8308,5857.827815,1899.741902
W12 7000,W12,7000,2869,154021949.4,130,9272,9142,5323.557337,2216.227545
W13 7000,W13,7000,2864,153753525,381,9272,8891,5384.107542,2112.399733
W14 7000,W14,7000,2874,154290373.9,381,8898,8517,6158.977731,2323.178495
W15 7000,W15,7000,2869,154021949.4,726,8939,8213,6862.053329,1909.596136
W16 7000,W16,7000,2865,153807209.8,-503,9898,10401,6574.509948,2288.986904
W17 7000,W17,7000,2870,154075634.3,38,9480,9442,6892.756098,2149.023452
W18 7000,W18,7000,2871,154129319.2,38,9316,9278,7004.740857,1978.031692
W19 7000,W19,7000,2867,153914579.6,210,9749,9539,6528.83781,2294.730022
W20 7000,W20,7000,2864,153753525,210,9316,9106,6393.730098,2182.906274
W21 7000,W21,7000,2872,154183004.1,38,9316,9278,6779.976671,2055.154976
W22 7000,W22,7000,2862,153646155.2,-617,8964,9581,4625.706848,2564.571022
W23 7000,W23,7000,2869,154021949.4,338,9146,8808,5939.99512,2045.97716
W24 7000,W24,7000,2866,153860894.7,357,9240,8883,6014.281228,2297.249758
W25 7000,W25,7000,2867,153914579.6,751,8798,8047,6274.905825,2044.582545
W26 7000,W26,7000,2871,154129319.2,-424,9787,10211,4955.622431,2471.230197
W27 7000,W27,7000,2870,154075634.3,730,9787,9057,6351.639373,2102.965032
W28 7000,W28,7000,2874,154290373.9,572,9102,8530,6726.350035,1993.237907
W29 7000,W29,7000,2870,154075634.3,572,9102,8530,6582.895819,1945.493652
W30 7000,W30,7000,2872,154183004.1,1052,9131,8079,7380.329387,1279.905325
W31 7000,W31,7000,2868,153968264.5,2171,9110,6939,8485.302999,579.1791743
W32 7000,W32,7000,2871,154129319.2,1621,9227,7606,8009.290839,1265.486103
W33 7000,W33,7000,2869,154021949.4,1117,9206,8089,7460.810038,1552.358701
W34 7000,W34,7000,2873,154236689,896,9261,8365,6691.980508,2038.356454
W35 7000,W35,7000,2872,154183004.1,1873,9227,7354,7670.898677,1528.667014
W36 7000,W36,7000,2873,154236689,1892,9134,7242,7348.569788,1793.765206
W37 7000,W37,7000,2869,154021949.4,1414,9134,7720,7565.805856,1754.52563
W38 7000,W38,7000,2876,154397743.6,2996,8982,5986,8373.44854,629.2448168
W39 7000,W39,7000,2867,153914579.6,2961,8939,5978,7842.461109,928.7017988
W40 7000,W40,7000,2869,154021949.4,1409,8996,7587,6708.246427,2168.313843
W41 7000,W41,7000,2872,154183004.1,1174,8876,7702,6799.932799,1788.105493
W42 7000,W42,7000,2874,154290373.9,2640,8996,6356,7775.571677,1037.658736
W43 7000,W43,7000,2868,153968264.5,3375,9530,6155,7621.389819,773.6472993
W44 7000,W44,7000,2874,154290373.9,1683,8939,7256,7147.59499,1472.321798
W45 7000,W45,7000,2872,154183004.1,1605,8939,7334,7023.216574,1624.565112
W46 7000,W46,7000,2875,154344058.7,1525,8878,7353,6574.356174,2022.837172
W47 7000,W47,7000,2874,154290373.9,1537,8906,7369,6762.355602,1949.380558
W48 7000,W48,7000,2878,154505113.4,1936,9269,7333,7648.919041,1196.430922
W49 7000,W49,7000,2868,153968264.5,1537,9269,7732,6772.286611,1806.351168
W50 7000,W50,7000,2878,154505113.4,1537,8872,7335,7340.866574,1547.005509
W51 7000,W51,7000,2873,154236689,1417,8858,7441,6878.761921,1900.459381
W52 7000,W52,7000,2878,154505113.4,1589,8774,7185,6259.690063,1942.82959
W53 7000,W53,7000,2874,154290373.9,1511,8751,7240,6560.089422,1916.909497
W54 7000,W54,7000,2873,154236689,1422,8565,7143,5761.804038,2090.89786
W55 7000,W55,7000,2867,153914579.6,1342,9145,7803,6913.17963,2053.445541
W56 7000,W56,7000,2871,154129319.2,1235,8959,7724,6660.55869,2121.884934
W57 7000,W57,7000,2871,154129319.2,802,9352,8550,5916.937652,2386.095551
W58 7000,W58,7000,2864,153753525,994,9352,8358,6096.550279,2373.770663
W59 7000,W59,7000,2868,153968264.5,659,9145,8486,5097.187238,2452.64883
W60 7000,W60,7000,2870,154075634.3,748,9191,8443,7025.409408,1957.977118
W61 7000,W61,7000,2868,153968264.5,896,9191,8295,7043.737448,1968.020049
W62 7000,W62,7000,2875,154344058.8,615,9787,9172,5705.318609,2491.557575
W63 7000,W63,7000,2870,154075634.3,-144,9766,9910,4707.645296,2473.796976
W64 7000,W64,7000,2874,154290373.9,460,9043,8583,5811.328462,2379.904367
W65 7000,W65,7000,2866,153860894.7,135,8679,8544,4870.890091,2487.161318
W66 7000,W66,7000,2869,154021949.4,135,8688,8553,4544.344719,2408.156551
WB_ E1 7000,WB_ E1,7000,2865,153807209.9,130,9272,9142,4520.770332,2516.054758
WB_ E10 7000,WB_ E10,7000,2870,154075634.3,659,9145,8486,4722.691638,2280.211296
WB_ E2 7000,WB_ E2,7000,2871,154129319.2,911,9043,8132,6450.355974,2270.274852
WB_ E3 7000,WB_ E3,7000,2869,154021949.4,3008,8945,5937,7772.130359,598.3409342
WB_ E4 7000,WB_ E4,7000,2876,154397743.6,1905,9009,7104,7974.182197,1220.937786
WB_ E5 7000,WB_ E5,7000,2866,153860894.7,130,9272,9142,4769.249826,2409.825333
WB_ E6 7000,WB_ E6,7000,2876,154397743.6,3375,9530,6155,7590.428373,726.7326316
WB_ E7 7000,WB_ E7,7000,2872,154183004.1,615,9787,9172,5893.655292,2270.427862
WB_ E8 7000,WB_ E8,7000,2867,153914579.6,1510,9352,7842,5955.684688,2412.898092
WB_ E9 7000,WB_ E9,7000,2875,154344058.8,854,8841,7987,5566.803478,2420.113786
WB_ H1 7000,WB_ H1,7000,2873,154236689,1596,8878,7282,7124.719805,1765.853111
WB_ H10 7000,WB_ H10,7000,2875,154344058.7,1525,8878,7353,6194.242087,2028.081235
WB_ H2 7000,WB_ H2,7000,2863,153699840.1,1724,9009,7285,7332.319595,1784.181935
WB_ H3 7000,WB_ H3,7000,2870,154075634.3,896,9261,8365,6647.672822,2250.586011
WB_ H4 7000,WB_ H4,7000,2874,154290373.9,1511,9112,7601,6541.841684,1861.652044
WB_ H5 7000,WB_ H5,7000,2873,154236689,1235,9008,7773,6221.679777,2282.707532
WB_ H6 7000,WB_ H6,7000,2871,154129319.2,117,9551,9434,6177.244166,2614.636462
WB_ H7 7000,WB_ H7,7000,2865,153807209.8,-503,9898,10401,6747.811169,2343.400985
WB_ H8 7000,WB_ H8,7000,2875,154344058.7,1142,8941,7799,6085.937043,2306.579648
WB_ H9 7000,WB_ H9,7000,2874,154290373.9,130,9272,9142,5244.557063,2533.422681
WB_ S1 7000,WB_ S1,7000,2871,154129319.2,-283,9580,9863,6135.594218,2595.757058
WB_ S10 7000,WB_ S10,7000,2869,154021949.4,91,9787,9696,4367.416173,2494.085619
WB_ S11 7000,WB_ S11,7000,2870,154075634.3,748,8755,8007,5718.676655,2500.696128
WB_ S12 7000,WB_ S12,7000,2866,153860894.7,659,9349,8690,5281.166434,2431.827528
WB_ S13 7000,WB_ S13,7000,2868,153968264.5,1174,9074,7900,5959.172943,2374.076188
WB_ S14 7000,WB_ S14,7000,2870,154075634.3,1683,9112,7429,7298.741812,1315.390006
WB_ S15 7000,WB_ S15,7000,2876,154397743.6,1525,8878,7353,6685.573018,1971.655638
WB_ S16 7000,WB_ S16,7000,2867,153914579.6,477,9146,8669,5933.94489,2359.088153
WB_ S17 7000,WB_ S17,7000,2866,153860894.7,1052,9131,8079,7373.523726,1458.500401
WB_ S18 7000,WB_ S18,7000,2871,154129319.2,896,9261,8365,6527.381052,2243.502182
WB_ S19 7000,WB_ S19,7000,2869,154021949.4,1873,8972,7099,7266.609969,1729.862645
WB_ S2 7000,WB_ S2,7000,2864,153753525,-1001,9580,10581,3949.395601,3560.382959
WB_ S20 7000,WB_ S20,7000,2874,154290373.9,1892,9134,7242,7921.455463,1438.598496
WB_ S21 7000,WB_ S21,7000,2873,154236689,2961,8939,5978,7606.459798,973.9193359
WB_ S22 7000,WB_ S22,7000,2872,154183004.1,3375,8963,5588,7662.05571,683.8330302
WB_ S23 7000,WB_ S23,7000,2868,153968264.5,497,9040,8543,6494.38947,1807.293889
WB_ S24 7000,WB_ S24,7000,2873,154236689,130,9272,9142,4855.244344,2351.362535
WB_ S25 7000,WB_ S25,7000,2872,154183004.1,887,9017,8130,7077.470752,1599.330837
WB_ S26 7000,WB_ S26,7000,2868,153968264.5,1621,9227,7606,7849.672943,1426.827152
WB_ S27 7000,WB_ S27,7000,2866,153860894.7,2171,9102,6931,8273.452896,894.7731599
WB_ S28 7000,WB_ S28,7000,2867,153914579.6,863,9063,8200,7449.161842,1407.015834
WB_ S29 7000,WB_ S29,7000,2865,153807209.8,2100,8960,6860,6910.849913,1366.183602
WB_ S3 7000,WB_ S3,7000,2872,154183004.1,135,9667,9532,5690.127089,2332.068643
WB_ S4 7000,WB_ S4,7000,2872,154183004.1,289,9096,8807,4357.78273,2431.501296
WB_ S5 7000,WB_ S5,7000,2869,154021949.4,854,9352,8498,5886.154061,2447.751464
WB_ S6 7000,WB_ S6,7000,2871,154129319.2,1485,9112,7627,6230.965517,2012.870536
WB_ S7 7000,WB_ S7,7000,2875,154344058.7,1537,8774,7237,6849.83687,1875.615431
WB_ S8 7000,WB_ S8,7000,2873,154236689,210,9749,9539,6977.974243,2108.428848
WB_ S9 7000,WB_ S9,7000,2866,153860894.7,-961,8964,9925,4444.452198,2420.475137
WB_ W1 7000,WB_ W1,7000,2873,154236689,755,9063,8308,5919.092934,1900.52166
WB_ W10 7000,WB_ W10,7000,2874,154290373.9,135,9637,9502,5755.411621,2334.858268
WB_ W2 7000,WB_ W2,7000,2867,153914579.6,425,8915,8490,7384.716777,1503.791465
WB_ W3 7000,WB_ W3,7000,2869,154021949.4,863,8841,7978,6418.208086,1629.728689
WB_ W4 7000,WB_ W4,7000,2865,153807209.9,977,9447,8470,6179.091449,1949.119604
WB_ W5 7000,WB_ W5,7000,2868,153968264.5,1117,9026,7909,7281.45258,1481.519462
WB_ W6 7000,WB_ W6,7000,2868,153968264.5,1905,9009,7104,7835.8553,1305.118091
WB_ W7 7000,WB_ W7,7000,2869,154021949.4,-714,9749,10463,5536.585221,2994.206471
WB_ W8 7000,WB_ W8,7000,2868,153968264.5,1323,9131,7808,7334.575662,1314.966131
WB_ W9 7000,WB_ W9,7000,2871,154129319.2,1489,8972,7483,7173.516545,1876.040568
W01 7250,W01,7250,3084,165564200.8,249,9551,9302,6955.105058,2032.318082
W02 7250,W02,7250,3076,165134721.6,395,9266,8871,7445.027633,1477.823095
W03 7250,W03,7250,3071,164866297.2,863,9063,8200,7149.931944,1633.556096
W04 7250,W04,7250,3077,165188406.5,395,9063,8668,7504.344166,1330.884296
W05 7250,W05,7250,3076,165134721.6,425,9313,8888,7218.682705,1685.784046
W06 7250,W06,7250,3079,165295776.3,863,9063,8200,7333.366028,1520.914744
W07 7250,W07,7250,3076,165134721.6,863,9063,8200,6445.406697,1714.225374
W08 7250,W08,7250,3082,165456831,1724,9009,7285,7361.11194,1574.621552
W09 7250,W09,7250,3084,165564200.8,1724,8981,7257,7198.720169,1462.918816
W10 7250,W10,7250,3078,165242091.4,1724,9009,7285,7224.021767,1830.702866
W11 7250,W11,7250,3085,165617885.6,755,9063,8308,5912.009076,1897.732546
W12 7250,W12,7250,3076,165134721.6,130,9272,9142,5296.166775,2246.638299
W13 7250,W13,7250,3080,165349461.2,381,9272,8891,5422.297078,2120.906942
W14 7250,W14,7250,3078,165242091.4,381,8898,8517,6172.186485,2316.963935
W15 7250,W15,7250,3084,165564200.8,726,8939,8213,6840.195525,1927.8667
W16 7250,W16,7250,3081,165403146.1,-503,9898,10401,6515.045115,2331.304041
W17 7250,W17,7250,3076,165134721.6,38,9480,9442,6879.229844,2167.393464
W18 7250,W18,7250,3071,164866297.2,38,9316,9278,6952.664604,1997.236447
W19 7250,W19,7250,3071,164866297.2,210,9749,9539,6524.680234,2296.00776
W20 7250,W20,7250,3074,165027351.9,210,9316,9106,6385.588159,2176.76381
W21 7250,W21,7250,3076,165134721.6,38,9316,9278,6786.133615,2024.834507
W22 7250,W22,7250,3076,165134721.6,-717,8964,9681,4653.79844,2607.57966
W23 7250,W23,7250,3075,165081036.7,-424,9146,9570,5926.23935,2080.88378
W24 7250,W24,7250,3081,165403146.1,357,9240,8883,6013.380071,2278.472856
W25 7250,W25,7250,3072,164919982.1,751,8798,8047,6236.784831,2051.745232
W26 7250,W26,7250,3071,164866297.2,-424,9787,10211,4970.352328,2481.167117
W27 7250,W27,7250,3083,165510515.9,730,9787,9057,6301.790464,2129.029671
W28 7250,W28,7250,3077,165188406.5,572,9102,8530,6737.637959,1960.694361
W29 7250,W29,7250,3075,165081036.7,572,9102,8530,6588.493984,1942.230704
W30 7250,W30,7250,3080,165349461.2,1052,9131,8079,7350.850974,1323.158578
W31 7250,W31,7250,3075,165081036.7,2171,9110,6939,8466.509268,623.3531191
W32 7250,W32,7250,3090,165886310.1,1621,9227,7606,7964.943042,1309.118878
W33 7250,W33,7250,3081,165403146.1,1117,9206,8089,7454.286271,1550.375954
W34 7250,W34,7250,3087,165725255.4,896,9261,8365,6674.909945,2060.614747
W35 7250,W35,7250,3087,165725255.4,1873,9227,7354,7653.367671,1576.890735
W36 7250,W36,7250,3088,165778940.3,1892,9134,7242,7361.915155,1789.349163
W37 7250,W37,7250,3077,165188406.5,1414,9134,7720,7581.669483,1737.988254
W38 7250,W38,7250,3088,165778940.3,2996,9031,6035,8342.525907,677.7101786
W39 7250,W39,7250,3078,165242091.4,2961,8939,5978,7849.515595,933.7853992
W40 7250,W40,7250,3082,165456831,1235,8996,7761,6700.301103,2169.809517
W41 7250,W41,7250,3078,165242091.4,1174,8876,7702,6773.077323,1838.291821
W42 7250,W42,7250,3078,165242091.4,2640,8996,6356,7760.022742,1041.838763
W43 7250,W43,7250,3076,165134721.6,3023,9530,6507,7607.81762,804.0736839
W44 7250,W44,7250,3080,165349461.2,1683,8939,7256,7138.725649,1466.534362
W45 7250,W45,7250,3078,165242091.4,1525,8939,7414,7024.041261,1630.900366
W46 7250,W46,7250,3085,165617885.6,1525,8878,7353,6568.505997,2029.24092
W47 7250,W47,7250,3081,165403146.1,1537,8906,7369,6745.480688,1969.509284
W48 7250,W48,7250,3079,165295776.3,1936,9269,7333,7643.469958,1194.793652
W49 7250,W49,7250,3079,165295776.3,1537,9269,7732,6817.491718,1796.506885
W50 7250,W50,7250,3078,165242091.4,1537,8872,7335,7304.67089,1589.856694
W51 7250,W51,7250,3085,165617885.6,1417,8858,7441,6832.762723,1910.944212
W52 7250,W52,7250,3079,165295776.3,1589,8774,7185,6299.842481,1932.726474
W53 7250,W53,7250,3080,165349461.2,1511,8758,7247,6523.206494,1946.758437
W54 7250,W54,7250,3089,165832625.2,1142,8592,7450,5743.684688,2103.88698
W55 7250,W55,7250,3079,165295776.3,1342,9145,7803,6883.291978,2070.460966
W56 7250,W56,7250,3084,165564200.8,1235,8959,7724,6617.608625,2136.797718
W57 7250,W57,7250,3082,165456831,802,9352,8550,5874.960415,2407.152433
W58 7250,W58,7250,3080,165349461.2,723,9352,8629,6025.57987,2405.172721
W59 7250,W59,7250,3077,165188406.5,659,9145,8486,5173.546636,2461.125404
W60 7250,W60,7250,3075,165081036.7,748,9191,8443,6977.463089,2008.321771
W61 7250,W61,7250,3081,165403146.1,896,9191,8295,7070.780591,1946.524388
W62 7250,W62,7250,3076,165134721.6,615,9787,9172,5754.070546,2490.622145
W63 7250,W63,7250,3084,165564200.8,-144,9766,9910,4773.925746,2471.061085
W64 7250,W64,7250,3086,165671570.5,460,9043,8583,5760.242385,2409.532274
W65 7250,W65,7250,3074,165027351.9,135,8679,8544,4911.468445,2489.984532
W66 7250,W66,7250,3081,165403146.1,135,8851,8716,4630.127881,2430.737594
WB_ E1 7250,WB_ E1,7250,3071,164866297.2,130,9272,9142,4610.467926,2522.878038
WB_ E10 7250,WB_ E10,7250,3079,165295776.3,659,9145,8486,4755.602793,2301.607717
WB_ E2 7250,WB_ E2,7250,3075,165081036.7,911,9342,8431,6394.050407,2298.238477
WB_ E3 7250,WB_ E3,7250,3080,165349461.2,3008,8963,5955,7763.09026,631.9522542
WB_ E4 7250,WB_ E4,7250,3077,165188406.5,1905,9009,7104,7961.076698,1221.416798
WB_ E5 7250,WB_ E5,7250,3072,164919982.1,130,9272,9142,4848.034505,2401.156147
WB_ E6 7250,WB_ E6,7250,3082,165456831,3375,9530,6155,7608.280662,715.10699
WB_ E7 7250,WB_ E7,7250,3070,164812612.3,615,9787,9172,5881.237459,2278.970079
WB_ E8 7250,WB_ E8,7250,3073,164973667,1510,9352,7842,5952.552229,2406.257365
WB_ E9 7250,WB_ E9,7250,3080,165349461.2,854,8841,7987,5583.913636,2417.040956
WB_ H1 7250,WB_ H1,7250,3090,165886310.1,1596,8878,7282,7056.174757,1823.531503
WB_ H10 7250,WB_ H10,7250,3084,165564200.8,1525,8878,7353,6258.140402,2009.986973
WB_ H2 7250,WB_ H2,7250,3075,165081036.7,1724,9009,7285,7369.725528,1748.541087
WB_ H3 7250,WB_ H3,7250,3087,165725255.4,896,9261,8365,6726.590217,2232.239387
WB_ H4 7250,WB_ H4,7250,3076,165134721.6,1511,9112,7601,6561.862159,1844.16773
WB_ H5 7250,WB_ H5,7250,3075,165081036.7,1174,9008,7834,6264.356748,2285.764991
WB_ H6 7250,WB_ H6,7250,3076,165134721.6,117,9551,9434,6214.506827,2590.784881
WB_ H7 7250,WB_ H7,7250,3077,165188406.5,-503,9898,10401,6773.248619,2325.056873
WB_ H8 7250,WB_ H8,7250,3087,165725255.4,854,8941,8087,5998.198899,2344.102064
WB_ H9 7250,WB_ H9,7250,3073,164973667,130,9272,9142,5267.888383,2519.347389
WB_ S1 7250,WB_ S1,7250,3086,165671570.5,-283,9580,9863,6220.309138,2552.318472
WB_ S10 7250,WB_ S10,7250,3084,165564200.8,-369,9787,10156,4338.968223,2521.779384
WB_ S11 7250,WB_ S11,7250,3082,165456831,748,8755,8007,5725.872485,2492.310599
WB_ S12 7250,WB_ S12,7250,3075,165081036.7,659,9349,8690,5351.150244,2426.455305
WB_ S13 7250,WB_ S13,7250,3074,165027351.9,1174,9074,7900,5998.930709,2357.430267
WB_ S14 7250,WB_ S14,7250,3081,165403146.1,1683,9112,7429,7273.171373,1339.389776
WB_ S15 7250,WB_ S15,7250,3091,165939995,1525,8878,7353,6672.297638,1979.005995
WB_ S16 7250,WB_ S16,7250,3072,164919982.1,477,9240,8763,5942.007487,2345.399057
WB_ S17 7250,WB_ S17,7250,3077,165188406.5,896,9131,8235,7356.190445,1475.1997
WB_ S18 7250,WB_ S18,7250,3074,165027351.9,896,9261,8365,6547.060833,2229.948433
WB_ S19 7250,WB_ S19,7250,3077,165188406.5,1873,8972,7099,7285.857654,1728.425297
WB_ S2 7250,WB_ S2,7250,3077,165188406.5,-1001,9580,10581,3983.271693,3558.67921
WB_ S20 7250,WB_ S20,7250,3074,165027351.9,1414,9134,7720,7890.729018,1486.489275
WB_ S21 7250,WB_ S21,7250,3090,165886310.1,2961,8939,5978,7625.550162,952.111502
WB_ S22 7250,WB_ S22,7250,3081,165403146.1,3375,8963,5588,7657.096397,695.8256562
WB_ S23 7250,WB_ S23,7250,3077,165188406.5,497,9040,8543,6478.170946,1837.684588
WB_ S24 7250,WB_ S24,7250,3075,165081036.7,130,9272,9142,4914.594797,2327.784625
WB_ S25 7250,WB_ S25,7250,3072,164919982.1,775,9017,8242,7044.794271,1632.455845
WB_ S26 7250,WB_ S26,7250,3075,165081036.7,1621,9227,7606,7799.979512,1480.335207
WB_ S27 7250,WB_ S27,7250,3074,165027351.9,2171,9102,6931,8272.423878,909.5230407
WB_ S28 7250,WB_ S28,7250,3083,165510515.9,863,9063,8200,7372.677911,1489.900098
WB_ S29 7250,WB_ S29,7250,3081,165403146.1,2017,8980,6963,6913.320351,1388.00829
WB_ S3 7250,WB_ S3,7250,3086,165671570.5,135,9667,9532,5657.023655,2345.399449
WB_ S4 7250,WB_ S4,7250,3077,165188406.5,289,9185,8896,4313.61586,2428.699524
WB_ S5 7250,WB_ S5,7250,3078,165242091.4,854,9352,8498,5872.036062,2449.035864
WB_ S6 7250,WB_ S6,7250,3077,165188406.5,1423,9112,7689,6225.590185,2027.523951
WB_ S7 7250,WB_ S7,7250,3085,165617885.6,1537,8858,7321,6803.117666,1903.646054
WB_ S8 7250,WB_ S8,7250,3077,165188406.5,210,9749,9539,6942.220344,2122.758717
WB_ S9 7250,WB_ S9,7250,3072,164919982.1,-961,8964,9925,4493.656901,2444.482182
WB_ W1 7250,WB_ W1,7250,3083,165510515.9,755,9063,8308,5960.1012,1896.746529
WB_ W10 7250,WB_ W10,7250,3078,165242091.4,135,9667,9532,5737.782326,2352.311376
WB_ W2 7250,WB_ W2,7250,3081,165403146.1,425,8915,8490,7360.763389,1542.71751
WB_ W3 7250,WB_ W3,7250,3075,165081036.7,863,8841,7978,6440.105041,1635.015475
WB_ W4 7250,WB_ W4,7250,3070,164812612.3,349,9447,9098,6157.18241,1997.579077
WB_ W5 7250,WB_ W5,7250,3077,165188406.5,1117,9043,7926,7243.104322,1525.836837
WB_ W6 7250,WB_ W6,7250,3074,165027351.9,1905,9009,7104,7843.066038,1296.872075
WB_ W7 7250,WB_ W7,7250,3082,165456831,-714,9749,10463,5517.491564,2989.374099
WB_ W8 7250,WB_ W8,7250,3082,165456831,1140,9131,7991,7309.694354,1372.239673
WB_ W9 7250,WB_ W9,7250,3075,165081036.7,1414,8987,7573,7149.003577,1889.50455
W01 7500,W01,7500,3294,176838027.7,249,9551,9302,6959.923801,2034.617278
W02 7500,W02,7500,3296,176945397.4,395,9266,8871,7405.873483,1519.7134
W03 7500,W03,7500,3298,177052767.2,863,9063,8200,7124.644027,1639.987687
W04 7500,W04,7500,3280,176086439.2,395,9063,8668,7429.853049,1417.682839
W05 7500,W05,7500,3297,176999082.3,425,9313,8888,7238.196239,1682.698647
W06 7500,W06,7500,3295,176891712.5,863,9063,8200,7286.36085,1551.320234
W07 7500,W07,7500,3295,176891712.6,863,9063,8200,6471.511077,1719.481377
W08 7500,W08,7500,3296,176945397.4,1724,9009,7285,7341.762439,1574.245242
W09 7500,W09,7500,3294,176838027.7,1724,8981,7257,7182.318761,1461.548708
W10 7500,W10,7500,3295,176891712.5,1633,9009,7376,7230.445827,1830.540096
W11 7500,W11,7500,3297,176999082.3,755,9063,8308,5945.192903,1907.076843
W12 7500,W12,7500,3295,176891712.6,130,9272,9142,5280.890137,2267.322881
W13 7500,W13,7500,3282,176193809,381,9272,8891,5445.582876,2123.18475
W14 7500,W14,7500,3293,176784342.8,381,8934,8553,6195.725478,2300.399272
W15 7500,W15,7500,3294,176838027.7,726,8939,8213,6817.484821,1942.90358
W16 7500,W16,7500,3294,176838027.7,-503,9898,10401,6485.513054,2349.596154
W17 7500,W17,7500,3299,177106452.1,-503,9480,9983,6846.71264,2209.754148
W18 7500,W18,7500,3297,176999082.3,38,9316,9278,6885.5229,2034.672608
W19 7500,W19,7500,3291,176676973,210,9749,9539,6508.897903,2321.102548
W20 7500,W20,7500,3282,176193809,210,9316,9106,6361.762035,2187.903044
W21 7500,W21,7500,3295,176891712.6,38,9316,9278,6791.570258,1997.160635
W22 7500,W22,7500,3282,176193809,-912,8964,9876,4682.406764,2646.856076
W23 7500,W23,7500,3295,176891712.5,-424,9240,9664,5900.643399,2129.081233
W24 7500,W24,7500,3296,176945397.4,357,9240,8883,6011.345267,2264.66978
W25 7500,W25,7500,3289,176569603.2,751,8931,8180,6214.361204,2056.55861
W26 7500,W26,7500,3297,176999082.3,-424,9787,10211,4986.708826,2480.468398
W27 7500,W27,7500,3298,177052767.2,715,9787,9072,6258.902668,2148.166254
W28 7500,W28,7500,3294,176838027.7,572,9102,8530,6740.867942,1942.851369
W29 7500,W29,7500,3297,176999082.3,572,9102,8530,6594.432818,1941.461413
W30 7500,W30,7500,3296,176945397.4,1052,9131,8079,7318.271845,1370.179334
W31 7500,W31,7500,3295,176891712.5,2171,9110,6939,8455.892868,642.0379194
W32 7500,W32,7500,3300,177160137,1621,9227,7606,7940.015455,1321.913263
W33 7500,W33,7500,3297,176999082.3,1117,9206,8089,7449.993631,1542.016438
W34 7500,W34,7500,3301,177213821.9,896,9261,8365,6654.065132,2083.242326
W35 7500,W35,7500,3300,177160137,1873,9227,7354,7643.247576,1603.424029
W36 7500,W36,7500,3298,177052767.2,1892,9134,7242,7387.486052,1774.513179
W37 7500,W37,7500,3296,176945397.4,1414,9134,7720,7595.325243,1727.93776
W38 7500,W38,7500,3300,177160137,2170,9134,6964,8306.828485,741.2722382
W39 7500,W39,7500,3289,176569603.2,2961,8939,5978,7859.900882,929.887151
W40 7500,W40,7500,3298,177052767.2,1235,8996,7761,6708.696483,2166.885754
W41 7500,W41,7500,3298,177052767.2,1174,8876,7702,6763.724985,1870.156833
W42 7500,W42,7500,3297,176999082.3,2170,8996,6826,7737.894753,1067.407545
W43 7500,W43,7500,3296,176945397.4,3023,9530,6507,7604.971784,817.017809
W44 7500,W44,7500,3302,177267506.8,1683,8939,7256,7128.214113,1465.303002
W45 7500,W45,7500,3301,177213821.9,1525,8939,7414,7023.478946,1632.03133
W46 7500,W46,7500,3300,177160137,1525,8878,7353,6576.451212,2020.542591
W47 7500,W47,7500,3301,177213821.9,1537,8906,7369,6744.395638,1977.420167
W48 7500,W48,7500,3303,177321191.7,1936,9269,7333,7640.679685,1189.191913
W49 7500,W49,7500,3289,176569603.2,1537,9269,7732,6857.379447,1781.491293
W50 7500,W50,7500,3300,177160137,1537,8872,7335,7266.275758,1628.509096
W51 7500,W51,7500,3301,177213821.9,1417,8858,7441,6780.354438,1936.228263
W52 7500,W52,7500,3300,177160137,1589,8774,7185,6331.537879,1922.226846
W53 7500,W53,7500,3301,177213821.9,1511,8758,7247,6505.369585,1955.461701
W54 7500,W54,7500,3302,177267506.8,1142,8706,7564,5735.160812,2106.688772
W55 7500,W55,7500,3283,176247493.9,1342,9145,7803,6856.346634,2082.065502
W56 7500,W56,7500,3297,176999082.3,1235,8959,7724,6578.773127,2150.035089
W57 7500,W57,7500,3299,177106452.1,802,9352,8550,5827.808124,2428.283946
W58 7500,W58,7500,3282,176193809,723,9352,8629,5960.166057,2431.520204
W59 7500,W59,7500,3290,176623288.1,659,9185,8526,5267.315805,2466.440323
W60 7500,W60,7500,3293,176784342.8,748,9191,8443,6914.847252,2064.557003
W61 7500,W61,7500,3299,177106452.1,896,9191,8295,7096.659594,1919.273157
W62 7500,W62,7500,3298,177052767.2,615,9787,9172,5798.786841,2490.285506
W63 7500,W63,7500,3296,176945397.4,-369,9766,10135,4830.333434,2476.902896
W64 7500,W64,7500,3300,177160137,460,9043,8583,5705.27,2429.594904
W65 7500,W65,7500,3287,176462233.4,135,8679,8544,4946.875875,2492.015903
W66 7500,W66,7500,3298,177052767.2,135,8851,8716,4701.539418,2449.991844
WB_ E1 7500,WB_ E1,7500,3288,176515918.3,130,9272,9142,4700.491484,2524.136316
WB_ E10 7500,WB_ E10,7500,3297,176999082.3,659,9145,8486,4784.475584,2325.959289
WB_ E2 7500,WB_ E2,7500,3296,176945397.4,748,9427,8679,6347.927488,2310.611572
WB_ E3 7500,WB_ E3,7500,3299,177106452.1,1918,8963,7045,7747.719612,680.3520454
WB_ E4 7500,WB_ E4,7500,3294,176838027.7,1905,9009,7104,7951.226776,1215.422667
WB_ E5 7500,WB_ E5,7500,3286,176408548.5,130,9272,9142,4887.801278,2380.159941
WB_ E6 7500,WB_ E6,7500,3302,177267506.8,3375,9530,6155,7626.164143,704.310987
WB_ E7 7500,WB_ E7,7500,3297,176999082.3,453,9787,9334,5875.574765,2280.518179
WB_ E8 7500,WB_ E8,7500,3296,176945397.4,1409,9352,7943,5956.822209,2393.297131
WB_ E9 7500,WB_ E9,7500,3282,176193809,854,8841,7987,5598.194089,2414.53207
WB_ H1 7500,WB_ H1,7500,3304,177374876.6,1568,8878,7310,7010.895884,1848.770069
WB_ H10 7500,WB_ H10,7500,3297,176999082.3,1525,8878,7353,6315.422505,1992.844286
WB_ H2 7500,WB_ H2,7500,3283,176247493.9,1724,9009,7285,7403.422175,1717.973033
WB_ H3 7500,WB_ H3,7500,3296,176945397.4,896,9261,8365,6804.461772,2211.411147
WB_ H4 7500,WB_ H4,7500,3300,177160137,1511,9112,7601,6574.912424,1825.347178
WB_ H5 7500,WB_ H5,7500,3300,177160137,1174,9074,7900,6302.335455,2287.196086
WB_ H6 7500,WB_ H6,7500,3293,176784342.8,117,9551,9434,6250.870027,2568.063985
WB_ H7 7500,WB_ H7,7500,3293,176784342.8,-503,9898,10401,6797.420589,2304.549549
WB_ H8 7500,WB_ H8,7500,3297,176999082.3,854,9005,8151,5922.140127,2371.297091
WB_ H9 7500,WB_ H9,7500,3296,176945397.4,130,9272,9142,5298.725728,2509.782191
WB_ S1 7500,WB_ S1,7500,3295,176891712.5,-283,9580,9863,6280.827314,2521.80122
WB_ S10 7500,WB_ S10,7500,3295,176891712.5,-842,9787,10629,4303.522914,2550.098159
WB_ S11 7500,WB_ S11,7500,3296,176945397.4,659,8755,8096,5737.393507,2479.64478
WB_ S12 7500,WB_ S12,7500,3286,176408548.5,659,9349,8690,5377.837188,2425.942221
WB_ S13 7500,WB_ S13,7500,3289,176569603.2,1174,9074,7900,6055.356947,2337.847602
WB_ S14 7500,WB_ S14,7500,3280,176086439.2,1683,9112,7429,7243.667988,1357.926465
WB_ S15 7500,WB_ S15,7500,3301,177213821.9,1525,8878,7353,6650.477128,1991.576686
WB_ S16 7500,WB_ S16,7500,3286,176408548.5,151,9240,9089,5942.429397,2342.610327
WB_ S17 7500,WB_ S17,7500,3296,176945397.4,896,9131,8235,7321.827973,1505.455679
WB_ S18 7500,WB_ S18,7500,3296,176945397.4,896,9261,8365,6574.59193,2212.921401
WB_ S19 7500,WB_ S19,7500,3293,176784342.8,1873,8972,7099,7301.728515,1724.699233
WB_ S2 7500,WB_ S2,7500,3284,176301178.8,-1001,9580,10581,4007.706456,3550.180837
WB_ S20 7500,WB_ S20,7500,3302,177267506.8,1414,9134,7720,7853.687159,1531.147621
WB_ S21 7500,WB_ S21,7500,3301,177213821.9,2961,8939,5978,7645.31233,934.5307828
WB_ S22 7500,WB_ S22,7500,3300,177160137,3375,8963,5588,7651.229091,710.4658427
WB_ S23 7500,WB_ S23,7500,3294,176838027.7,497,9040,8543,6477.261991,1857.829804
WB_ S24 7500,WB_ S24,7500,3296,176945397.4,130,9272,9142,4965.574029,2310.796584
WB_ S25 7500,WB_ S25,7500,3298,177052767.2,775,9017,8242,7002.05003,1674.223861
WB_ S26 7500,WB_ S26,7500,3296,176945397.4,1621,9227,7606,7755.734223,1525.476718
WB_ S27 7500,WB_ S27,7500,3296,176945397.4,2171,9102,6931,8270.531857,920.8565564
WB_ S28 7500,WB_ S28,7500,3293,176784342.8,395,9063,8668,7311.432736,1549.902604
WB_ S29 7500,WB_ S29,7500,3297,176999082.3,1665,9003,7338,6905.427055,1414.35086
WB_ S3 7500,WB_ S3,7500,3296,176945397.4,135,9667,9532,5624.158374,2362.939574
WB_ S4 7500,WB_ S4,7500,3300,177160137,289,9185,8896,4288.52,2423.599501
WB_ S5 7500,WB_ S5,7500,3288,176515918.3,854,9352,8498,5858.644465,2444.975487
WB_ S6 7500,WB_ S6,7500,3297,176999082.3,1423,9112,7689,6232.937216,2030.625731
WB_ S7 7500,WB_ S7,7500,3300,177160137,1417,8858,7441,6767.434242,1925.688948
WB_ S8 7500,WB_ S8,7500,3294,176838027.7,210,9749,9539,6923.165452,2117.156581
WB_ S9 7500,WB_ S9,7500,3287,176462233.4,-961,9305,10266,4542.746273,2473.241071
WB_ W1 7500,WB_ W1,7500,3299,177106452.1,755,9063,8308,5998.632616,1899.916286
WB_ W10 7500,WB_ W10,7500,3296,176945397.4,135,9667,9532,5697.770631,2372.840774
WB_ W2 7500,WB_ W2,7500,3294,176838027.7,425,8915,8490,7341.279903,1564.458678
WB_ W3 7500,WB_ W3,7500,3295,176891712.5,863,8902,8039,6458.880728,1646.590167
WB_ W4 7500,WB_ W4,7500,3289,176569603.2,349,9447,9098,6126.37215,2048.032888
WB_ W5 7500,WB_ W5,7500,3280,176086439.2,1117,9043,7926,7216.072866,1561.414847
WB_ W6 7500,WB_ W6,7500,3297,176999082.3,1905,9009,7104,7858.307856,1284.684488
WB_ W7 7500,WB_ W7,7500,3295,176891712.6,-714,9749,10463,5513.321396,2982.491854
WB_ W8 7500,WB_ W8,7500,3295,176891712.5,1052,9131,8079,7288.101366,1425.771959
WB_ W9 7500,WB_ W9,7500,3296,176945397.4,1414,9134,7720,7126.986347,1905.38058
W01 7750,W01,7750,3521,189024497.7,249,9551,9302,6981.725646,2026.332113
W02 7750,W02,7750,3517,188809758.1,343,9266,8923,7364.942849,1568.392059
W03 7750,W03,7750,3505,188165539.4,863,9063,8200,7115.229957,1635.820906
W04 7750,W04,7750,3513,188595018.6,395,9102,8707,7359.896385,1499.15655
W05 7750,W05,7750,3518,188863443,425,9313,8888,7247.780273,1682.508502
W06 7750,W06,7750,3520,188970812.8,863,9063,8200,7249.341477,1572.619259
W07 7750,W07,7750,3518,188863443,863,9063,8200,6491.683343,1725.174242
W08 7750,W08,7750,3519,188917127.9,1724,9009,7285,7315.013072,1580.183436
W09 7750,W09,7750,3522,189078182.6,1724,8981,7257,7169.771721,1468.175441
W10 7750,W10,7750,3519,188917127.9,1633,9009,7376,7229.136687,1833.931377
W11 7750,W11,7750,3520,188970812.8,595,9063,8468,5973.865341,1922.754123
W12 7750,W12,7750,3517,188809758.1,130,9272,9142,5285.773102,2276.834909
W13 7750,W13,7750,3515,188702388.3,381,9272,8891,5486.432432,2130.204515
W14 7750,W14,7750,3513,188595018.6,381,8934,8553,6219.167094,2279.511853
W15 7750,W15,7750,3520,188970812.8,681,8939,8258,6789.875568,1973.646655
W16 7750,W16,7750,3521,189024497.7,-503,9898,10401,6469.888952,2357.476799
W17 7750,W17,7750,3517,188809758.1,-503,9480,9983,6811.591129,2237.694463
W18 7750,W18,7750,3512,188541333.7,38,9604,9566,6826.785877,2077.028357
W19 7750,W19,7750,3514,188648703.5,210,9749,9539,6496.612977,2347.39316
W20 7750,W20,7750,3515,188702388.3,210,9316,9106,6328.507539,2204.197837
W21 7750,W21,7750,3517,188809758.1,38,9316,9278,6789.807222,1985.144842
W22 7750,W22,7750,3514,188648703.5,-961,8964,9925,4727.307911,2676.67216
W23 7750,W23,7750,3520,188970812.8,-424,9240,9664,5888.453125,2164.160458
W24 7750,W24,7750,3521,189024497.7,357,9240,8883,6012.077535,2250.817842
W25 7750,W25,7750,3516,188756073.2,477,8960,8483,6173.280148,2079.575457
W26 7750,W26,7750,3511,188487648.8,-424,9787,10211,4999.978639,2478.144176
W27 7750,W27,7750,3524,189185552.4,715,9787,9072,6218.162883,2163.256306
W28 7750,W28,7750,3510,188433963.9,477,9102,8625,6730.685755,1938.714431
W29 7750,W29,7750,3515,188702388.3,572,9102,8530,6598.359602,1939.817492
W30 7750,W30,7750,3521,189024497.7,1017,9131,8114,7290.126101,1418.135026
W31 7750,W31,7750,3518,188863443,2171,9110,6939,8443.885446,665.5038705
W32 7750,W32,7750,3530,189507661.7,1621,9227,7606,7912.750425,1333.278649
W33 7750,W33,7750,3520,188970812.8,1117,9206,8089,7438.061364,1547.094319
W34 7750,W34,7750,3521,189024497.7,896,9261,8365,6643.423459,2101.886163
W35 7750,W35,7750,3529,189453976.8,1873,9227,7354,7644.246245,1611.818256
W36 7750,W36,7750,3529,189453976.8,1892,9134,7242,7411.643808,1760.602778
W37 7750,W37,7750,3514,188648703.5,1414,9134,7720,7605.104724,1722.489319
W38 7750,W38,7750,3527,189346607,2170,9134,6964,8274.631131,792.2372002
W39 7750,W39,7750,3520,188970812.8,2961,8939,5978,7869.696023,924.5277294
W40 7750,W40,7750,3521,189024497.7,1235,8996,7761,6722.394206,2163.332538
W41 7750,W41,7750,3517,188809758.1,1174,8996,7822,6749.677282,1896.748785
W42 7750,W42,7750,3519,188917127.9,1676,8996,7320,7703.745951,1114.107173
W43 7750,W43,7750,3517,188809758.1,2961,9530,6569,7608.410293,819.3493721
W44 7750,W44,7750,3518,188863443,1683,8939,7256,7123.484935,1462.651308
W45 7750,W45,7750,3526,189292922.1,1525,8939,7414,7026.326432,1628.289411
W46 7750,W46,7750,3523,189131867.5,1525,8878,7353,6595.975305,2000.768392
W47 7750,W47,7750,3522,189078182.6,1537,8906,7369,6753.333617,1977.189822
W48 7750,W48,7750,3522,189078182.6,1936,9269,7333,7639.215219,1183.262488
W49 7750,W49,7750,3522,189078182.6,1537,9269,7732,6891.264055,1764.942211
W50 7750,W50,7750,3519,188917127.9,1537,8872,7335,7220.886616,1670.471391
W51 7750,W51,7750,3521,189024497.7,1417,8872,7455,6728.037489,1959.364693
W52 7750,W52,7750,3516,188756073.2,1589,8774,7185,6367.172071,1914.255977
W53 7750,W53,7750,3520,188970812.8,1511,8832,7321,6497.310795,1957.046752
W54 7750,W54,7750,3523,189131867.5,1142,8706,7564,5745.039455,2102.145902
W55 7750,W55,7750,3517,188809758.1,1342,9145,7803,6829.058288,2084.184665
W56 7750,W56,7750,3523,189131867.5,1235,8972,7737,6528.420948,2160.663366
W57 7750,W57,7750,3521,189024497.7,802,9352,8550,5777.276342,2446.852656
W58 7750,W58,7750,3519,188917127.9,723,9352,8629,5886.689685,2454.241259
W59 7750,W59,7750,3514,188648703.5,659,9237,8578,5358.770632,2468.528494
W60 7750,W60,7750,3514,188648703.5,748,9191,8443,6853.339784,2104.53319
W61 7750,W61,7750,3521,189024497.7,896,9191,8295,7120.115308,1894.743082
W62 7750,W62,7750,3507,188272909.2,615,9787,9172,5840.715426,2491.648682
W63 7750,W63,7750,3524,189185552.4,-369,9766,10135,4883.744041,2479.0878
W64 7750,W64,7750,3525,189239237.2,135,9043,8908,5652.840567,2446.891438
W65 7750,W65,7750,3519,188917127.9,135,8679,8544,4990.971583,2489.661591
W66 7750,W66,7750,3520,188970812.8,135,8905,8770,4748.142045,2468.789461
WB_ E1 7750,WB_ E1,7750,3516,188756073.2,130,9272,9142,4792.930034,2519.344684
WB_ E10 7750,WB_ E10,7750,3523,189131867.5,659,9145,8486,4812.560034,2343.278621
WB_ E2 7750,WB_ E2,7750,3522,189078182.6,748,9427,8679,6300.76803,2327.159887
WB_ E3 7750,WB_ E3,7750,3522,189078182.6,1913,8963,7050,7720.080068,767.5535162
WB_ E4 7750,WB_ E4,7750,3517,188809758.1,1905,9009,7104,7948.461473,1203.057455
WB_ E5 7750,WB_ E5,7750,3516,188756073.2,130,9272,9142,4905.790387,2368.768154
WB_ E6 7750,WB_ E6,7750,3512,188541333.7,3375,9530,6155,7637.214408,694.7023558
WB_ E7 7750,WB_ E7,7750,3511,188487648.8,453,9787,9334,5883.581886,2279.692037
WB_ E8 7750,WB_ E8,7750,3513,188595018.6,1409,9352,7943,5957.929405,2380.675016
WB_ E9 7750,WB_ E9,7750,3512,188541333.7,854,8841,7987,5615.842255,2410.005476
WB_ H1 7750,WB_ H1,7750,3521,189024497.7,1568,8878,7310,6959.461801,1878.610499
WB_ H10 7750,WB_ H10,7750,3523,189131867.5,1525,8878,7353,6377.360204,1978.744676
WB_ H2 7750,WB_ H2,7750,3515,188702388.3,1724,9009,7285,7435.967852,1688.018773
WB_ H3 7750,WB_ H3,7750,3527,189346607,896,9261,8365,6867.988942,2181.317942
WB_ H4 7750,WB_ H4,7750,3516,188756073.2,1485,9112,7627,6585.316268,1808.773718
WB_ H5 7750,WB_ H5,7750,3514,188648703.5,1174,9074,7900,6335.338645,2286.973034
WB_ H6 7750,WB_ H6,7750,3509,188380279,117,9551,9434,6282.874038,2550.479936
WB_ H7 7750,WB_ H7,7750,3515,188702388.3,-503,9898,10401,6815.708108,2282.325257
WB_ H8 7750,WB_ H8,7750,3529,189453976.8,854,9352,8498,5865.198356,2389.315175
WB_ H9 7750,WB_ H9,7750,3507,188272909.2,130,9272,9142,5330.869119,2507.310943
WB_ S1 7750,WB_ S1,7750,3523,189131867.5,-283,9580,9863,6327.077491,2498.878623
WB_ S10 7750,WB_ S10,7750,3524,189185552.4,-961,9787,10748,4281.5542,2578.69127
WB_ S11 7750,WB_ S11,7750,3518,188863443,659,8903,8244,5746.008243,2469.284564
WB_ S12 7750,WB_ S12,7750,3514,188648703.5,659,9349,8690,5390.435117,2428.199232
WB_ S13 7750,WB_ S13,7750,3520,188970812.8,1174,9074,7900,6114.383807,2311.159687
WB_ S14 7750,WB_ S14,7750,3514,188648703.5,1683,9112,7429,7204.02988,1391.478042
WB_ S15 7750,WB_ S15,7750,3528,189400291.9,1525,8878,7353,6644.276927,1989.520715
WB_ S16 7750,WB_ S16,7750,3516,188756073.2,136,9240,9104,5934.476109,2349.864473
WB_ S17 7750,WB_ S17,7750,3518,188863443,896,9131,8235,7283.708357,1540.731336
WB_ S18 7750,WB_ S18,7750,3515,188702388.3,896,9261,8365,6606.700996,2189.096968
WB_ S19 7750,WB_ S19,7750,3514,188648703.5,1873,8976,7103,7318.774047,1719.61682
WB_ S2 7750,WB_ S2,7750,3513,188595018.6,-1001,9580,10581,4023.945346,3533.596281
WB_ S20 7750,WB_ S20,7750,3508,188326594.1,1414,9134,7720,7820.359749,1559.832962
WB_ S21 7750,WB_ S21,7750,3530,189507661.7,2961,8939,5978,7663.53966,917.0464137
WB_ S22 7750,WB_ S22,7750,3516,188756073.2,3375,8963,5588,7646.007679,710.1421005
WB_ S23 7750,WB_ S23,7750,3514,188648703.5,497,9040,8543,6478.145418,1871.248808
WB_ S24 7750,WB_ S24,7750,3507,188272909.2,130,9272,9142,5014.702025,2293.97289
WB_ S25 7750,WB_ S25,7750,3513,188595018.6,775,9017,8242,6962.062055,1710.900004
WB_ S26 7750,WB_ S26,7750,3520,188970812.8,1621,9227,7606,7707.602841,1569.707779
WB_ S27 7750,WB_ S27,7750,3516,188756073.2,2171,9102,6931,8267.926906,933.7078279
WB_ S28 7750,WB_ S28,7750,3523,189131867.5,395,9063,8668,7259.79648,1591.546961
WB_ S29 7750,WB_ S29,7750,3521,189024497.7,1665,9003,7338,6892.917353,1444.77497
WB_ S3 7750,WB_ S3,7750,3527,189346607,135,9667,9532,5590.061242,2382.500115
WB_ S4 7750,WB_ S4,7750,3510,188433963.9,289,9185,8896,4283.07151,2415.554224
WB_ S5 7750,WB_ S5,7750,3518,188863443,854,9352,8498,5838.831438,2445.176191
WB_ S6 7750,WB_ S6,7750,3515,188702388.3,1423,9112,7689,6247.922617,2028.39631
WB_ S7 7750,WB_ S7,7750,3522,189078182.6,1417,8858,7441,6727.400909,1948.013318
WB_ S8 7750,WB_ S8,7750,3506,188219224.3,210,9749,9539,6913.50599,2114.101695
WB_ S9 7750,WB_ S9,7750,3515,188702388.3,-961,9422,10383,4604.374111,2496.069435
WB_ W1 7750,WB_ W1,7750,3523,189131867.5,755,9063,8308,6032.07891,1909.561563
WB_ W10 7750,WB_ W10,7750,3510,188433963.9,135,9667,9532,5664.581197,2389.6281
WB_ W2 7750,WB_ W2,7750,3515,188702388.3,425,9063,8638,7315.986913,1587.813394
WB_ W3 7750,WB_ W3,7750,3515,188702388.3,863,8934,8071,6482.854339,1657.993162
WB_ W4 7750,WB_ W4,7750,3513,188595018.6,349,9787,9438,6087.896385,2091.314066
WB_ W5 7750,WB_ W5,7750,3510,188433963.9,1117,9110,7993,7201.737322,1587.625048
WB_ W6 7750,WB_ W6,7750,3508,188326594.1,1905,9009,7104,7866.582668,1274.146755
WB_ W7 7750,WB_ W7,7750,3524,189185552.4,-714,9749,10463,5510.544835,2978.978899
WB_ W8 7750,WB_ W8,7750,3520,188970812.8,1052,9131,8079,7264.108239,1474.40179
WB_ W9 7750,WB_ W9,7750,3515,188702388.3,1414,9134,7720,7102.847511,1916.672253
W01 8000,W01,8000,3746,201103597.9,249,9551,9302,6995.595302,2025.472011
W02 8000,W02,8000,3746,201103597.9,249,9266,9017,7329.593433,1606.673924
W03 8000,W03,8000,3749,201264652.6,863,9063,8200,7100.266204,1638.505321
W04 8000,W04,8000,3734,200459379.3,395,9102,8707,7302.556508,1554.846604
W05 8000,W05,8000,3750,201318337.5,425,9313,8888,7241.858133,1687.962309
W06 8000,W06,8000,3749,201264652.6,863,9063,8200,7214.6255,1587.808997
W07 8000,W07,8000,3748,201210967.7,863,9063,8200,6513.152348,1727.446897
W08 8000,W08,8000,3747,201157282.8,1724,9009,7285,7286.785428,1589.288214
W09 8000,W09,8000,3746,201103597.9,1724,8981,7257,7164.852109,1475.732197
W10 8000,W10,8000,3746,201103597.9,1633,9009,7376,7233.12173,1835.457304
W11 8000,W11,8000,3748,201210967.7,595,9063,8468,5994.901281,1939.329334
W12 8000,W12,8000,3747,201157282.8,130,9272,9142,5307.86309,2283.7199
W13 8000,W13,8000,3737,200620433.9,381,9272,8891,5525.443136,2135.321422
W14 8000,W14,8000,3749,201264652.6,381,8934,8553,6252.581755,2252.925706
W15 8000,W15,8000,3747,201157282.8,507,8939,8432,6763.769949,2004.37004
W16 8000,W16,8000,3745,201049913.1,-503,9898,10401,6472.128972,2353.921232
W17 8000,W17,8000,3747,201157282.8,-503,9480,9983,6769.043235,2264.076901
W18 8000,W18,8000,3747,201157282.8,38,9604,9566,6770.942087,2119.917919
W19 8000,W19,8000,3746,201103597.9,-41,9749,9790,6479.95275,2376.837265
W20 8000,W20,8000,3739,200727803.7,210,9604,9394,6304.665953,2217.16414
W21 8000,W21,8000,3747,201157282.8,38,9316,9278,6783.02055,1980.75857
W22 8000,W22,8000,3739,200727803.7,-961,8964,9925,4754.319069,2709.512238
W23 8000,W23,8000,3749,201264652.6,-424,9240,9664,5857.17498,2216.331798
W24 8000,W24,8000,3748,201210967.7,151,9240,9089,6007.05016,2251.4243
W25 8000,W25,8000,3747,201157282.8,477,9146,8669,6152.239392,2092.157072
W26 8000,W26,8000,3748,201210967.7,-424,9787,10211,5027.302828,2483.838153
W27 8000,W27,8000,3749,201264652.6,715,9787,9072,6183.6263,2170.197091
W28 8000,W28,8000,3749,201264652.6,477,9102,8625,6708.01147,1936.856321
W29 8000,W29,8000,3751,201372022.4,572,9102,8530,6592.86217,1955.782646
W30 8000,W30,8000,3750,201318337.5,896,9131,8235,7247.041067,1485.982825
W31 8000,W31,8000,3746,201103597.9,2171,9110,6939,8433.20662,675.9422156
W32 8000,W32,8000,3748,201210967.7,1621,9227,7606,7891.354856,1340.459515
W33 8000,W33,8000,3751,201372022.4,1117,9221,8104,7437.392695,1538.804892
W34 8000,W34,8000,3748,201210967.7,896,9261,8365,6637.685966,2125.719449
W35 8000,W35,8000,3749,201264652.6,1873,9227,7354,7653.235529,1606.598814
W36 8000,W36,8000,3748,201210967.7,1489,9134,7645,7439.545624,1747.826166
W37 8000,W37,8000,3752,201425707.3,1235,9134,7899,7615.059701,1715.817074
W38 8000,W38,8000,3751,201372022.4,2170,9134,6964,8247.395894,834.0112109
W39 8000,W39,8000,3747,201157282.8,2961,8946,5985,7880.116894,918.5119548
W40 8000,W40,8000,3752,201425707.3,1235,8996,7761,6743.486674,2159.124002
W41 8000,W41,8000,3754,201533077.1,1174,9112,7938,6737.338039,1913.517811
W42 8000,W42,8000,3752,201425707.3,1676,8996,7320,7666.231876,1176.820243
W43 8000,W43,8000,3754,201533077.1,2961,9530,6569,7616.219766,809.5710648
W44 8000,W44,8000,3754,201533077.1,1683,8939,7256,7124.092968,1460.375248
W45 8000,W45,8000,3751,201372022.4,1525,8939,7414,7038.932018,1610.69059
W46 8000,W46,8000,3753,201479392.2,1525,8878,7353,6621.42446,1974.722119
W47 8000,W47,8000,3758,201747816.6,1537,8906,7369,6772.816658,1968.621598
W48 8000,W48,8000,3754,201533077.1,1936,9269,7333,7644.985083,1173.741357
W49 8000,W49,8000,3748,201210967.7,1537,9269,7732,6920.245464,1756.402153
W50 8000,W50,8000,3756,201640446.8,1417,8872,7455,7160.509851,1726.769724
W51 8000,W51,8000,3755,201586762,1417,8872,7455,6685.168575,1966.911526
W52 8000,W52,8000,3758,201747816.6,1589,8774,7185,6397.301756,1910.416696
W53 8000,W53,8000,3757,201694131.7,1511,9112,7601,6503.661698,1949.313552
W54 8000,W54,8000,3751,201372022.4,1142,8708,7566,5764.415889,2105.282599
W55 8000,W55,8000,3739,200727803.7,1342,9145,7803,6808.597486,2081.602464
W56 8000,W56,8000,3749,201264652.6,1235,9008,7773,6482.190984,2167.959627
W57 8000,W57,8000,3752,201425707.3,802,9352,8550,5727.473881,2459.6756
W58 8000,W58,8000,3741,200835173.5,723,9352,8629,5838.330928,2462.879854
W59 8000,W59,8000,3748,201210967.7,659,9237,8578,5430.471985,2463.394876
W60 8000,W60,8000,3750,201318337.5,748,9191,8443,6766.795733,2154.277496
W61 8000,W61,8000,3751,201372022.4,896,9191,8295,7131.32658,1877.035825
W62 8000,W62,8000,3754,201533077.1,615,9787,9172,5877.023442,2491.432883
W63 8000,W63,8000,3748,201210967.7,-376,9766,10142,4918.814835,2493.202279
W64 8000,W64,8000,3748,201210967.7,135,9043,8908,5610.58778,2465.524111
W65 8000,W65,8000,3747,201157282.8,135,8688,8553,5022.789165,2494.857634
W66 8000,W66,8000,3751,201372022.4,135,8905,8770,4784.272461,2481.316338
WB_ E1 8000,WB_ E1,8000,3745,201049913.1,130,9272,9142,4880.678238,2511.612852
WB_ E10 8000,WB_ E10,8000,3751,201372022.4,659,9145,8486,4853.921621,2361.588743
WB_ E2 8000,WB_ E2,8000,3749,201264652.6,748,9427,8679,6252.714057,2343.763525
WB_ E3 8000,WB_ E3,8000,3752,201425707.3,1913,8963,7050,7689.00533,839.7844279
WB_ E4 8000,WB_ E4,8000,3748,201210967.7,1905,9009,7104,7949.442102,1188.010696
WB_ E5 8000,WB_ E5,8000,3746,201103597.9,130,9272,9142,4907.761078,2362.730277
WB_ E6 8000,WB_ E6,8000,3758,201747816.6,3375,9530,6155,7642.452634,692.5582046
WB_ E7 8000,WB_ E7,8000,3748,201210967.7,453,9787,9334,5897.317769,2281.316128
WB_ E8 8000,WB_ E8,8000,3753,201479392.2,1235,9352,8117,5948.475886,2370.712502
WB_ E9 8000,WB_ E9,8000,3744,200996228.2,854,8841,7987,5633.149306,2404.995911
WB_ H1 8000,WB_ H1,8000,3751,201372022.4,1568,8878,7310,6923.166356,1888.962832
WB_ H10 8000,WB_ H10,8000,3755,201586762,1525,8878,7353,6431.616511,1962.076015
WB_ H2 8000,WB_ H2,8000,3739,200727803.7,1724,9063,7339,7467.778016,1665.840007
WB_ H3 8000,WB_ H3,8000,3749,201264652.6,896,9261,8365,6909.404908,2149.576124
WB_ H4 8000,WB_ H4,8000,3755,201586762,1485,9112,7627,6585.906258,1799.143847
WB_ H5 8000,WB_ H5,8000,3755,201586762,1174,9074,7900,6358.776565,2287.589677
WB_ H6 8000,WB_ H6,8000,3748,201210967.7,117,9551,9434,6322.398346,2528.145126
WB_ H7 8000,WB_ H7,8000,3745,201049913.1,-503,9898,10401,6845.637917,2250.713254
WB_ H8 8000,WB_ H8,8000,3750,201318337.5,854,9352,8498,5807.155467,2402.151476
WB_ H9 8000,WB_ H9,8000,3753,201479392.2,130,9272,9142,5361.092726,2494.735096
WB_ S1 8000,WB_ S1,8000,3744,200996228.2,-283,9749,10032,6361.441774,2494.013308
WB_ S10 8000,WB_ S10,8000,3748,201210967.7,-961,9787,10748,4267.70651,2603.172942
WB_ S11 8000,WB_ S11,8000,3751,201372022.4,659,8931,8272,5750.931485,2463.499825
WB_ S12 8000,WB_ S12,8000,3748,201210967.7,659,9349,8690,5396.270544,2443.984816
WB_ S13 8000,WB_ S13,8000,3748,201210967.7,1174,9085,7911,6161.952241,2289.176826
WB_ S14 8000,WB_ S14,8000,3743,200942543.3,1683,9112,7429,7152.580016,1439.932536
WB_ S15 8000,WB_ S15,8000,3751,201372022.4,1525,8878,7353,6654.308451,1971.806448
WB_ S16 8000,WB_ S16,8000,3744,200996228.2,130,9240,9110,5917.903579,2366.384987
WB_ S17 8000,WB_ S17,8000,3746,201103597.9,896,9131,8235,7239.703951,1593.477172
WB_ S18 8000,WB_ S18,8000,3751,201372022.4,896,9261,8365,6628.394028,2176.125272
WB_ S19 8000,WB_ S19,8000,3750,201318337.5,1873,8976,7103,7332.442933,1721.854426
WB_ S2 8000,WB_ S2,8000,3736,200566749,-1015,9580,10595,4029.179069,3515.104364
WB_ S20 8000,WB_ S20,8000,3757,201694131.7,1414,9134,7720,7790.694171,1567.225044
WB_ S21 8000,WB_ S21,8000,3752,201425707.3,2961,8939,5978,7678.228145,903.0777219
WB_ S22 8000,WB_ S22,8000,3754,201533077.1,3375,8963,5588,7645.658231,703.9829121
WB_ S23 8000,WB_ S23,8000,3748,201210967.7,497,9063,8566,6498.573639,1872.738052
WB_ S24 8000,WB_ S24,8000,3752,201425707.3,130,9272,9142,5065.456557,2281.166932
WB_ S25 8000,WB_ S25,8000,3749,201264652.6,775,9017,8242,6943.020539,1723.588603
WB_ S26 8000,WB_ S26,8000,3746,201103597.9,1621,9227,7606,7660.579818,1605.056367
WB_ S27 8000,WB_ S27,8000,3750,201318337.5,2171,9128,6957,8258.949867,944.2019884
WB_ S28 8000,WB_ S28,8000,3747,201157282.8,395,9063,8668,7234.001868,1605.651068
WB_ S29 8000,WB_ S29,8000,3748,201210967.7,1137,9003,7866,6872.76174,1489.468765
WB_ S3 8000,WB_ S3,8000,3749,201264652.6,135,9667,9532,5554.654308,2402.999962
WB_ S4 8000,WB_ S4,8000,3755,201586762,289,9185,8896,4302.867377,2407.908162
WB_ S5 8000,WB_ S5,8000,3748,201210967.7,854,9352,8498,5822.994664,2444.599857
WB_ S6 8000,WB_ S6,8000,3754,201533077.1,1423,9112,7689,6276.524241,2022.550334
WB_ S7 8000,WB_ S7,8000,3754,201533077.1,1417,8858,7441,6704.571124,1956.336158
WB_ S8 8000,WB_ S8,8000,3753,201479392.2,210,9749,9539,6899.269384,2112.075518
WB_ S9 8000,WB_ S9,8000,3746,201103597.9,-961,9422,10383,4650.146022,2514.603077
WB_ W1 8000,WB_ W1,8000,3745,201049913.1,755,9063,8308,6056.48785,1927.991791
WB_ W10 8000,WB_ W10,8000,3750,201318337.5,135,9771,9636,5635.760533,2400.090515
WB_ W2 8000,WB_ W2,8000,3746,201103597.9,425,9063,8638,7296.073679,1598.489313
WB_ W3 8000,WB_ W3,8000,3748,201210967.7,863,8960,8097,6502.800961,1679.491733
WB_ W4 8000,WB_ W4,8000,3744,200996228.2,349,9787,9438,6044.174145,2135.283964
WB_ W5 8000,WB_ W5,8000,3738,200674118.8,1117,9110,7993,7197.362761,1596.386328
WB_ W6 8000,WB_ W6,8000,3749,201264652.6,1905,9009,7104,7876.436116,1260.773391
WB_ W7 8000,WB_ W7,8000,3746,201103597.9,-714,9749,10463,5511.025894,2975.201924
WB_ W8 8000,WB_ W8,8000,3750,201318337.5,1052,9131,8079,7250.389067,1507.591541
WB_ W9 8000,WB_ W9,8000,3753,201479392.2,1235,9134,7899,7089.800693,1923.046569
W01 8250,W01,8250,3988,214095341.3,249,9551,9302,7011.782598,2022.955856
W02 8250,W02,8250,3982,213773232,249,9266,9017,7296.742341,1646.267777
W03 8250,W03,8250,3983,213826916.9,863,9063,8200,7086.306302,1632.45223
W04 8250,W04,8250,3989,214149026.2,395,9102,8707,7247.092504,1614.734019
W05 8250,W05,8250,3981,213719547.1,425,9313,8888,7234.470987,1695.831355
W06 8250,W06,8250,3984,213880601.8,863,9063,8200,7181.639809,1604.059115
W07 8250,W07,8250,3983,213826916.9,863,9063,8200,6534.509415,1730.119412
W08 8250,W08,8250,3984,213880601.8,1724,9009,7285,7257.569026,1606.171918
W09 8250,W09,8250,3990,214202711.1,1724,8981,7257,7160.114286,1482.975424
W10 8250,W10,8250,3981,213719547.1,1534,9009,7475,7229.439839,1842.22265
W11 8250,W11,8250,3983,213826916.9,595,9063,8468,6021.509917,1953.477109
W12 8250,W12,8250,3980,213665862.2,130,9272,9142,5339.020603,2288.840498
W13 8250,W13,8250,3992,214310080.9,381,9272,8891,5564.293587,2138.693994
W14 8250,W14,8250,3981,213719547.1,381,8934,8553,6276.744285,2233.665315
W15 8250,W15,8250,3989,214149026.2,381,8981,8600,6745.180998,2037.491956
W16 8250,W16,8250,3988,214095341.3,-503,9898,10401,6494.858325,2344.08542
W17 8250,W17,8250,3982,213773232,-503,9480,9983,6744.579106,2262.599559
W18 8250,W18,8250,3981,213719547.1,38,9604,9566,6720.873147,2150.1613
W19 8250,W19,8250,3981,213719547.1,-286,9749,10035,6473.505401,2394.367649
W20 8250,W20,8250,3985,213934286.7,210,9604,9394,6295.592974,2220.0583
W21 8250,W21,8250,3981,213719547.1,38,9316,9278,6757.384828,2002.749585
W22 8250,W22,8250,3986,213987971.5,-961,8964,9925,4787.824385,2735.618097
W23 8250,W23,8250,3985,213934286.7,-424,9240,9664,5846.796989,2255.564776
W24 8250,W24,8250,3986,213987971.5,151,9240,9089,6014.198695,2247.288597
W25 8250,W25,8250,3985,213934286.7,477,9422,8945,6136.61857,2105.051018
W26 8250,W26,8250,3983,213826916.9,-424,9787,10211,5044.442631,2494.900445
W27 8250,W27,8250,3987,214041656.4,715,9787,9072,6157.839227,2176.754751
W28 8250,W28,8250,3981,213719547.1,477,9102,8625,6683.411454,1939.375089
W29 8250,W29,8250,3983,213826916.9,477,9102,8625,6586.29877,1973.463792
W30 8250,W30,8250,3987,214041656.4,896,9131,8235,7197.207424,1561.58264
W31 8250,W31,8250,3985,213934286.7,2171,9110,6939,8420.756336,688.959127
W32 8250,W32,8250,3987,214041656.4,1621,9227,7606,7866.208427,1357.053627
W33 8250,W33,8250,3986,213987971.5,1117,9227,8110,7428.202459,1536.968334
W34 8250,W34,8250,3992,214310080.9,896,9261,8365,6632.957916,2147.567663
W35 8250,W35,8250,3985,213934286.7,1873,9227,7354,7671.136763,1586.651768
W36 8250,W36,8250,3991,214256396,1489,9134,7645,7468.122526,1734.012858
W37 8250,W37,8250,3987,214041656.4,1235,9134,7899,7625.05217,1708.692174
W38 8250,W38,8250,3993,214363765.8,2170,9134,6964,8222.09717,878.1931788
W39 8250,W39,8250,3991,214256396,2961,8946,5985,7888.738161,912.0249966
W40 8250,W40,8250,3985,213934286.7,1235,8996,7761,6769.115684,2153.430669
W41 8250,W41,8250,3987,214041656.4,1174,9112,7938,6718.934537,1930.05145
W42 8250,W42,8250,3985,213934286.7,1510,8996,7486,7625.523212,1240.573908
W43 8250,W43,8250,3992,214310080.9,2961,9530,6569,7622.948647,797.4274859
W44 8250,W44,8250,3987,214041656.4,1605,8939,7334,7129.83998,1454.916167
W45 8250,W45,8250,3990,214202711.1,1525,8939,7414,7053.965664,1592.378339
W46 8250,W46,8250,3992,214310080.9,1525,8878,7353,6643.214178,1954.190958
W47 8250,W47,8250,3989,214149026.2,1537,8906,7369,6801.198546,1951.550246
W48 8250,W48,8250,3991,214256396,1936,9269,7333,7652.180656,1164.387378
W49 8250,W49,8250,3995,214471135.6,1537,9269,7732,6950.886358,1745.90715
W50 8250,W50,8250,3987,214041656.4,1417,8872,7455,7113.91372,1767.124165
W51 8250,W51,8250,3989,214149026.2,1417,8872,7455,6658.531963,1964.362519
W52 8250,W52,8250,3984,213880601.8,1589,8774,7185,6426.051205,1905.665233
W53 8250,W53,8250,3987,214041656.4,1511,9112,7601,6510.345372,1946.390586
W54 8250,W54,8250,3991,214256396,1142,8758,7616,5792.481333,2105.963206
W55 8250,W55,8250,3995,214471135.6,1342,9145,7803,6800.919149,2070.85211
W56 8250,W56,8250,3990,214202711.1,1235,9145,7910,6422.351629,2185.257148
W57 8250,W57,8250,3984,213880601.8,802,9352,8550,5679.161647,2467.09634
W58 8250,W58,8250,3991,214256396,723,9352,8629,5768.985718,2473.826459
W59 8250,W59,8250,3992,214310080.9,659,9349,8690,5466.958667,2456.500307
W60 8250,W60,8250,3984,213880601.8,748,9191,8443,6684.637801,2190.970859
W61 8250,W61,8250,3983,213826916.9,896,9191,8295,7139.77178,1857.235573
W62 8250,W62,8250,3983,213826916.9,615,9787,9172,5901.975144,2493.291638
W63 8250,W63,8250,3987,214041656.4,-447,9925,10372,4949.537246,2511.414017
W64 8250,W64,8250,3992,214310080.9,135,9043,8908,5558.123246,2492.858616
W65 8250,W65,8250,3987,214041656.4,135,9145,9010,5059.957111,2494.992755
W66 8250,W66,8250,3987,214041656.4,135,8905,8770,4800.926762,2490.358183
WB_ E1 8250,WB_ E1,8250,3981,213719547.1,130,9272,9142,4953.455162,2500.881561
WB_ E10 8250,WB_ E10,8250,3986,213987971.5,659,9145,8486,4889.075013,2376.007947
WB_ E2 8250,WB_ E2,8250,3986,213987971.5,748,9427,8679,6203.087306,2363.586659
WB_ E3 8250,WB_ E3,8250,3984,213880601.8,1913,8963,7050,7665.057229,878.6540048
WB_ E4 8250,WB_ E4,8250,3982,213773232,1905,9009,7104,7947.881718,1179.584207
WB_ E5 8250,WB_ E5,8250,3983,213826916.9,130,9272,9142,4912.378358,2355.51472
WB_ E6 8250,WB_ E6,8250,3988,214095341.3,3375,9530,6155,7635.019809,713.7030137
WB_ E7 8250,WB_ E7,8250,3982,213773232,453,9787,9334,5910.459819,2283.709765
WB_ E8 8250,WB_ E8,8250,3989,214149026.2,1174,9352,8178,5931.073703,2366.331751
WB_ E9 8250,WB_ E9,8250,3996,214524820.4,854,8888,8034,5654.424675,2399.546321
WB_ H1 8250,WB_ H1,8250,3993,214363765.8,1568,8878,7310,6893.477586,1887.723948
WB_ H10 8250,WB_ H10,8250,3990,214202711.1,1525,8878,7353,6486.510777,1943.263024
WB_ H2 8250,WB_ H2,8250,3986,213987971.5,1724,9063,7339,7502.547918,1639.4328
WB_ H3 8250,WB_ H3,8250,3989,214149026.2,896,9261,8365,6943.213086,2115.388203
WB_ H4 8250,WB_ H4,8250,3988,214095341.3,1485,9112,7627,6592.704614,1796.818773
WB_ H5 8250,WB_ H5,8250,3986,213987971.5,1174,9074,7900,6368.079779,2291.066002
WB_ H6 8250,WB_ H6,8250,3981,213719547.1,117,9551,9434,6352.258227,2504.651703
WB_ H7 8250,WB_ H7,8250,3981,213719547.1,-503,9898,10401,6867.922633,2219.985194
WB_ H8 8250,WB_ H8,8250,3993,214363765.8,854,9352,8498,5758.491861,2408.112933
WB_ H9 8250,WB_ H9,8250,3980,213665862.2,130,9272,9142,5378.680151,2481.468576
WB_ S1 8250,WB_ S1,8250,3987,214041656.4,-283,9749,10032,6376.859794,2509.196587
WB_ S10 8250,WB_ S10,8250,3989,214149026.2,-961,9787,10748,4256.704187,2622.630803
WB_ S11 8250,WB_ S11,8250,3991,214256396,460,8931,8471,5759.349286,2456.830881
WB_ S12 8250,WB_ S12,8250,3993,214363765.8,659,9349,8690,5389.721012,2457.03727
WB_ S13 8250,WB_ S13,8250,3988,214095341.3,1174,9352,8178,6204.262788,2268.49813
WB_ S14 8250,WB_ S14,8250,3998,214632190.2,1683,9112,7429,7096.077289,1491.401399
WB_ S15 8250,WB_ S15,8250,3995,214471135.5,1525,8878,7353,6669.638298,1951.623056
WB_ S16 8250,WB_ S16,8250,3982,213773232,130,9240,9110,5902.575088,2376.541135
WB_ S17 8250,WB_ S17,8250,3984,213880601.8,896,9131,8235,7195.501506,1642.839733
WB_ S18 8250,WB_ S18,8250,3985,213934286.7,896,9261,8365,6655.212045,2161.526963
WB_ S19 8250,WB_ S19,8250,3988,214095341.3,1873,9134,7261,7344.001254,1724.701235
WB_ S2 8250,WB_ S2,8250,3987,214041656.4,-1222,9580,10802,4035.661901,3491.926204
WB_ S20 8250,WB_ S20,8250,3987,214041656.4,1414,9134,7720,7765.209431,1571.823082
WB_ S21 8250,WB_ S21,8250,3989,214149026.2,2961,8939,5978,7689.435949,892.3996986
WB_ S22 8250,WB_ S22,8250,3992,214310080.9,3375,9530,6155,7644.378758,694.9890624
WB_ S23 8250,WB_ S23,8250,3982,213773232,497,9176,8679,6520.164239,1872.984247
WB_ S24 8250,WB_ S24,8250,3981,213719547.1,130,9272,9142,5112.184125,2276.037337
WB_ S25 8250,WB_ S25,8250,3983,213826916.9,775,9017,8242,6945.168717,1721.823299
WB_ S26 8250,WB_ S26,8250,3984,213880601.8,1621,9227,7606,7622.982932,1632.757727
WB_ S27 8250,WB_ S27,8250,3990,214202711.1,2171,9128,6957,8248.889223,954.788981
WB_ S28 8250,WB_ S28,8250,3989,214149026.2,395,9063,8668,7207.755578,1619.297935
WB_ S29 8250,WB_ S29,8250,3985,213934286.7,1051,9003,7952,6854.802008,1533.720093
WB_ S3 8250,WB_ S3,8250,3990,214202711.1,135,9667,9532,5520.557393,2416.627314
WB_ S4 8250,WB_ S4,8250,3988,214095341.3,289,9185,8896,4332.806921,2405.062221
WB_ S5 8250,WB_ S5,8250,3994,214417450.7,854,9352,8498,5796.939659,2445.721858
WB_ S6 8250,WB_ S6,8250,3989,214149026.2,1423,9112,7689,6298.442216,2017.133899
WB_ S7 8250,WB_ S7,8250,3992,214310080.9,1417,8858,7441,6684.883768,1962.839917
WB_ S8 8250,WB_ S8,8250,3980,213665862.2,210,9749,9539,6884.782412,2106.11735
WB_ S9 8250,WB_ S9,8250,3984,213880601.8,-961,9787,10748,4697.976406,2539.062706
WB_ W1 8250,WB_ W1,8250,3989,214149026.2,595,9063,8468,6083.769366,1941.454019
WB_ W10 8250,WB_ W10,8250,3983,213826916.9,135,9876,9741,5625.777052,2406.671628
WB_ W2 8250,WB_ W2,8250,3982,213773232,425,9063,8638,7289.696133,1594.109928
WB_ W3 8250,WB_ W3,8250,3981,213719547.1,863,9063,8200,6522.601356,1701.34546
WB_ W4 8250,WB_ W4,8250,3987,214041656.4,338,9787,9449,5983.597442,2192.807244
WB_ W5 8250,WB_ W5,8250,3996,214524820.4,1117,9110,7993,7205.963213,1595.023264
WB_ W6 8250,WB_ W6,8250,3987,214041656.4,1905,9009,7104,7882.632807,1254.849019
WB_ W7 8250,WB_ W7,8250,3986,213987971.5,-714,9749,10463,5511.941295,2969.690025
WB_ W8 8250,WB_ W8,8250,3984,213880601.8,1052,9131,8079,7228.790161,1544.862331
WB_ W9 8250,WB_ W9,8250,3988,214095341.3,1235,9134,7899,7082.326229,1918.548152
W01 8500,W01,8500,4227,226926030,249,9551,9302,7016.092027,2029.513772
W02 8500,W02,8500,4225,226818660.2,249,9266,9017,7271.020592,1674.070466
W03 8500,W03,8500,4232,227194454.5,863,9063,8200,7072.074433,1626.198341
W04 8500,W04,8500,4227,226926030,395,9102,8707,7202.988408,1655.543445
W05 8500,W05,8500,4224,226764975.4,425,9313,8888,7224.456913,1706.799221
W06 8500,W06,8500,4231,227140769.6,863,9063,8200,7152.769794,1608.893557
W07 8500,W07,8500,4234,227301824.3,863,9063,8200,6564.207605,1731.632567
W08 8500,W08,8500,4231,227140769.6,1724,9063,7339,7226.153392,1617.637354
W09 8500,W09,8500,4227,226926030,1186,8981,7795,7150.772652,1495.176244
W10 8500,W10,8500,4227,226926030,1534,9009,7475,7243.297374,1837.210946
W11 8500,W11,8500,4228,226979714.9,595,9063,8468,6048.912488,1971.690239
W12 8500,W12,8500,4233,227248139.4,130,9272,9142,5379.558233,2289.979989
W13 8500,W13,8500,4230,227087084.7,381,9272,8891,5593.06643,2143.094782
W14 8500,W14,8500,4235,227355509.2,381,8934,8553,6292.800708,2215.101392
W15 8500,W15,8500,4228,226979714.9,381,8981,8600,6740.354068,2057.572807
W16 8500,W16,8500,4227,226926030,-503,9898,10401,6520.502247,2325.584287
W17 8500,W17,8500,4227,226926030,-503,9480,9983,6707.615093,2279.413566
W18 8500,W18,8500,4233,227248139.4,38,9604,9566,6673.139617,2170.248386
W19 8500,W19,8500,4228,226979714.9,-714,9749,10463,6478.2228,2398.842306
W20 8500,W20,8500,4234,227301824.3,210,9604,9394,6287.973311,2228.085224
W21 8500,W21,8500,4233,227248139.4,38,9316,9278,6732.205528,2020.900142
W22 8500,W22,8500,4234,227301824.3,-961,8964,9925,4803.306566,2765.335062
W23 8500,W23,8500,4232,227194454.5,-424,9422,9846,5826.124764,2299.626815
W24 8500,W24,8500,4228,226979714.9,151,9240,9089,6017.273179,2253.096519
W25 8500,W25,8500,4228,226979714.9,477,9447,8970,6131.723273,2113.439485
W26 8500,W26,8500,4232,227194454.5,-961,9787,10748,5057.4388,2516.379942
W27 8500,W27,8500,4230,227087084.7,715,9787,9072,6137.128132,2182.279544
W28 8500,W28,8500,4237,227462878.9,477,9102,8625,6658.47038,1943.234288
W29 8500,W29,8500,4234,227301824.3,477,9102,8625,6576.679972,1998.142078
W30 8500,W30,8500,4232,227194454.5,896,9131,8235,7148.962665,1633.615152
W31 8500,W31,8500,4231,227140769.6,2171,9110,6939,8409.225951,698.9127597
W32 8500,W32,8500,4228,226979714.9,1621,9227,7606,7845.657994,1377.479856
W33 8500,W33,8500,4230,227087084.7,1117,9227,8110,7422.115839,1532.814451
W34 8500,W34,8500,4224,226764975.4,896,9261,8365,6640.239583,2156.382035
W35 8500,W35,8500,4230,227087084.7,1873,9227,7354,7687.198109,1568.045003
W36 8500,W36,8500,4228,226979714.9,1489,9134,7645,7497.094607,1716.17492
W37 8500,W37,8500,4234,227301824.3,1235,9134,7899,7630.281767,1705.443713
W38 8500,W38,8500,4226,226872345.1,2170,9134,6964,8204.786796,913.9721565
W39 8500,W39,8500,4237,227462878.9,2961,8946,5985,7894.078829,904.6992299
W40 8500,W40,8500,4229,227033399.8,1235,8996,7761,6797.833294,2143.75539
W41 8500,W41,8500,4238,227516563.8,1174,9112,7938,6708.327985,1932.798873
W42 8500,W42,8500,4235,227355509.2,1510,8996,7486,7592.367651,1292.439498
W43 8500,W43,8500,4237,227462878.9,2961,9530,6569,7628.409488,786.3856032
W44 8500,W44,8500,4240,227623933.6,1605,8939,7334,7144.990802,1442.809019
W45 8500,W45,8500,4239,227570248.7,1525,8939,7414,7074.657938,1568.976228
W46 8500,W46,8500,4232,227194454.5,1525,8878,7353,6669.988894,1933.711852
W47 8500,W47,8500,4239,227570248.7,1537,8906,7369,6831.264449,1932.205971
W48 8500,W48,8500,4240,227623933.6,1936,9269,7333,7662.403538,1153.395829
W49 8500,W49,8500,4240,227623933.6,1537,9269,7732,6984.697642,1730.964162
W50 8500,W50,8500,4241,227677618.5,1417,8872,7455,7059.488092,1805.510452
W51 8500,W51,8500,4241,227677618.5,1417,8872,7455,6641.589484,1952.841809
W52 8500,W52,8500,4242,227731303.4,1589,8774,7185,6455.321546,1901.170001
W53 8500,W53,8500,4239,227570248.7,1511,9112,7601,6509.162538,1944.138348
W54 8500,W54,8500,4229,227033399.8,1142,8879,7737,5819.027666,2110.115716
W55 8500,W55,8500,4233,227248139.4,1342,9145,7803,6799.393102,2056.982353
W56 8500,W56,8500,4231,227140769.6,1235,9145,7910,6366.09005,2202.87874
W57 8500,W57,8500,4230,227087084.7,802,9352,8550,5648.513002,2465.800455
W58 8500,W58,8500,4238,227516563.8,723,9352,8629,5715.185937,2478.933189
W59 8500,W59,8500,4233,227248139.4,659,9349,8690,5490.483818,2456.733034
W60 8500,W60,8500,4235,227355509.2,748,9191,8443,6609.717119,2217.557939
W61 8500,W61,8500,4226,226872345.1,896,9191,8295,7121.927828,1859.657574
W62 8500,W62,8500,4234,227301824.3,615,9787,9172,5934.061171,2494.369389
W63 8500,W63,8500,4233,227248139.4,-447,9925,10372,4962.555871,2537.065439
W64 8500,W64,8500,4224,226764975.4,135,9342,9207,5527.758759,2511.869236
W65 8500,W65,8500,4234,227301824.3,135,9145,9010,5097.652102,2495.320982
W66 8500,W66,8500,4230,227087084.7,135,8905,8770,4829.147754,2490.278023
WB_ E1 8500,WB_ E1,8500,4229,227033399.8,130,9272,9142,5029.309293,2490.93795
WB_ E10 8500,WB_ E10,8500,4233,227248139.4,659,9145,8486,4941.193244,2395.510401
WB_ E2 8500,WB_ E2,8500,4236,227409194,748,9427,8679,6159.43508,2371.863341
WB_ E3 8500,WB_ E3,8500,4231,227140769.6,1913,8963,7050,7650.960766,885.3854421
WB_ E4 8500,WB_ E4,8500,4234,227301824.3,1905,9009,7104,7951.106991,1168.844173
WB_ E5 8500,WB_ E5,8500,4228,226979714.9,130,9272,9142,4925.193709,2351.130494
WB_ E6 8500,WB_ E6,8500,4242,227731303.4,3023,9530,6507,7622.694955,742.9793257
WB_ E7 8500,WB_ E7,8500,4234,227301824.3,453,9787,9334,5916.157062,2291.650538
WB_ E8 8500,WB_ E8,8500,4236,227409194,1174,9352,8178,5920.232295,2361.209491
WB_ E9 8500,WB_ E9,8500,4230,227087084.7,854,8888,8034,5673.722695,2394.844463
WB_ H1 8500,WB_ H1,8500,4233,227248139.4,1568,8906,7338,6873.466808,1884.856813
WB_ H10 8500,WB_ H10,8500,4237,227462878.9,1525,8878,7353,6540.282039,1923.922941
WB_ H2 8500,WB_ H2,8500,4234,227301824.3,1724,9063,7339,7534.495749,1610.863165
WB_ H3 8500,WB_ H3,8500,4226,226872345.1,896,9261,8365,6978.205159,2081.907961
WB_ H4 8500,WB_ H4,8500,4237,227462878.9,1423,9112,7689,6588.807411,1805.787489
WB_ H5 8500,WB_ H5,8500,4236,227409194,1174,9074,7900,6377.325071,2289.680765
WB_ H6 8500,WB_ H6,8500,4235,227355509.2,117,9551,9434,6375.157025,2481.436346
WB_ H7 8500,WB_ H7,8500,4225,226818660.2,-503,9898,10401,6894.289467,2186.667452
WB_ H8 8500,WB_ H8,8500,4231,227140769.6,854,9352,8498,5717.366107,2413.068306
WB_ H9 8500,WB_ H9,8500,4232,227194454.5,130,9272,9142,5397.637524,2467.583887
WB_ S1 8500,WB_ S1,8500,4224,226764975.4,-714,9749,10463,6385.598722,2528.397997
WB_ S10 8500,WB_ S10,8500,4230,227087084.7,-961,9787,10748,4266.458156,2637.870822
WB_ S11 8500,WB_ S11,8500,4231,227140769.6,460,9145,8685,5780.910423,2447.613769
WB_ S12 8500,WB_ S12,8500,4239,227570248.7,659,9349,8690,5387.947393,2465.278238
WB_ S13 8500,WB_ S13,8500,4236,227409194,1174,9352,8178,6239.478517,2256.792957
WB_ S14 8500,WB_ S14,8500,4233,227248139.4,1485,9112,7627,7049.392393,1531.460896
WB_ S15 8500,WB_ S15,8500,4226,226872345.1,1525,8878,7353,6690.070043,1933.580252
WB_ S16 8500,WB_ S16,8500,4232,227194454.5,130,9240,9110,5895.637051,2375.537597
WB_ S17 8500,WB_ S17,8500,4226,226872345.1,896,9131,8235,7143.216044,1694.119496
WB_ S18 8500,WB_ S18,8500,4233,227248139.4,896,9261,8365,6655.154264,2165.498851
WB_ S19 8500,WB_ S19,8500,4232,227194454.5,1873,9134,7261,7344.892486,1735.275969
WB_ S2 8500,WB_ S2,8500,4233,227248139.4,-1479,9580,11059,4028.227971,3479.453465
WB_ S20 8500,WB_ S20,8500,4238,227516563.8,1414,9134,7720,7748.001416,1574.809241
WB_ S21 8500,WB_ S21,8500,4233,227248139.4,2961,9530,6569,7697.989133,889.3594214
WB_ S22 8500,WB_ S22,8500,4238,227516563.8,3375,9530,6155,7644.048608,691.0518188
WB_ S23 8500,WB_ S23,8500,4224,226764975.4,497,9195,8698,6537.24858,1876.932593
WB_ S24 8500,WB_ S24,8500,4234,227301824.3,130,9272,9142,5178.362069,2277.122142
WB_ S25 8500,WB_ S25,8500,4235,227355509.2,726,9017,8291,6952.382527,1720.739172
WB_ S26 8500,WB_ S26,8500,4230,227087084.7,1117,9227,8110,7581.795508,1657.616953
WB_ S27 8500,WB_ S27,8500,4236,227409194,2171,9158,6987,8236.456799,975.4734108
WB_ S28 8500,WB_ S28,8500,4226,226872345.1,395,9063,8668,7177.80194,1632.956783
WB_ S29 8500,WB_ S29,8500,4229,227033399.8,863,9003,8140,6822.02672,1591.061075
WB_ S3 8500,WB_ S3,8500,4230,227087084.7,135,9667,9532,5485.577305,2435.678163
WB_ S4 8500,WB_ S4,8500,4235,227355509.1,289,9185,8896,4367.616057,2406.306288
WB_ S5 8500,WB_ S5,8500,4239,227570248.7,843,9352,8509,5776.251238,2452.661913
WB_ S6 8500,WB_ S6,8500,4236,227409194,1290,9112,7822,6320.509207,2006.115012
WB_ S7 8500,WB_ S7,8500,4237,227462878.9,1417,8858,7441,6663.18362,1962.023036
WB_ S8 8500,WB_ S8,8500,4235,227355509.2,210,9749,9539,6849.238253,2112.358629
WB_ S9 8500,WB_ S9,8500,4231,227140769.6,-961,9787,10748,4735.088395,2561.519781
WB_ W1 8500,WB_ W1,8500,4223,226711290.5,595,9063,8468,6104.30618,1951.390855
WB_ W10 8500,WB_ W10,8500,4238,227516563.8,-144,9925,10069,5619.887447,2425.901631
WB_ W2 8500,WB_ W2,8500,4226,226872345.1,425,9313,8888,7288.611216,1591.290872
WB_ W3 8500,WB_ W3,8500,4231,227140769.6,863,9063,8200,6535.135429,1730.896258
WB_ W4 8500,WB_ W4,8500,4232,227194454.5,-424,9787,10211,5935.083648,2234.222311
WB_ W5 8500,WB_ W5,8500,4228,226979714.9,1117,9110,7993,7204.698912,1593.875658
WB_ W6 8500,WB_ W6,8500,4232,227194454.5,1905,9009,7104,7885.371692,1251.729813
WB_ W7 8500,WB_ W7,8500,4226,226872345.1,-714,9749,10463,5499.210128,2967.297858
WB_ W8 8500,WB_ W8,8500,4232,227194454.5,1052,9131,8079,7214.060255,1566.809547
WB_ W9 8500,WB_ W9,8500,4236,227409194,1235,9145,7910,7071.923041,1919.973238
W01 8750,W01,8750,4474,240186197.9,249,9551,9302,7011.682164,2035.850032
W02 8750,W02,8750,4479,240454622.3,249,9266,9017,7257.350078,1677.787282
W03 8750,W03,8750,4481,240561992.1,395,9063,8668,7048.456371,1625.497649
W04 8750,W04,8750,4488,240937786.3,395,9102,8707,7162.920677,1691.019907
W05 8750,W05,8750,4475,240239882.8,425,9551,9126,7227.665251,1708.036703
W06 8750,W06,8750,4477,240347252.5,863,9063,8200,7131.736654,1610.178785
W07 8750,W07,8750,4481,240561992.1,863,9063,8200,6591.853158,1735.971887
W08 8750,W08,8750,4476,240293567.6,1724,9063,7339,7199.358803,1630.146615
W09 8750,W09,8750,4476,240293567.6,1186,8991,7805,7136.291555,1516.365357
W10 8750,W10,8750,4484,240723046.8,1534,9009,7475,7249.832293,1834.728056
W11 8750,W11,8750,4475,240239882.8,595,9063,8468,6076.021899,1985.417215
W12 8750,W12,8750,4484,240723046.8,130,9272,9142,5426.349911,2291.42876
W13 8750,W13,8750,4490,241045156.1,381,9272,8891,5627.159243,2146.212351
W14 8750,W14,8750,4481,240561992.1,381,9272,8891,6298.987949,2207.569594
W15 8750,W15,8750,4476,240293567.6,381,8981,8600,6732.697945,2075.521536
W16 8750,W16,8750,4475,240239882.8,-503,9898,10401,6554.117765,2310.867796
W17 8750,W17,8750,4481,240561992.1,-503,9480,9983,6696.430707,2272.19306
W18 8750,W18,8750,4481,240561992.1,38,9604,9566,6639.201071,2182.130411
W19 8750,W19,8750,4488,240937786.3,-714,9749,10463,6489.704768,2398.38206
W20 8750,W20,8750,4489,240991471.2,210,9604,9394,6287.146358,2233.664796
W21 8750,W21,8750,4483,240669361.9,38,9316,9278,6692.676556,2046.536968
W22 8750,W22,8750,4490,241045156.1,-961,8964,9925,4836.425167,2784.583829
W23 8750,W23,8750,4481,240561992.1,-424,9447,9871,5801.962732,2342.169039
W24 8750,W24,8750,4477,240347252.5,136,9240,9104,6024.975207,2256.911662
W25 8750,W25,8750,4485,240776731.6,477,9447,8970,6134.904794,2125.615432
W26 8750,W26,8750,4483,240669361.9,-961,9787,10748,5059.826455,2548.545119
W27 8750,W27,8750,4479,240454622.3,572,9787,9215,6121.317482,2188.032962
W28 8750,W28,8750,4474,240186197.9,477,9102,8625,6639.005811,1950.964454
W29 8750,W29,8750,4481,240561992.1,477,9102,8625,6562.891988,2029.08332
W30 8750,W30,8750,4482,240615677,896,9131,8235,7103.200357,1697.847677
W31 8750,W31,8750,4490,241045156.1,2171,9144,6973,8404.199777,699.7747019
W32 8750,W32,8750,4481,240561992.1,1621,9227,7606,7831.548538,1381.08055
W33 8750,W33,8750,4482,240615677,1117,9261,8144,7411.312807,1537.384948
W34 8750,W34,8750,4485,240776731.7,896,9261,8365,6652.2932,2159.495446
W35 8750,W35,8750,4478,240400937.4,1873,9227,7354,7693.601831,1560.519028
W36 8750,W36,8750,4482,240615677,1489,9134,7645,7515.07162,1707.574582
W37 8750,W37,8750,4491,241098841,1235,9134,7899,7631.340459,1703.874414
W38 8750,W38,8750,4487,240884101.4,2170,9134,6964,8185.468464,952.2506489
W39 8750,W39,8750,4493,241206210.8,2961,8946,5985,7897.602048,900.2097751
W40 8750,W40,8750,4484,240723046.8,1235,8996,7761,6827.64273,2130.389072
W41 8750,W41,8750,4487,240884101.4,1174,9112,7938,6704.391576,1938.941564
W42 8750,W42,8750,4486,240830416.5,1510,8996,7486,7558.474365,1344.791271
W43 8750,W43,8750,4495,241313580.6,2961,9530,6569,7635.309455,776.1082738
W44 8750,W44,8750,4484,240723046.8,1605,8939,7334,7159.563113,1431.56576
W45 8750,W45,8750,4488,240937786.3,1525,8939,7414,7098.13213,1547.354342
W46 8750,W46,8750,4484,240723046.8,1525,8878,7353,6691.748216,1917.448365
W47 8750,W47,8750,4487,240884101.4,1537,8906,7369,6865.990862,1909.4517
W48 8750,W48,8750,4490,241045156.1,1787,9269,7482,7670.590646,1139.010247
W49 8750,W49,8750,4496,241367265.4,1537,9269,7732,7009.112322,1723.990094
W50 8750,W50,8750,4486,240830416.5,1417,8872,7455,7021.018725,1820.365524
W51 8750,W51,8750,4485,240776731.7,1417,8872,7455,6640.205128,1938.901488
W52 8750,W52,8750,4486,240830416.5,1519,8774,7255,6486.734953,1894.713742
W53 8750,W53,8750,4484,240723046.8,1511,9112,7601,6506.900535,1941.055079
W54 8750,W54,8750,4489,240991471.2,1142,8879,7737,5853.639563,2108.809322
W55 8750,W55,8750,4495,241313580.5,1342,9145,7803,6800.208899,2040.164347
W56 8750,W56,8750,4481,240561992.1,1235,9237,8002,6310.773934,2222.030327
W57 8750,W57,8750,4486,240830416.5,723,9352,8629,5612.815649,2471.269709
W58 8750,W58,8750,4496,241367265.4,723,9352,8629,5665.687055,2489.133206
W59 8750,W59,8750,4491,241098841,659,9349,8690,5502.256736,2457.646711
W60 8750,W60,8750,4484,240723046.8,748,9191,8443,6538.57025,2240.601487
W61 8750,W61,8750,4482,240615677,896,9191,8295,7109.712628,1854.471072
W62 8750,W62,8750,4481,240561992.1,615,9787,9172,5955.668378,2494.988331
W63 8750,W63,8750,4479,240454622.3,-973,9925,10898,4963.694575,2577.666867
W64 8750,W64,8750,4487,240884101.4,135,9427,9292,5511.850457,2521.149479
W65 8750,W65,8750,4491,241098841,135,9145,9010,5138.516143,2490.681141
W66 8750,W66,8750,4481,240561992.1,135,9075,8940,4848.333631,2490.776992
WB_ E1 8750,WB_ E1,8750,4487,240884101.4,130,9272,9142,5101.838422,2479.099356
WB_ E10 8750,WB_ E10,8750,4487,240884101.4,659,9145,8486,4991.275017,2408.698673
WB_ E2 8750,WB_ E2,8750,4483,240669361.9,748,9427,8679,6124.538479,2374.825417
WB_ E3 8750,WB_ E3,8750,4492,241152525.9,1913,8963,7050,7646.107524,876.388417
WB_ E4 8750,WB_ E4,8750,4482,240615677,1905,9009,7104,7952.04083,1164.765412
WB_ E5 8750,WB_ E5,8750,4485,240776731.6,130,9272,9142,4958.383055,2350.63734
WB_ E6 8750,WB_ E6,8750,4482,240615677,3023,9530,6507,7616.484382,754.728187
WB_ E7 8750,WB_ E7,8750,4483,240669361.9,278,9787,9509,5916.501896,2306.255923
WB_ E8 8750,WB_ E8,8750,4495,241313580.5,1174,9352,8178,5907.65762,2358.082084
WB_ E9 8750,WB_ E9,8750,4494,241259895.7,854,8888,8034,5701.811972,2385.434235
WB_ H1 8750,WB_ H1,8750,4488,240937786.3,1525,8906,7381,6857.208333,1885.695997
WB_ H10 8750,WB_ H10,8750,4489,240991471.2,1525,8878,7353,6592.97104,1904.265731
WB_ H2 8750,WB_ H2,8750,4491,241098841,1724,9063,7339,7558.743042,1586.431927
WB_ H3 8750,WB_ H3,8750,4480,240508307.2,896,9261,8365,7016.268973,2049.696955
WB_ H4 8750,WB_ H4,8750,4488,240937786.3,1423,9112,7689,6571.942291,1819.830363
WB_ H5 8750,WB_ H5,8750,4489,240991471.2,1174,9074,7900,6375.874582,2289.745607
WB_ H6 8750,WB_ H6,8750,4476,240293567.6,117,9551,9434,6387.752458,2466.303024
WB_ H7 8750,WB_ H7,8750,4482,240615677,-503,9898,10401,6907.941544,2168.832279
WB_ H8 8750,WB_ H8,8750,4482,240615677,854,9352,8498,5696.140562,2414.626886
WB_ H9 8750,WB_ H9,8750,4483,240669361.9,130,9272,9142,5412.38501,2449.493362
WB_ S1 8750,WB_ S1,8750,4481,240561992.1,-714,9749,10463,6385.02678,2560.378763
WB_ S10 8750,WB_ S10,8750,4478,240400937.4,-961,9787,10748,4290.180661,2646.484621
WB_ S11 8750,WB_ S11,8750,4481,240561992.1,460,9145,8685,5794.09306,2443.384993
WB_ S12 8750,WB_ S12,8750,4494,241259895.7,659,9349,8690,5381.965732,2471.239779
WB_ S13 8750,WB_ S13,8750,4495,241313580.5,1174,9352,8178,6265.285651,2247.571862
WB_ S14 8750,WB_ S14,8750,4496,241367265.4,1423,9112,7689,7006.407696,1579.019889
WB_ S15 8750,WB_ S15,8750,4489,240991471.2,1525,8878,7353,6709.518378,1916.848293
WB_ S16 8750,WB_ S16,8750,4490,241045156.1,130,9240,9110,5899.910022,2360.872092
WB_ S17 8750,WB_ S17,8750,4483,240669361.9,896,9131,8235,7087.955387,1748.135786
WB_ S18 8750,WB_ S18,8750,4484,240723046.8,896,9261,8365,6658.05174,2162.590628
WB_ S19 8750,WB_ S19,8750,4490,241045156.1,1873,9134,7261,7337.326503,1748.062233
WB_ S2 8750,WB_ S2,8750,4488,240937786.3,-1479,9580,11059,4024.372326,3467.948894
WB_ S20 8750,WB_ S20,8750,4486,240830416.5,1414,9134,7720,7733.846857,1571.377124
WB_ S21 8750,WB_ S21,8750,4482,240615677,2961,9530,6569,7702.840027,896.8635188
WB_ S22 8750,WB_ S22,8750,4492,241152525.9,3375,9530,6155,7640.510463,688.3944163
WB_ S23 8750,WB_ S23,8750,4482,240615677,497,9377,8880,6546.863677,1880.094577
WB_ S24 8750,WB_ S24,8750,4480,240508307.2,130,9272,9142,5239.947768,2275.984181
WB_ S25 8750,WB_ S25,8750,4483,240669361.9,726,9026,8300,6956.834932,1724.795347
WB_ S26 8750,WB_ S26,8750,4487,240884101.4,1117,9261,8144,7553.081569,1662.216837
WB_ S27 8750,WB_ S27,8750,4492,241152525.9,2171,9170,6999,8231.226625,977.7014862
WB_ S28 8750,WB_ S28,8750,4475,240239882.8,395,9063,8668,7159.968045,1641.278595
WB_ S29 8750,WB_ S29,8750,4477,240347252.5,863,9003,8140,6785.600179,1649.353019
WB_ S3 8750,WB_ S3,8750,4478,240400937.4,135,9667,9532,5456.043323,2448.184844
WB_ S4 8750,WB_ S4,8750,4489,240991471.2,285,9349,9064,4399.255068,2421.379876
WB_ S5 8750,WB_ S5,8750,4495,241313580.5,843,9352,8509,5756.676974,2450.470097
WB_ S6 8750,WB_ S6,8750,4492,241152525.9,1174,9112,7938,6335.58927,1997.610935
WB_ S7 8750,WB_ S7,8750,4489,240991471.2,1417,8872,7455,6645.838494,1959.804963
WB_ S8 8750,WB_ S8,8750,4478,240400937.4,210,9749,9539,6818.386333,2116.244653
WB_ S9 8750,WB_ S9,8750,4488,240937786.3,-961,9787,10748,4783.204768,2590.793314
WB_ W1 8750,WB_ W1,8750,4484,240723046.8,595,9063,8468,6131.5281,1963.919153
WB_ W10 8750,WB_ W10,8750,4476,240293567.6,-144,9925,10069,5619.246649,2437.964148
WB_ W2 8750,WB_ W2,8750,4481,240561992.1,425,9313,8888,7292.907833,1589.796787
WB_ W3 8750,WB_ W3,8750,4483,240669361.9,863,9063,8200,6554.895606,1754.341765
WB_ W4 8750,WB_ W4,8750,4492,241152525.9,-424,9787,10211,5879.112645,2280.461079
WB_ W5 8750,WB_ W5,8750,4490,241045156.1,1117,9110,7993,7202.516036,1589.780355
WB_ W6 8750,WB_ W6,8750,4488,240937786.3,1905,9009,7104,7882.71123,1251.578629
WB_ W7 8750,WB_ W7,8750,4480,240508307.2,-714,9749,10463,5462.268527,2971.89311
WB_ W8 8750,WB_ W8,8750,4477,240347252.5,1052,9131,8079,7202.268707,1594.139634
WB_ W9 8750,WB_ W9,8750,4484,240723046.8,1235,9145,7910,7050.37868,1937.875881
W01 9000,W01,9000,4737,254305323.9,249,9551,9302,7002.548659,2044.876384
W02 9000,W02,9000,4742,254573748.4,249,9266,9017,7247.75116,1683.608679
W03 9000,W03,9000,4742,254573748.4,395,9063,8668,7027.185787,1627.561102
W04 9000,W04,9000,4747,254842172.8,395,9102,8707,7134.739414,1711.313366
W05 9000,W05,9000,4736,254251639,425,9551,9126,7237.107052,1709.475919
W06 9000,W06,9000,4743,254627433.3,863,9063,8200,7120.134936,1602.781207
W07 9000,W07,9000,4744,254681118.2,863,9063,8200,6616.805438,1745.326562
W08 9000,W08,9000,4743,254627433.3,1724,9063,7339,7180.412608,1625.579701
W09 9000,W09,9000,4742,254573748.4,822,8991,8169,7110.12927,1546.26734
W10 9000,W10,9000,4748,254895857.7,1534,9009,7475,7252.166386,1834.55212
W11 9000,W11,9000,4741,254520063.5,511,9116,8605,6103.611474,2002.054696
W12 9000,W12,9000,4746,254788487.9,130,9272,9142,5468.211757,2285.950188
W13 9000,W13,9000,4746,254788487.9,381,9272,8891,5647.18268,2157.560398
W14 9000,W14,9000,4745,254734803,381,9272,8891,6309.142044,2189.949011
W15 9000,W15,9000,4742,254573748.4,381,8981,8600,6733.530578,2083.103429
W16 9000,W16,9000,4738,254359008.8,-503,9898,10401,6571.583157,2296.030264
W17 9000,W17,9000,4743,254627433.3,-503,9480,9983,6689.020662,2260.18996
W18 9000,W18,9000,4741,254520063.5,38,9716,9678,6609.062012,2200.432098
W19 9000,W19,9000,4744,254681118.2,-714,9749,10463,6495.557125,2397.371226
W20 9000,W20,9000,4747,254842172.8,210,9604,9394,6282.847272,2250.539163
W21 9000,W21,9000,4746,254788487.9,38,9316,9278,6646.038559,2072.595645
W22 9000,W22,9000,4747,254842172.8,-1001,9222,10223,4872.33558,2806.447952
W23 9000,W23,9000,4745,254734803,-424,9447,9871,5774.284089,2377.320707
W24 9000,W24,9000,4741,254520063.5,130,9240,9110,6040.281586,2260.395081
W25 9000,W25,9000,4743,254627433.3,477,9447,8970,6138.081383,2125.060702
W26 9000,W26,9000,4743,254627433.3,-961,9787,10748,5063.288847,2574.468979
W27 9000,W27,9000,4743,254627433.3,572,9787,9215,6097.60447,2197.620928
W28 9000,W28,9000,4747,254842172.8,477,9102,8625,6616.005898,1963.170354
W29 9000,W29,9000,4744,254681118.2,171,9102,8931,6551.706788,2055.098888
W30 9000,W30,9000,4745,254734803,896,9131,8235,7066.377028,1750.402591
W31 9000,W31,9000,4746,254788487.9,2171,9144,6973,8393.332491,719.4602637
W32 9000,W32,9000,4745,254734803,1621,9227,7606,7821.518019,1377.34663
W33 9000,W33,9000,4742,254573748.4,1117,9261,8144,7392.483129,1553.492659
W34 9000,W34,9000,4731,253983214.6,896,9261,8365,6678.695413,2151.939062
W35 9000,W35,9000,4747,254842172.8,1873,9227,7354,7696.582052,1558.621003
W36 9000,W36,9000,4736,254251639,1489,9134,7645,7537.919975,1690.343477
W37 9000,W37,9000,4748,254895857.7,1235,9134,7899,7632.561289,1703.804795
W38 9000,W38,9000,4731,253983214.6,1892,9134,7242,8172.940393,972.8687977
W39 9000,W39,9000,4753,255164282.2,2961,8946,5985,7897.206817,899.6301704
W40 9000,W40,9000,4748,254895857.7,1235,8996,7761,6862.004844,2117.162226
W41 9000,W41,9000,4746,254788487.9,1174,9112,7938,6704.941424,1944.161541
W42 9000,W42,9000,4747,254842172.8,1510,8996,7486,7526.139456,1400.442689
W43 9000,W43,9000,4749,254949542.6,2961,9530,6569,7640.080649,766.5266373
W44 9000,W44,9000,4751,255056912.4,1525,8939,7414,7171.77289,1426.727733
W45 9000,W45,9000,4749,254949542.6,1525,8939,7414,7119.536955,1523.828428
W46 9000,W46,9000,4752,255110597.3,1525,8878,7353,6717.34112,1896.630165
W47 9000,W47,9000,4750,255003227.5,1537,8906,7369,6900.897895,1883.334428
W48 9000,W48,9000,4752,255110597.3,1787,9269,7482,7679.399832,1128.460845
W49 9000,W49,9000,4757,255379021.7,1537,9269,7732,7038.591549,1711.019603
W50 9000,W50,9000,4751,255056912.4,1417,8872,7455,6980.712482,1835.68966
W51 9000,W51,9000,4747,254842172.8,1417,8872,7455,6651.179692,1921.679609
W52 9000,W52,9000,4752,255110597.3,1417,8774,7357,6515.68729,1890.458687
W53 9000,W53,9000,4749,254949542.6,1511,9112,7601,6493.878922,1940.100257
W54 9000,W54,9000,4734,254144269.3,1142,9112,7970,5884.569075,2109.428419
W55 9000,W55,9000,4749,254949542.6,1342,9145,7803,6799.468099,2028.768933
W56 9000,W56,9000,4746,254788487.9,1235,9237,8002,6268.386852,2237.354252
W57 9000,W57,9000,4748,254895857.7,723,9352,8629,5596.263479,2474.615336
W58 9000,W58,9000,4755,255271651.9,723,9352,8629,5625.01346,2495.997924
W59 9000,W59,9000,4749,254949542.6,659,9349,8690,5505.578438,2465.802251
W60 9000,W60,9000,4745,254734803,748,9191,8443,6468.372603,2266.586521
W61 9000,W61,9000,4744,254681118.2,896,9191,8295,7075.64903,1864.850171
W62 9000,W62,9000,4746,254788487.9,595,9787,9192,5982.680784,2496.896099
W63 9000,W63,9000,4745,254734803,-1582,9925,11507,4963.236459,2617.608338
W64 9000,W64,9000,4731,253983214.6,135,9427,9292,5515.269922,2513.496271
W65 9000,W65,9000,4747,254842172.8,135,9145,9010,5179.930693,2485.920987
W66 9000,W66,9000,4744,254681118.2,135,9108,8973,4864.13554,2498.277382
WB_ E1 9000,WB_ E1,9000,4745,254734803,130,9272,9142,5168.323077,2463.610353
WB_ E10 9000,WB_ E10,9000,4745,254734803,659,9170,8511,5050.715911,2423.332092
WB_ E2 9000,WB_ E2,9000,4746,254788487.9,748,9427,8679,6090.73957,2376.964701
WB_ E3 9000,WB_ E3,9000,4754,255217967.1,1913,8963,7050,7637.619058,873.9345964
WB_ E4 9000,WB_ E4,9000,4746,254788487.9,1905,9009,7104,7951.356511,1157.192008
WB_ E5 9000,WB_ E5,9000,4743,254627433.3,130,9272,9142,4997.957833,2343.004044
WB_ E6 9000,WB_ E6,9000,4751,255056912.4,2961,9530,6569,7616.274889,755.6219019
WB_ E7 9000,WB_ E7,9000,4743,254627433.3,199,9787,9588,5909.638415,2317.415389
WB_ E8 9000,WB_ E8,9000,4749,254949542.6,1174,9352,8178,5895.49821,2355.178492
WB_ E9 9000,WB_ E9,9000,4743,254627433.3,854,8888,8034,5729.500738,2373.137718
WB_ H1 9000,WB_ H1,9000,4737,254305323.9,1525,8906,7381,6835.105763,1896.903405
WB_ H10 9000,WB_ H10,9000,4747,254842172.8,1525,8878,7353,6635.397725,1886.701383
WB_ H2 9000,WB_ H2,9000,4750,255003227.5,1724,9063,7339,7582.034737,1564.705144
WB_ H3 9000,WB_ H3,9000,4734,254144269.3,896,9261,8365,7047.163498,2016.769983
WB_ H4 9000,WB_ H4,9000,4748,254895857.7,1423,9112,7689,6556.507372,1835.943697
WB_ H5 9000,WB_ H5,9000,4750,255003227.5,1174,9074,7900,6381.041684,2283.904371
WB_ H6 9000,WB_ H6,9000,4744,254681118.2,117,9551,9434,6400.298482,2455.838961
WB_ H7 9000,WB_ H7,9000,4745,254734803,-503,9898,10401,6918.47334,2158.8847
WB_ H8 9000,WB_ H8,9000,4742,254573748.4,854,9352,8498,5676.154787,2418.28035
WB_ H9 9000,WB_ H9,9000,4743,254627433.3,130,9272,9142,5430.149483,2428.399667
WB_ S1 9000,WB_ S1,9000,4733,254090584.4,-714,9749,10463,6379.290302,2587.427
WB_ S10 9000,WB_ S10,9000,4742,254573748.4,-961,9787,10748,4333.072965,2663.898556
WB_ S11 9000,WB_ S11,9000,4746,254788487.9,135,9145,9010,5802.470712,2436.190401
WB_ S12 9000,WB_ S12,9000,4752,255110597.3,659,9349,8690,5397.007786,2474.881031
WB_ S13 9000,WB_ S13,9000,4750,255003227.5,1174,9352,8178,6281.264421,2246.458426
WB_ S14 9000,WB_ S14,9000,4745,254734803,1290,9112,7822,6975.345205,1613.45656
WB_ S15 9000,WB_ S15,9000,4736,254251639,1525,8878,7353,6731.193412,1901.333122
WB_ S16 9000,WB_ S16,9000,4746,254788487.9,130,9240,9110,5913.291825,2346.986651
WB_ S17 9000,WB_ S17,9000,4748,254895857.7,896,9131,8235,7032.276959,1792.320373
WB_ S18 9000,WB_ S18,9000,4743,254627433.3,896,9261,8365,6642.413451,2165.611589
WB_ S19 9000,WB_ S19,9000,4747,254842172.8,1873,9134,7261,7327.636191,1762.016277
WB_ S2 9000,WB_ S2,9000,4750,255003227.5,-1479,9580,11059,4022.909474,3458.5239
WB_ S20 9000,WB_ S20,9000,4749,254949542.6,1414,9134,7720,7721.481575,1564.74945
WB_ S21 9000,WB_ S21,9000,4748,254895857.7,2961,9530,6569,7709.401432,900.1252989
WB_ S22 9000,WB_ S22,9000,4749,254949542.6,3375,9530,6155,7632.706675,685.9916512
WB_ S23 9000,WB_ S23,9000,4745,254734803,497,9377,8880,6555.296944,1882.5562
WB_ S24 9000,WB_ S24,9000,4746,254788487.9,130,9272,9142,5312.80531,2278.207532
WB_ S25 9000,WB_ S25,9000,4742,254573748.4,726,9026,8300,6954.171447,1739.746966
WB_ S26 9000,WB_ S26,9000,4747,254842172.8,1117,9261,8144,7528.636191,1663.802502
WB_ S27 9000,WB_ S27,9000,4748,254895857.7,2171,9175,7004,8223.569924,980.8963135
WB_ S28 9000,WB_ S28,9000,4738,254359008.8,395,9102,8707,7145.654496,1640.926619
WB_ S29 9000,WB_ S29,9000,4739,254412693.7,863,9003,8140,6752.492298,1698.829286
WB_ S3 9000,WB_ S3,9000,4742,254573748.4,135,9771,9636,5425.371151,2460.310824
WB_ S4 9000,WB_ S4,9000,4748,254895857.7,285,9349,9064,4423.520851,2430.111152
WB_ S5 9000,WB_ S5,9000,4751,255056912.4,723,9352,8629,5740.435277,2447.379153
WB_ S6 9000,WB_ S6,9000,4750,255003227.5,1174,9112,7938,6345.555579,1987.507775
WB_ S7 9000,WB_ S7,9000,4750,255003227.5,1417,8872,7455,6626.295789,1956.743842
WB_ S8 9000,WB_ S8,9000,4747,254842172.8,38,9749,9711,6764.327154,2141.824498
WB_ S9 9000,WB_ S9,9000,4744,254681118.2,-961,9787,10748,4822.040261,2619.694125
WB_ W1 9000,WB_ W1,9000,4728,253822159.9,595,9063,8468,6153.289129,1979.133268
WB_ W10 9000,WB_ W10,9000,4748,254895857.7,-144,9925,10069,5614.951348,2443.348163
WB_ W2 9000,WB_ W2,9000,4741,254520063.5,425,9313,8888,7295.181396,1589.990256
WB_ W3 9000,WB_ W3,9000,4742,254573748.4,822,9063,8241,6565.516238,1772.130959
WB_ W4 9000,WB_ W4,9000,4746,254788487.9,-424,9787,10211,5841.75453,2316.190515
WB_ W5 9000,WB_ W5,9000,4740,254466378.6,1117,9110,7993,7191.644726,1593.258549
WB_ W6 9000,WB_ W6,9000,4744,254681118.2,1905,9009,7104,7878.420742,1246.856835
WB_ W7 9000,WB_ W7,9000,4736,254251639,-1001,9749,10750,5425.255279,2978.797647
WB_ W8 9000,WB_ W8,9000,4744,254681118.2,896,9131,8235,7183.166526,1637.737965
WB_ W9 9000,WB_ W9,9000,4746,254788487.9,1235,9145,7910,7030.610619,1955.182091
W01 9250,W01,9250,5005,268692874.4,117,9551,9434,6994.787612,2058.0521
W02 9250,W02,9250,5007,268800244.2,249,9266,9017,7239.205512,1685.229667
W03 9250,W03,9250,5008,268853929.1,395,9063,8668,7006.717652,1630.716492
W04 9250,W04,9250,5014,269176038.5,395,9102,8707,7116.505584,1721.812217
W05 9250,W05,9250,5005,268692874.4,425,9551,9126,7252.768631,1707.796253
W06 9250,W06,9250,5005,268692874.4,863,9063,8200,7111.403397,1598.066764
W07 9250,W07,9250,5004,268639189.6,863,9063,8200,6641.964229,1751.58349
W08 9250,W08,9250,5005,268692874.4,1724,9063,7339,7167.108092,1620.329402
W09 9250,W09,9250,5007,268800244.2,822,8991,8169,7075.609746,1584.554042
W10 9250,W10,9250,5015,269229723.3,1534,9009,7475,7253.725623,1825.842252
W11 9250,W11,9250,5003,268585504.7,495,9272,8777,6129.69918,2020.846864
W12 9250,W12,9250,5002,268531819.8,130,9272,9142,5502.315474,2281.873541
W13 9250,W13,9250,5014,269176038.5,130,9272,9142,5670.099322,2176.453942
W14 9250,W14,9250,5003,268585504.7,381,9272,8891,6323.181491,2179.063354
W15 9250,W15,9250,5007,268800244.2,381,8981,8600,6724.660675,2094.075323
W16 9250,W16,9250,5006,268746559.3,-503,9898,10401,6587.749101,2277.004585
W17 9250,W17,9250,5007,268800244.2,-503,9507,10010,6695.686439,2239.120296
W18 9250,W18,9250,5010,268961298.9,38,9749,9711,6601.116168,2204.080259
W19 9250,W19,9250,5016,269283408.2,-714,9749,10463,6500.581539,2395.172311
W20 9250,W20,9250,5016,269283408.2,210,9604,9394,6270.310606,2270.034003
W21 9250,W21,9250,5000,268424450,38,9316,9278,6605.8056,2095.412742
W22 9250,W22,9250,5015,269229723.3,-1001,9222,10223,4909.733998,2822.07523
W23 9250,W23,9250,5004,268639189.6,-424,9447,9871,5750.845124,2404.895655
W24 9250,W24,9250,5007,268800244.2,130,9240,9110,6053.391851,2261.291277
W25 9250,W25,9250,5017,269337093.1,366,9447,9081,6120.351206,2137.152177
W26 9250,W26,9250,5015,269229723.3,-961,9787,10748,5070.495713,2599.542345
W27 9250,W27,9250,5006,268746559.3,572,9787,9215,6070.402917,2214.662887
W28 9250,W28,9250,4999,268370765.1,477,9102,8625,6602.999,1968.754032
W29 9250,W29,9250,5006,268746559.3,171,9102,8931,6547.079505,2077.360706
W30 9250,W30,9250,5006,268746559.3,896,9131,8235,7028.781063,1797.506291
W31 9250,W31,9250,5019,269444462.9,2171,9144,6973,8382.286711,751.3779861
W32 9250,W32,9250,5007,268800244.2,1621,9227,7606,7810.610146,1381.098601
W33 9250,W33,9250,5006,268746559.3,1117,9261,8144,7377.739712,1574.968033
W34 9250,W34,9250,5013,269122353.6,896,9261,8365,6721.273289,2136.76987
W35 9250,W35,9250,5006,268746559.3,1873,9227,7354,7698.327407,1559.502554
W36 9250,W36,9250,5010,268961298.9,1414,9134,7720,7549.487226,1683.757531
W37 9250,W37,9250,5023,269659202.5,1235,9134,7899,7628.072268,1709.137524
W38 9250,W38,9250,5014,269176038.5,1892,9134,7242,8153.109892,997.3941613
W39 9250,W39,9250,5021,269551832.7,2961,8946,5985,7896.899422,901.0038514
W40 9250,W40,9250,5013,269122353.6,1235,8996,7761,6895.606822,2097.194011
W41 9250,W41,9250,5016,269283408.2,1174,9112,7938,6708.969099,1951.205563
W42 9250,W42,9250,5017,269337093.1,1510,8996,7486,7487.540961,1463.184384
W43 9250,W43,9250,5021,269551832.7,2961,9530,6569,7642.911771,756.6726316
W44 9250,W44,9250,5017,269337093.1,1525,8939,7414,7184.79131,1421.816521
W45 9250,W45,9250,5011,269014983.8,1525,8939,7414,7132.344841,1504.946018
W46 9250,W46,9250,5014,269176038.5,1525,8878,7353,6736.058237,1879.519173
W47 9250,W47,9250,5017,269337093.1,1537,8906,7369,6935.287622,1859.036229
W48 9250,W48,9250,5012,269068668.7,1596,9269,7673,7681.552873,1116.283099
W49 9250,W49,9250,5024,269712887.4,1537,9269,7732,7063.026473,1703.86683
W50 9250,W50,9250,5016,269283408.2,1417,8872,7455,6951.27193,1839.050387
W51 9250,W51,9250,5013,269122353.6,1417,8872,7455,6670.39218,1905.207435
W52 9250,W52,9250,5017,269337093.1,1417,8774,7357,6539.64999,1884.745254
W53 9250,W53,9250,5016,269283408.2,1511,9112,7601,6486.229067,1940.929118
W54 9250,W54,9250,5016,269283408.2,1142,9112,7970,5921.469099,2105.169477
W55 9250,W55,9250,5017,269337093.1,1342,9145,7803,6792.665736,2024.344226
W56 9250,W56,9250,5009,268907614,1205,9349,8144,6238.367738,2246.012599
W57 9250,W57,9250,5013,269122353.6,723,9352,8629,5574.982047,2478.071291
W58 9250,W58,9250,5018,269390778,723,9352,8629,5598.258071,2494.88263
W59 9250,W59,9250,5017,269337093.1,659,9349,8690,5510.980068,2474.586416
W60 9250,W60,9250,5016,269283408.2,748,9191,8443,6406.862241,2286.107008
W61 9250,W61,9250,5009,268907614,896,9191,8295,7050.524656,1875.902497
W62 9250,W62,9250,5011,269014983.8,453,9787,9334,6006.16364,2491.822705
W63 9250,W63,9250,5007,268800244.2,-1582,9927,11509,4960.897543,2661.544957
W64 9250,W64,9250,5009,268907614,135,9427,9292,5525.519465,2502.531116
W65 9250,W65,9250,5017,269337093.1,135,9145,9010,5222.233207,2478.627788
W66 9250,W66,9250,5010,268961298.9,135,9108,8973,4871.162475,2500.502926
WB_ E1 9250,WB_ E1,9250,5016,269283408.2,130,9272,9142,5235.672448,2447.006581
WB_ E10 9250,WB_ E10,9250,5012,269068668.7,659,9185,8526,5120.638268,2436.238613
WB_ E2 9250,WB_ E2,9250,5004,268639189.6,720,9427,8707,6051.257994,2378.564521
WB_ E3 9250,WB_ E3,9250,5022,269605517.6,1913,8963,7050,7629.793509,881.9303044
WB_ E4 9250,WB_ E4,9250,5004,268639189.6,1905,9009,7104,7943.690647,1165.16755
WB_ E5 9250,WB_ E5,9250,5016,269283408.2,130,9272,9142,5058.258772,2336.955127
WB_ E6 9250,WB_ E6,9250,5012,269068668.7,2961,9530,6569,7618.474661,749.4404718
WB_ E7 9250,WB_ E7,9250,5015,269229723.3,-424,9787,10211,5900.457827,2339.862626
WB_ E8 9250,WB_ E8,9250,5021,269551832.7,1174,9352,8178,5887.015933,2356.433558
WB_ E9 9250,WB_ E9,9250,5024,269712887.4,854,8888,8034,5756.528662,2360.550983
WB_ H1 9250,WB_ H1,9250,5017,269337093.1,1525,8906,7381,6827.876619,1895.472055
WB_ H10 9250,WB_ H10,9250,5015,269229723.3,1525,8878,7353,6677.387836,1867.973451
WB_ H2 9250,WB_ H2,9250,5014,269176038.5,1724,9063,7339,7596.785401,1549.175267
WB_ H3 9250,WB_ H3,9250,5007,268800244.2,896,9261,8365,7070.39305,1985.682994
WB_ H4 9250,WB_ H4,9250,5019,269444462.9,1423,9112,7689,6528.026101,1858.428976
WB_ H5 9250,WB_ H5,9250,5020,269498147.8,1174,9074,7900,6393.731275,2271.268284
WB_ H6 9250,WB_ H6,9250,5000,268424450,117,9551,9434,6409.2822,2454.865383
WB_ H7 9250,WB_ H7,9250,5014,269176038.5,-503,9898,10401,6910.929797,2167.496526
WB_ H8 9250,WB_ H8,9250,5010,268961298.9,854,9352,8498,5668.144112,2417.130463
WB_ H9 9250,WB_ H9,9250,5011,269014983.8,130,9272,9142,5451.819996,2410.065714
WB_ S1 9250,WB_ S1,9250,5005,268692874.4,-714,9749,10463,6378.842757,2616.128637
WB_ S10 9250,WB_ S10,9250,5008,268853929.1,-961,9787,10748,4383.332867,2676.385409
WB_ S11 9250,WB_ S11,9250,5007,268800244.2,135,9145,9010,5794.069303,2432.334621
WB_ S12 9250,WB_ S12,9250,5019,269444462.9,659,9349,8690,5410.101016,2477.665063
WB_ S13 9250,WB_ S13,9250,5020,269498147.8,1174,9352,8178,6293,2246.931982
WB_ S14 9250,WB_ S14,9250,5024,269712887.4,1290,9112,7822,6951.781648,1645.75026
WB_ S15 9250,WB_ S15,9250,5019,269444462.9,1525,8878,7353,6752.188285,1884.798688
WB_ S16 9250,WB_ S16,9250,5016,269283408.2,130,9240,9110,5936.31559,2328.934029
WB_ S17 9250,WB_ S17,9250,5015,269229723.3,896,9131,8235,6982.841077,1828.027802
WB_ S18 9250,WB_ S18,9250,5016,269283408.2,896,9261,8365,6642.578947,2159.771654
WB_ S19 9250,WB_ S19,9250,5022,269605517.6,1489,9134,7645,7314.811031,1781.95378
WB_ S2 9250,WB_ S2,9250,5018,269390778,-1479,9580,11059,4019.544041,3447.37459
WB_ S20 9250,WB_ S20,9250,5017,269337093.1,1409,9134,7725,7705.713375,1579.639439
WB_ S21 9250,WB_ S21,9250,5010,268961298.9,2856,9530,6674,7718.284232,904.0122402
WB_ S22 9250,WB_ S22,9250,5023,269659202.5,3375,9530,6155,7621.367509,691.3235195
WB_ S23 9250,WB_ S23,9250,5007,268800244.2,497,9377,8880,6560.816257,1889.47182
WB_ S24 9250,WB_ S24,9250,5010,268961298.9,130,9272,9142,5378.503593,2277.977736
WB_ S25 9250,WB_ S25,9250,5012,269068668.7,726,9026,8300,6948.635475,1757.199343
WB_ S26 9250,WB_ S26,9250,5019,269444462.9,1117,9261,8144,7509.467424,1658.268672
WB_ S27 9250,WB_ S27,9250,5019,269444462.9,2171,9175,7004,8212.337517,987.7895794
WB_ S28 9250,WB_ S28,9250,5006,268746559.3,395,9102,8707,7134.654415,1647.933648
WB_ S29 9250,WB_ S29,9250,5008,268853929.1,822,9003,8181,6727.573482,1734.675727
WB_ S3 9250,WB_ S3,9250,5008,268853929.1,135,9876,9741,5402.870607,2471.479875
WB_ S4 9250,WB_ S4,9250,5019,269444462.9,285,9352,9067,4429.517035,2434.805939
WB_ S5 9250,WB_ S5,9250,5020,269498147.8,723,9352,8629,5734.348606,2443.396564
WB_ S6 9250,WB_ S6,9250,5024,269712887.4,1174,9112,7938,6347.759554,1985.747545
WB_ S7 9250,WB_ S7,9250,5013,269122353.6,1417,8878,7461,6614.924596,1956.907933
WB_ S8 9250,WB_ S8,9250,5009,268907614,38,9749,9711,6703.7221,2180.106614
WB_ S9 9250,WB_ S9,9250,5016,269283408.2,-961,9787,10748,4856.742424,2651.370405
WB_ W1 9250,WB_ W1,9250,5004,268639189.6,511,9116,8605,6179.611511,1996.547545
WB_ W10 9250,WB_ W10,9250,5001,268478134.9,-144,9925,10069,5609.908418,2447.252209
WB_ W2 9250,WB_ W2,9250,5006,268746559.3,425,9313,8888,7297.727527,1589.36194
WB_ W3 9250,WB_ W3,9250,5006,268746559.3,822,9063,8241,6585.25809,1789.561068
WB_ W4 9250,WB_ W4,9250,5014,269176038.5,-424,9787,10211,5796.624053,2349.749531
WB_ W5 9250,WB_ W5,9250,5024,269712887.4,1117,9115,7998,7176.415605,1605.567381
WB_ W6 9250,WB_ W6,9250,5016,269283408.2,1905,9009,7104,7870.808612,1243.689142
WB_ W7 9250,WB_ W7,9250,5005,268692874.4,-1001,9749,10750,5387.524476,2983.991102
WB_ W8 9250,WB_ W8,9250,5007,268800244.2,896,9131,8235,7169.481126,1661.891898
WB_ W9 9250,WB_ W9,9250,5018,269390778,1235,9145,7910,7013.472698,1971.693008
W01 9500,W01,9500,5279,283402534.3,117,9551,9434,6980.050767,2074.203169
W02 9500,W02,9500,5281,283509904.1,249,9266,9017,7218.739443,1699.540621
W03 9500,W03,9500,5284,283670958.8,395,9063,8668,6984.705148,1639.898263
W04 9500,W04,9500,5288,283885698.3,395,9266,8871,7103.372352,1728.947107
W05 9500,W05,9500,5280,283456219.2,425,9551,9126,7270.766477,1706.695238
W06 9500,W06,9500,5278,283348849.4,863,9063,8200,7116.515915,1587.884625
W07 9500,W07,9500,5282,283563589,863,9063,8200,6665.151268,1760.945276
W08 9500,W08,9500,5280,283456219.2,1724,9063,7339,7158.689583,1617.206818
W09 9500,W09,9500,5281,283509904.1,822,8991,8169,7035.624503,1625.805423
W10 9500,W10,9500,5287,283832013.4,1534,9009,7475,7255.532816,1819.556955
W11 9500,W11,9500,5279,283402534.3,381,9272,8891,6148.091684,2036.798535
W12 9500,W12,9500,5285,283724643.6,130,9272,9142,5540.198297,2271.508925
W13 9500,W13,9500,5287,283832013.4,130,9272,9142,5696.541895,2192.785242
W14 9500,W14,9500,5284,283670958.8,381,9272,8891,6330.574375,2171.272951
W15 9500,W15,9500,5283,283617273.9,381,8981,8600,6712.399016,2098.402701
W16 9500,W16,9500,5282,283563589,-503,9898,10401,6603.742711,2252.51258
W17 9500,W17,9500,5284,283670958.8,-503,9898,10401,6701.345572,2220.179288
W18 9500,W18,9500,5284,283670958.8,38,9749,9711,6589.110712,2208.970079
W19 9500,W19,9500,5284,283670958.8,-714,9749,10463,6497.963285,2396.038834
W20 9500,W20,9500,5283,283617273.9,38,9716,9678,6256.105054,2287.858755
W21 9500,W21,9500,5281,283509904.1,38,9316,9278,6571.061163,2120.441028
W22 9500,W22,9500,5280,283456219.2,-1001,9604,10605,4956.580114,2834.123131
W23 9500,W23,9500,5286,283778328.5,-424,9787,10211,5737.701854,2423.169613
W24 9500,W24,9500,5284,283670958.8,130,9240,9110,6057.496404,2262.472239
W25 9500,W25,9500,5288,283885698.3,357,9787,9430,6100.519478,2152.95637
W26 9500,W26,9500,5287,283832013.4,-961,9787,10748,5086.855305,2612.601587
W27 9500,W27,9500,5286,283778328.5,453,9787,9334,6039.520621,2233.687193
W28 9500,W28,9500,5289,283939383.2,477,9102,8625,6577.643978,1986.721392
W29 9500,W29,9500,5285,283724643.6,171,9102,8931,6542.975781,2100.120898
W30 9500,W30,9500,5284,283670958.8,572,9131,8559,6992.013626,1839.270244
W31 9500,W31,9500,5288,283885698.3,2171,9144,6973,8365.490166,797.9520529
W32 9500,W32,9500,5285,283724643.6,1621,9227,7606,7791.411164,1394.241891
W33 9500,W33,9500,5285,283724643.6,1117,9261,8144,7357.820435,1602.046012
W34 9500,W34,9500,5278,283348849.4,896,9261,8365,6765.810724,2120.522928
W35 9500,W35,9500,5288,283885698.3,1873,9227,7354,7706.305787,1554.390746
W36 9500,W36,9500,5284,283670958.8,1414,9134,7720,7562.870174,1677.314089
W37 9500,W37,9500,5291,284046753,1235,9134,7899,7622.356832,1710.311558
W38 9500,W38,9500,5280,283456219.2,1892,9134,7242,8128.729167,1027.68322
W39 9500,W39,9500,5295,284261492.5,2961,8946,5985,7894.995279,899.9607236
W40 9500,W40,9500,5287,283832013.4,1235,8996,7761,6925.773596,2080.75697
W41 9500,W41,9500,5293,284154122.8,1174,9112,7938,6717.62082,1954.801096
W42 9500,W42,9500,5292,284100437.9,1510,8996,7486,7453.590325,1514.642732
W43 9500,W43,9500,5293,284154122.8,2961,9530,6569,7641.170603,751.3501375
W44 9500,W44,9500,5291,284046753,1525,8945,7420,7194.631072,1421.945666
W45 9500,W45,9500,5293,284154122.8,1525,8939,7414,7140.267145,1491.225784
W46 9500,W46,9500,5290,283993068.1,1525,8878,7353,6764.485633,1860.608548
W47 9500,W47,9500,5291,284046753,1537,8906,7369,6961.38934,1840.340001
W48 9500,W48,9500,5294,284207807.7,1596,9269,7673,7682.153381,1105.368913
W49 9500,W49,9500,5296,284315177.4,1537,9269,7732,7091.690899,1689.649033
W50 9500,W50,9500,5294,284207807.7,1417,8872,7455,6930.959577,1838.151115
W51 9500,W51,9500,5292,284100437.9,1417,8872,7455,6694.501134,1888.87708
W52 9500,W52,9500,5294,284207807.7,1417,8774,7357,6557.089346,1882.966837
W53 9500,W53,9500,5291,284046753,1511,9112,7601,6474.573049,1943.570753
W54 9500,W54,9500,5281,283509904.1,1142,9112,7970,5937.835827,2108.890279
W55 9500,W55,9500,5290,283993068.1,1342,9161,7819,6784.815123,2021.524673
W56 9500,W56,9500,5285,283724643.6,904,9349,8445,6216.428004,2254.405667
W57 9500,W57,9500,5288,283885698.3,723,9352,8629,5563.656581,2477.784157
W58 9500,W58,9500,5292,284100437.9,723,9352,8629,5583.130574,2487.527819
W59 9500,W59,9500,5290,283993068.1,659,9349,8690,5504.688847,2481.935553
W60 9500,W60,9500,5289,283939383.2,748,9191,8443,6346.031008,2306.818922
W61 9500,W61,9500,5284,283670958.8,896,9191,8295,7010.612226,1902.211703
W62 9500,W62,9500,5287,283832013.4,453,9787,9334,6019.229052,2485.408331
W63 9500,W63,9500,5286,283778328.5,-1582,9927,11509,4948.144154,2699.52887
W64 9500,W64,9500,5277,283295164.5,135,9427,9292,5553.385446,2488.855909
W65 9500,W65,9500,5291,284046753,135,9145,9010,5261.511813,2467.703594
W66 9500,W66,9500,5288,283885698.3,135,9109,8974,4884.346634,2502.977658
WB_ E1 9500,WB_ E1,9500,5285,283724643.6,130,9272,9142,5295.22649,2435.44943
WB_ E10 9500,WB_ E10,9500,5287,283832013.4,659,9185,8526,5184.247778,2452.957407
WB_ E2 9500,WB_ E2,9500,5287,283832013.4,720,9427,8707,6000.198979,2385.06888
WB_ E3 9500,WB_ E3,9500,5293,284154122.8,1913,8963,7050,7622.302097,887.6596181
WB_ E4 9500,WB_ E4,9500,5284,283670958.8,1905,9009,7104,7929.223694,1191.003071
WB_ E5 9500,WB_ E5,9500,5288,283885698.3,130,9272,9142,5118.675492,2330.371563
WB_ E6 9500,WB_ E6,9500,5297,284368862.3,2961,9530,6569,7622.614121,741.6273655
WB_ E7 9500,WB_ E7,9500,5287,283832013.4,-424,9787,10211,5886.393607,2358.841009
WB_ E8 9500,WB_ E8,9500,5291,284046753,990,9352,8362,5868.863542,2358.120197
WB_ E9 9500,WB_ E9,9500,5294,284207807.7,854,8888,8034,5765.561768,2352.010446
WB_ H1 9500,WB_ H1,9500,5286,283778328.5,1525,8906,7381,6827.120318,1891.460981
WB_ H10 9500,WB_ H10,9500,5292,284100437.9,1525,8878,7353,6709.809902,1851.751758
WB_ H2 9500,WB_ H2,9500,5286,283778328.5,1724,9063,7339,7610.879871,1536.292916
WB_ H3 9500,WB_ H3,9500,5282,283563589,896,9261,8365,7079.749905,1961.436628
WB_ H4 9500,WB_ H4,9500,5291,284046753,1290,9112,7822,6505.723493,1882.096414
WB_ H5 9500,WB_ H5,9500,5289,283939383.2,1174,9074,7900,6418.318397,2253.907882
WB_ H6 9500,WB_ H6,9500,5284,283670958.8,89,9551,9462,6416.387207,2455.163375
WB_ H7 9500,WB_ H7,9500,5284,283670958.8,-503,9898,10401,6890.080431,2192.253692
WB_ H8 9500,WB_ H8,9500,5286,283778328.5,854,9352,8498,5663.408627,2412.398544
WB_ H9 9500,WB_ H9,9500,5286,283778328.5,130,9272,9142,5489.334468,2396.66416
WB_ S1 9500,WB_ S1,9500,5279,283402534.3,-714,9749,10463,6383.728168,2626.057378
WB_ S10 9500,WB_ S10,9500,5282,283563589,-961,9787,10748,4434.77944,2695.475311
WB_ S11 9500,WB_ S11,9500,5288,283885698.3,135,9145,9010,5781.469932,2434.939708
WB_ S12 9500,WB_ S12,9500,5287,283832013.4,659,9349,8690,5430.420654,2477.503334
WB_ S13 9500,WB_ S13,9500,5294,284207807.7,1174,9352,8178,6307.714205,2245.689693
WB_ S14 9500,WB_ S14,9500,5296,284315177.4,1290,9112,7822,6923.754532,1681.848647
WB_ S15 9500,WB_ S15,9500,5283,283617273.9,1525,8878,7353,6774.157486,1867.233484
WB_ S16 9500,WB_ S16,9500,5285,283724643.6,130,9240,9110,5960.287039,2312.401802
WB_ S17 9500,WB_ S17,9500,5285,283724643.6,896,9131,8235,6948.976348,1850.724771
WB_ S18 9500,WB_ S18,9500,5287,283832013.4,896,9261,8365,6643.064876,2154.446601
WB_ S19 9500,WB_ S19,9500,5292,284100437.9,1489,9134,7645,7309.274754,1796.129379
WB_ S2 9500,WB_ S2,9500,5287,283832013.4,-1479,9580,11059,4029.899376,3432.926393
WB_ S20 9500,WB_ S20,9500,5290,283993068.1,1409,9134,7725,7686.955198,1597.997985
WB_ S21 9500,WB_ S21,9500,5293,284154122.8,2844,9530,6686,7729.98772,909.2257569
WB_ S22 9500,WB_ S22,9500,5292,284100437.9,3177,9530,6353,7608.815571,703.5099535
WB_ S23 9500,WB_ S23,9500,5281,283509904.1,497,9377,8880,6565.438175,1900.523765
WB_ S24 9500,WB_ S24,9500,5286,283778328.5,130,9272,9142,5443.85717,2277.688097
WB_ S25 9500,WB_ S25,9500,5285,283724643.6,681,9026,8345,6937.658089,1777.918386
WB_ S26 9500,WB_ S26,9500,5289,283939383.2,1117,9261,8144,7485.211382,1661.786623
WB_ S27 9500,WB_ S27,9500,5286,283778328.5,2171,9175,7004,8203.637911,991.6976497
WB_ S28 9500,WB_ S28,9500,5277,283295164.5,395,9102,8707,7117.901459,1656.045696
WB_ S29 9500,WB_ S29,9500,5283,283617273.9,822,9003,8181,6709.544198,1758.388864
WB_ S3 9500,WB_ S3,9500,5285,283724643.6,135,9925,9790,5400.293661,2471.720082
WB_ S4 9500,WB_ S4,9500,5287,283832013.4,135,9352,9217,4430.547002,2436.46126
WB_ S5 9500,WB_ S5,9500,5291,284046753,723,9352,8629,5742.643357,2439.117292
WB_ S6 9500,WB_ S6,9500,5292,284100437.9,1174,9112,7938,6334.653817,1997.662285
WB_ S7 9500,WB_ S7,9500,5292,284100437.9,1417,8878,7461,6611.18972,1951.294382
WB_ S8 9500,WB_ S8,9500,5285,283724643.6,-41,9749,9790,6639.708988,2234.646184
WB_ S9 9500,WB_ S9,9500,5287,283832013.4,-1001,9787,10788,4884.043503,2684.448641
WB_ W1 9500,WB_ W1,9500,5276,283241479.6,381,9116,8735,6191.300607,2020.039978
WB_ W10 9500,WB_ W10,9500,5289,283939383.2,-144,9925,10069,5616.652675,2445.121909
WB_ W2 9500,WB_ W2,9500,5281,283509904.1,425,9313,8888,7297.566938,1594.473699
WB_ W3 9500,WB_ W3,9500,5285,283724643.6,511,9063,8552,6601.089877,1808.400854
WB_ W4 9500,WB_ W4,9500,5285,283724643.6,-424,9787,10211,5763.296121,2375.036142
WB_ W5 9500,WB_ W5,9500,5290,283993068.1,887,9115,8228,7157.285255,1629.053752
WB_ W6 9500,WB_ W6,9500,5285,283724643.6,1905,9009,7104,7861.352129,1248.126603
WB_ W7 9500,WB_ W7,9500,5281,283509904.1,-1001,9749,10750,5357.969324,2985.542387
WB_ W8 9500,WB_ W8,9500,5287,283832013.4,896,9131,8235,7142.352941,1696.852521
WB_ W9 9500,WB_ W9,9500,5289,283939383.2,1235,9145,7910,7000.432785,1986.01589
W01 9750,W01,9750,5558,298380618.6,117,9551,9434,6967.54462,2090.682085
W02 9750,W02,9750,5561,298541673.3,249,9551,9302,7193.896781,1715.43432
W03 9750,W03,9750,5564,298702728,395,9063,8668,6968.781272,1646.618134
W04 9750,W04,9750,5568,298917467.5,395,9551,9156,7100.63398,1736.284673
W05 9750,W05,9750,5564,298702728,425,9551,9126,7282.687994,1710.168867
W06 9750,W06,9750,5568,298917467.5,863,9063,8200,7123.634698,1581.931438
W07 9750,W07,9750,5563,298649043.1,822,9063,8241,6687.822398,1766.83221
W08 9750,W08,9750,5570,299024837.3,1724,9063,7339,7145.438241,1624.971165
W09 9750,W09,9750,5565,298756412.9,729,8991,8262,6997.407008,1669.215603
W10 9750,W10,9750,5566,298810097.7,1534,9009,7475,7248.827345,1817.894453
W11 9750,W11,9750,5567,298863782.6,365,9272,8907,6163.845698,2051.195983
W12 9750,W12,9750,5564,298702728,130,9272,9142,5592.199856,2261.846678
W13 9750,W13,9750,5570,299024837.3,130,9272,9142,5730.52711,2206.73895
W14 9750,W14,9750,5565,298756412.9,381,9272,8891,6334.760467,2166.517964
W15 9750,W15,9750,5564,298702728,381,8981,8600,6695.552301,2099.208682
W16 9750,W16,9750,5560,298487988.4,-503,9898,10401,6611.767626,2232.98964
W17 9750,W17,9750,5561,298541673.3,-503,9898,10401,6705.085776,2205.692604
W18 9750,W18,9750,5563,298649043.1,38,9749,9711,6582.353946,2206.749747
W19 9750,W19,9750,5568,298917467.5,-714,9749,10463,6492.557471,2393.804756
W20 9750,W20,9750,5568,298917467.5,-424,9749,10173,6246.688039,2304.291663
W21 9750,W21,9750,5562,298595358.2,38,9316,9278,6544.411722,2139.268363
W22 9750,W22,9750,5570,299024837.3,-1001,9604,10605,5005.638779,2852.120691
W23 9750,W23,9750,5565,298756412.9,-424,9787,10211,5722.192453,2443.21239
W24 9750,W24,9750,5563,298649043.1,130,9240,9110,6064.664929,2261.345517
W25 9750,W25,9750,5569,298971152.4,357,9787,9430,6071.156222,2176.36888
W26 9750,W26,9750,5568,298917467.5,-961,9787,10748,5109.751257,2626.033889
W27 9750,W27,9750,5568,298917467.5,453,9787,9334,6025.944325,2240.54604
W28 9750,W28,9750,5565,298756412.8,477,9102,8625,6547.499012,2007.944726
W29 9750,W29,9750,5563,298649043.1,171,9102,8931,6543.195937,2115.281944
W30 9750,W30,9750,5568,298917467.5,572,9131,8559,6962.440912,1872.663085
W31 9750,W31,9750,5573,299185892,2017,9144,7127,8351.84066,825.5335088
W32 9750,W32,9750,5569,298971152.4,1621,9227,7606,7771.626683,1406.98696
W33 9750,W33,9750,5565,298756412.9,1117,9261,8144,7335.273136,1627.536952
W34 9750,W34,9750,5570,299024837.3,896,9261,8365,6814.200718,2107.182835
W35 9750,W35,9750,5572,299132207.1,1873,9227,7354,7719.73313,1545.346135
W36 9750,W36,9750,5568,298917467.5,1414,9134,7720,7569.027658,1678.392954
W37 9750,W37,9750,5568,298917467.5,1235,9134,7899,7611.705999,1719.881627
W38 9750,W38,9750,5572,299132207.1,1892,9134,7242,8095.95262,1069.979802
W39 9750,W39,9750,5573,299185892,2961,8946,5985,7890.247084,903.2608045
W40 9750,W40,9750,5571,299078522.2,1235,9134,7899,6962.296356,2064.665457
W41 9750,W41,9750,5572,299132207.1,1174,9112,7938,6724.844042,1956.992494
W42 9750,W42,9750,5573,299185892,1510,8996,7486,7414.501525,1570.077194
W43 9750,W43,9750,5574,299239576.9,2961,9530,6569,7641.397919,749.394373
W44 9750,W44,9750,5573,299185892,1525,8945,7420,7207.331419,1422.905478
W45 9750,W45,9750,5575,299293261.8,1525,8939,7414,7150.226906,1476.8914
W46 9750,W46,9750,5568,298917467.5,1525,8878,7353,6791.487428,1840.032071
W47 9750,W47,9750,5573,299185892,1537,8906,7369,6980.738381,1826.588763
W48 9750,W48,9750,5574,299239576.9,1596,9269,7673,7681.589702,1099.852432
W49 9750,W49,9750,5573,299185892,1537,9269,7732,7114.391351,1685.196405
W50 9750,W50,9750,5572,299132207.1,1417,8872,7455,6925.093324,1828.73849
W51 9750,W51,9750,5570,299024837.3,1417,8872,7455,6710.660682,1879.516667
W52 9750,W52,9750,5570,299024837.3,1417,8774,7357,6562.667504,1885.254402
W53 9750,W53,9750,5574,299239576.9,1511,9112,7601,6473.332975,1939.071168
W54 9750,W54,9750,5579,299508001.3,1142,9112,7970,5950.430364,2114.639209
W55 9750,W55,9750,5575,299293261.7,1342,9161,7819,6773.46583,2020.368387
W56 9750,W56,9750,5565,298756412.9,840,9349,8509,6194.496676,2268.72256
W57 9750,W57,9750,5570,299024837.3,659,9352,8693,5555.113824,2467.91018
W58 9750,W58,9750,5574,299239576.9,723,9352,8629,5575.176713,2477.569269
W59 9750,W59,9750,5573,299185892,659,9349,8690,5499.639691,2487.757792
W60 9750,W60,9750,5569,298971152.4,748,9191,8443,6291.952236,2330.058976
W61 9750,W61,9750,5565,298756412.9,896,9191,8295,6983.653369,1914.123239
W62 9750,W62,9750,5567,298863782.6,453,9787,9334,6024.56296,2480.952454
W63 9750,W63,9750,5570,299024837.3,-1582,9927,11509,4929.181688,2741.828071
W64 9750,W64,9750,5568,298917467.5,135,9427,9292,5580.288075,2477.676006
W65 9750,W65,9750,5571,299078522.2,135,9145,9010,5296.60779,2452.228863
W66 9750,W66,9750,5568,298917467.5,135,9207,9072,4891.398886,2509.737666
WB_ E1 9750,WB_ E1,9750,5570,299024837.3,130,9272,9142,5367.529264,2427.412365
WB_ E10 9750,WB_ E10,9750,5567,298863782.6,659,9237,8578,5250.648823,2476.345249
WB_ E2 9750,WB_ E2,9750,5570,299024837.3,460,9427,8967,5953.744165,2393.373174
WB_ E3 9750,WB_ E3,9750,5574,299239576.9,1913,8963,7050,7613.091137,898.6134279
WB_ E4 9750,WB_ E4,9750,5564,298702728,1763,9009,7246,7909.923976,1222.762583
WB_ E5 9750,WB_ E5,9750,5568,298917467.5,130,9272,9142,5188.424569,2327.487462
WB_ E6 9750,WB_ E6,9750,5573,299185892,2961,9530,6569,7622.608469,734.1014956
WB_ E7 9750,WB_ E7,9750,5563,298649043.1,-424,9787,10211,5861.077836,2379.184254
WB_ E8 9750,WB_ E8,9750,5571,299078522.2,990,9352,8362,5863.583378,2358.644474
WB_ E9 9750,WB_ E9,9750,5578,299454316.4,843,9352,8509,5764.806561,2349.385624
WB_ H1 9750,WB_ H1,9750,5581,299615371.1,1525,8906,7381,6836.952159,1879.758394
WB_ H10 9750,WB_ H10,9750,5573,299185892,1525,8878,7353,6746.076261,1834.855419
WB_ H2 9750,WB_ H2,9750,5570,299024837.3,1724,9063,7339,7621.084201,1523.938268
WB_ H3 9750,WB_ H3,9750,5566,298810097.7,896,9261,8365,7094.540244,1934.690615
WB_ H4 9750,WB_ H4,9750,5573,299185892,1174,9112,7938,6468.347748,1921.607759
WB_ H5 9750,WB_ H5,9750,5571,299078522.2,1174,9074,7900,6454.419494,2235.954094
WB_ H6 9750,WB_ H6,9750,5562,298595358.2,89,9551,9462,6426.02625,2455.10316
WB_ H7 9750,WB_ H7,9750,5564,298702728,-503,9898,10401,6874.214774,2206.321093
WB_ H8 9750,WB_ H8,9750,5568,298917467.5,854,9352,8498,5659.114763,2408.400347
WB_ H9 9750,WB_ H9,9750,5565,298756412.9,130,9272,9142,5534.803774,2381.515376
WB_ S1 9750,WB_ S1,9750,5567,298863782.6,-714,9749,10463,6385.288665,2635.494326
WB_ S10 9750,WB_ S10,9750,5562,298595358.2,-961,9787,10748,4490.108055,2708.534371
WB_ S11 9750,WB_ S11,9750,5570,299024837.3,135,9191,9056,5771.179354,2438.566862
WB_ S12 9750,WB_ S12,9750,5569,298971152.4,659,9349,8690,5440.894595,2475.019474
WB_ S13 9750,WB_ S13,9750,5572,299132207.1,1174,9352,8178,6315.674982,2240.249758
WB_ S14 9750,WB_ S14,9750,5578,299454316.4,1290,9112,7822,6892.589638,1716.784149
WB_ S15 9750,WB_ S15,9750,5578,299454316.4,1525,8878,7353,6796.135712,1849.274751
WB_ S16 9750,WB_ S16,9750,5570,299024837.3,130,9240,9110,5990.639497,2291.789034
WB_ S17 9750,WB_ S17,9750,5564,298702728,896,9145,8249,6920.725377,1876.427949
WB_ S18 9750,WB_ S18,9750,5567,298863782.6,896,9261,8365,6654.144782,2145.898096
WB_ S19 9750,WB_ S19,9750,5569,298971152.4,1489,9134,7645,7309.063566,1801.456231
WB_ S2 9750,WB_ S2,9750,5569,298971152.4,-1582,9580,11162,4047.103609,3412.15507
WB_ S20 9750,WB_ S20,9750,5572,299132207.1,1235,9134,7899,7665.892498,1625.159652
WB_ S21 9750,WB_ S21,9750,5574,299239576.9,2844,9530,6686,7741.02709,907.0412724
WB_ S22 9750,WB_ S22,9750,5575,299293261.8,3177,9530,6353,7599.865471,714.6057639
WB_ S23 9750,WB_ S23,9750,5562,298595358.2,497,9377,8880,6575.657857,1908.444778
WB_ S24 9750,WB_ S24,9750,5565,298756412.8,130,9272,9142,5511.500809,2276.605758
WB_ S25 9750,WB_ S25,9750,5566,298810097.7,527,9043,8516,6928.520302,1794.817533
WB_ S26 9750,WB_ S26,9750,5570,299024837.3,1117,9261,8144,7463.162478,1668.628009
WB_ S27 9750,WB_ S27,9750,5569,298971152.4,2171,9175,7004,8197.470821,1000.83503
WB_ S28 9750,WB_ S28,9750,5562,298595358.2,395,9102,8707,7099.968357,1665.940006
WB_ S29 9750,WB_ S29,9750,5561,298541673.3,822,9003,8181,6695.399389,1781.429547
WB_ S3 9750,WB_ S3,9750,5566,298810097.7,135,9925,9790,5403.322314,2473.049369
WB_ S4 9750,WB_ S4,9750,5570,299024837.3,135,9352,9217,4420.403232,2433.539636
WB_ S5 9750,WB_ S5,9750,5573,299185892,723,9352,8629,5737.778934,2438.488899
WB_ S6 9750,WB_ S6,9750,5575,299293261.7,1174,9112,7938,6315.64,2015.194043
WB_ S7 9750,WB_ S7,9750,5574,299239576.9,1417,8878,7461,6601.339971,1951.009006
WB_ S8 9750,WB_ S8,9750,5564,298702728,-41,9749,9790,6588.331955,2279.056565
WB_ S9 9750,WB_ S9,9750,5568,298917467.5,-1001,9787,10788,4908.062859,2714.049616
WB_ W1 9750,WB_ W1,9750,5563,298649043.1,381,9272,8891,6208.346216,2029.449043
WB_ W10 9750,WB_ W10,9750,5570,299024837.3,-144,9927,10071,5626.041472,2441.870083
WB_ W2 9750,WB_ W2,9750,5562,298595358.2,395,9313,8918,7291.153362,1608.454006
WB_ W3 9750,WB_ W3,9750,5560,298487988.4,511,9063,8552,6619.930396,1819.236892
WB_ W4 9750,WB_ W4,9750,5568,298917467.5,-424,9787,10211,5730.573994,2394.115346
WB_ W5 9750,WB_ W5,9750,5573,299185892,775,9134,8359,7128.755787,1659.451106
WB_ W6 9750,WB_ W6,9750,5565,298756412.9,1905,9063,7158,7848.527942,1264.335641
WB_ W7 9750,WB_ W7,9750,5568,298917467.5,-1001,9749,10750,5346.966056,2985.488684
WB_ W8 9750,WB_ W8,9750,5566,298810097.7,896,9131,8235,7113.407833,1736.00749
WB_ W9 9750,WB_ W9,9750,5569,298971152.4,1235,9145,7910,6994.208475,1992.485434
W01 10000,W01,10000,5848,313949236.7,117,9551,9434,6962.70725,2099.264736
W02 10000,W02,10000,5851,314110291.4,249,9551,9302,7155.493591,1742.908101
W03 10000,W03,10000,5855,314325031,395,9063,8668,6955.310845,1653.584319
W04 10000,W04,10000,5852,314163976.3,395,9551,9156,7095.344156,1742.085011
W05 10000,W05,10000,5849,314002921.6,395,9551,9156,7279.934006,1730.90958
W06 10000,W06,10000,5852,314163976.3,395,9063,8668,7121.527512,1584.812836
W07 10000,W07,10000,5855,314325031,822,9063,8241,6698.437916,1781.706598
W08 10000,W08,10000,5855,314325031,1724,9063,7339,7132.326388,1634.1792
W09 10000,W09,10000,5851,314110291.4,507,8991,8484,6948.624167,1712.323655
W10 10000,W10,10000,5853,314217661.2,1534,9009,7475,7243.8558,1809.43675
W11 10000,W11,10000,5852,314163976.3,233,9272,9039,6179.95728,2059.764912
W12 10000,W12,10000,5858,314486085.6,130,9272,9142,5641.110959,2254.168247
W13 10000,W13,10000,5849,314002921.6,130,9272,9142,5774.659942,2209.770168
W14 10000,W14,10000,5858,314486085.6,381,9272,8891,6336.803687,2159.64609
W15 10000,W15,10000,5852,314163976.3,381,8981,8600,6683.383971,2092.282264
W16 10000,W16,10000,5845,313788182.1,-503,9898,10401,6626.947819,2210.257369
W17 10000,W17,10000,5852,314163976.3,-503,9898,10401,6712.842789,2187.399317
W18 10000,W18,10000,5856,314378715.8,38,9749,9711,6574.16735,2204.809917
W19 10000,W19,10000,5855,314325030.9,-714,9749,10463,6483.102647,2401.112498
W20 10000,W20,10000,5850,314056606.5,-424,9749,10173,6226.431282,2325.337114
W21 10000,W21,10000,5858,314486085.6,38,9316,9278,6525.509218,2152.012004
W22 10000,W22,10000,5853,314217661.2,-1001,9604,10605,5056.825047,2862.733035
W23 10000,W23,10000,5855,314325031,-424,9787,10211,5712.248335,2459.753225
W24 10000,W24,10000,5852,314163976.3,130,9240,9110,6078.2189,2263.00743
W25 10000,W25,10000,5852,314163976.3,357,9787,9430,6046.423787,2197.831577
W26 10000,W26,10000,5858,314486085.6,-961,9787,10748,5140.21731,2635.081871
W27 10000,W27,10000,5851,314110291.4,453,9787,9334,6010.727397,2238.913455
W28 10000,W28,10000,5856,314378715.8,171,9102,8931,6509.851264,2039.645353
W29 10000,W29,10000,5859,314539770.5,171,9102,8931,6548.957843,2128.592165
W30 10000,W30,10000,5854,314271346.1,572,9131,8559,6937.387598,1897.171756
W31 10000,W31,10000,5861,314647140.3,894,9162,8268,8335.807712,862.608181
W32 10000,W32,10000,5860,314593455.4,1621,9227,7606,7740.153754,1438.571837
W33 10000,W33,10000,5855,314325031,1117,9261,8144,7309.749787,1651.579843
W34 10000,W34,10000,5860,314593455.4,896,9261,8365,6853.032082,2098.332772
W35 10000,W35,10000,5858,314486085.6,1873,9227,7354,7734.768351,1534.464865
W36 10000,W36,10000,5861,314647140.3,1414,9134,7720,7576.530456,1676.370501
W37 10000,W37,10000,5858,314486085.6,1235,9134,7899,7600.966541,1731.460914
W38 10000,W38,10000,5865,314861879.9,1892,9134,7242,8065.548508,1096.960801
W39 10000,W39,10000,5859,314539770.5,2961,8946,5985,7885.216078,908.9338728
W40 10000,W40,10000,5857,314432400.7,1235,9134,7899,6993.730408,2046.904954
W41 10000,W41,10000,5863,314754510.1,1174,9112,7938,6741.414975,1954.237411
W42 10000,W42,10000,5858,314486085.6,1509,8996,7487,7386.362922,1603.777315
W43 10000,W43,10000,5859,314539770.5,2961,9530,6569,7639.908346,749.6016519
W44 10000,W44,10000,5862,314700825.2,1525,8963,7438,7222.374616,1417.047924
W45 10000,W45,10000,5860,314593455.4,1525,8939,7414,7158.345222,1460.61193
W46 10000,W46,10000,5861,314647140.3,1525,8878,7353,6816.843713,1820.307162
W47 10000,W47,10000,5863,314754510.1,1537,8906,7369,7002.574962,1808.015497
W48 10000,W48,10000,5867,314969249.6,1596,9269,7673,7682.219192,1096.391738
W49 10000,W49,10000,5863,314754510.1,1537,9269,7732,7139.76582,1676.269979
W50 10000,W50,10000,5869,315076619.4,1417,8872,7455,6922.276708,1827.19109
W51 10000,W51,10000,5866,314915564.7,1417,8872,7455,6734.594272,1868.192075
W52 10000,W52,10000,5867,314969249.6,1417,8774,7357,6573.532981,1888.200878
W53 10000,W53,10000,5865,314861879.9,1511,9112,7601,6457.771526,1941.673789
W54 10000,W54,10000,5865,314861879.9,1142,9112,7970,5961.20665,2111.907486
W55 10000,W55,10000,5855,314325030.9,1342,9161,7819,6754.820495,2023.293122
W56 10000,W56,10000,5858,314486085.6,802,9349,8547,6175.899795,2285.820992
W57 10000,W57,10000,5855,314325031,659,9352,8693,5549.128779,2462.828171
W58 10000,W58,10000,5855,314325030.9,723,9352,8629,5575.108454,2465.414412
W59 10000,W59,10000,5857,314432400.7,659,9349,8690,5483.065733,2491.235474
W60 10000,W60,10000,5856,314378715.8,748,9191,8443,6253.052766,2347.375449
W61 10000,W61,10000,5852,314163976.3,730,9191,8461,6950.547676,1932.347905
W62 10000,W62,10000,5857,314432400.7,199,9787,9588,6021.74475,2479.386825
W63 10000,W63,10000,5852,314163976.3,-1582,9927,11509,4906.294429,2778.681332
W64 10000,W64,10000,5862,314700825.2,135,9537,9402,5612.492323,2465.171943
W65 10000,W65,10000,5855,314325030.9,135,9145,9010,5319.007003,2439.030839
W66 10000,W66,10000,5857,314432400.7,135,9386,9251,4903.676114,2517.519405
WB_ E1 10000,WB_ E1,10000,5854,314271346.1,130,9272,9142,5433.661428,2415.9884
WB_ E10 10000,WB_ E10,10000,5856,314378715.8,659,9237,8578,5304.949624,2494.095355
WB_ E2 10000,WB_ E2,10000,5858,314486085.6,460,9427,8967,5903.745818,2409.26181
WB_ E3 10000,WB_ E3,10000,5862,314700825.2,1913,8963,7050,7608.849028,902.2292256
WB_ E4 10000,WB_ E4,10000,5859,314539770.5,1763,9009,7246,7886.613245,1257.446958
WB_ E5 10000,WB_ E5,10000,5851,314110291.4,130,9272,9142,5255.164416,2324.215212
WB_ E6 10000,WB_ E6,10000,5864,314808195,2961,9530,6569,7624.786323,725.8248924
WB_ E7 10000,WB_ E7,10000,5858,314486085.6,-424,9787,10211,5833.795323,2394.958566
WB_ E8 10000,WB_ E8,10000,5859,314539770.5,852,9352,8500,5849.434716,2363.202889
WB_ E9 10000,WB_ E9,10000,5863,314754510.1,843,9352,8509,5751.947467,2354.413186
WB_ H1 10000,WB_ H1,10000,5870,315130304.3,1525,8906,7381,6839.635434,1869.110618
WB_ H10 10000,WB_ H10,10000,5865,314861879.9,1525,8878,7353,6773.387212,1822.43909
WB_ H2 10000,WB_ H2,10000,5851,314110291.4,1724,9063,7339,7627.045291,1514.525612
WB_ H3 10000,WB_ H3,10000,5858,314486085.6,896,9261,8365,7118.439228,1903.84561
WB_ H4 10000,WB_ H4,10000,5864,314808195,1174,9112,7938,6433.850955,1956.29251
WB_ H5 10000,WB_ H5,10000,5862,314700825.2,1174,9074,7900,6496.005629,2217.037749
WB_ H6 10000,WB_ H6,10000,5856,314378715.8,89,9551,9462,6440.597507,2451.228553
WB_ H7 10000,WB_ H7,10000,5851,314110291.4,-503,9898,10401,6846.644163,2218.482721
WB_ H8 10000,WB_ H8,10000,5860,314593455.4,854,9352,8498,5647.859386,2400.774398
WB_ H9 10000,WB_ H9,10000,5857,314432400.7,130,9272,9142,5594.620796,2365.591588
WB_ S1 10000,WB_ S1,10000,5857,314432400.7,-714,9749,10463,6383.922315,2640.402782
WB_ S10 10000,WB_ S10,10000,5853,314217661.2,-961,9787,10748,4536.535452,2726.501089
WB_ S11 10000,WB_ S11,10000,5859,314539770.5,135,9191,9056,5753.127496,2448.863128
WB_ S12 10000,WB_ S12,10000,5856,314378715.8,659,9349,8690,5442.572404,2471.29257
WB_ S13 10000,WB_ S13,10000,5858,314486085.6,1174,9352,8178,6329.089109,2230.484248
WB_ S14 10000,WB_ S14,10000,5868,315022934.5,1174,9112,7938,6858.797546,1752.578943
WB_ S15 10000,WB_ S15,10000,5866,314915564.7,1525,8878,7353,6822.949028,1830.306938
WB_ S16 10000,WB_ S16,10000,5852,314163976.3,130,9250,9120,6021.645079,2270.496382
WB_ S17 10000,WB_ S17,10000,5852,314163976.3,896,9145,8249,6886.6608,1912.010378
WB_ S18 10000,WB_ S18,10000,5859,314539770.5,896,9261,8365,6668.076634,2132.520829
WB_ S19 10000,WB_ S19,10000,5858,314486085.6,1489,9134,7645,7309.020485,1807.977966
WB_ S2 10000,WB_ S2,10000,5851,314110291.4,-1582,9580,11162,4076.507606,3400.439693
WB_ S20 10000,WB_ S20,10000,5861,314647140.3,1235,9134,7899,7647.689473,1648.128632
WB_ S21 10000,WB_ S21,10000,5865,314861879.9,2844,9530,6686,7746.852174,913.7019406
WB_ S22 10000,WB_ S22,10000,5861,314647140.3,3023,9530,6507,7592.543081,729.8803272
WB_ S23 10000,WB_ S23,10000,5852,314163976.3,497,9377,8880,6587.615003,1910.838422
WB_ S24 10000,WB_ S24,10000,5854,314271346.1,130,9272,9142,5561.488726,2279.464675
WB_ S25 10000,WB_ S25,10000,5860,314593455.4,497,9110,8613,6921.025597,1811.553436
WB_ S26 10000,WB_ S26,10000,5858,314486085.6,1117,9261,8144,7440.513315,1683.55893
WB_ S27 10000,WB_ S27,10000,5859,314539770.5,2171,9175,7004,8189.033453,1015.348364
WB_ S28 10000,WB_ S28,10000,5849,314002921.6,395,9102,8707,7079.983758,1672.582325
WB_ S29 10000,WB_ S29,10000,5852,314163976.3,511,9003,8492,6687.334245,1804.540098
WB_ S3 10000,WB_ S3,10000,5857,314432400.7,135,9925,9790,5417.473963,2470.487929
WB_ S4 10000,WB_ S4,10000,5860,314593455.4,135,9352,9217,4421.107679,2429.371822
WB_ S5 10000,WB_ S5,10000,5860,314593455.4,723,9352,8629,5736.435495,2427.908566
WB_ S6 10000,WB_ S6,10000,5859,314539770.5,1142,9112,7970,6297.557262,2031.783407
WB_ S7 10000,WB_ S7,10000,5866,314915564.7,1417,8878,7461,6598.416638,1941.941432
WB_ S8 10000,WB_ S8,10000,5854,314271346.1,-41,9749,9790,6537.637513,2320.587215
WB_ S9 10000,WB_ S9,10000,5852,314163976.3,-1001,9787,10788,4933.935578,2742.446991
WB_ W1 10000,WB_ W1,10000,5858,314486085.6,365,9272,8907,6222.109252,2038.312892
WB_ W10 10000,WB_ W10,10000,5856,314378715.8,-144,9927,10071,5632.755977,2437.681702
WB_ W2 10000,WB_ W2,10000,5851,314110291.4,395,9551,9156,7280.341651,1629.224446
WB_ W3 10000,WB_ W3,10000,5859,314539770.5,507,9063,8556,6632.615122,1833.213407
WB_ W4 10000,WB_ W4,10000,5857,314432400.7,-424,9787,10211,5703.775141,2408.69979
WB_ W5 10000,WB_ W5,10000,5854,314271346.1,775,9134,8359,7096.31124,1689.365206
WB_ W6 10000,WB_ W6,10000,5858,314486085.6,1897,9063,7166,7833.967736,1287.785309
WB_ W7 10000,WB_ W7,10000,5853,314217661.2,-1001,9749,10750,5338.808816,2984.9133
WB_ W8 10000,WB_ W8,10000,5858,314486085.6,896,9131,8235,7081.328269,1775.176104
WB_ W9 10000,WB_ W9,10000,5858,314486085.6,1235,9145,7910,6980.288836,2008.511912
